granularity_geo,location_name,date,new_dose_1,new_dose_2,total_dose_1,total_dose_2,total_pr100_dose_1,total_pr100_dose_2,new_doses,total_doses,source
county,Agder,2020-12-27,0,0,0,0,0.0,0.0,0,0,fhi:git
county,Agder,2020-12-28,0,0,0,0,0.0,0.0,0,0,fhi:git
county,Agder,2020-12-29,0,0,0,0,0.0,0.0,0,0,fhi:git
county,Agder,2020-12-30,0,0,0,0,0.0,0.0,0,0,fhi:git
county,Agder,2020-12-31,0,0,0,0,0.0,0.0,0,0,fhi:git
county,Agder,2021-01-01,0,0,0,0,0.0,0.0,0,0,fhi:git
county,Agder,2021-01-02,0,0,0,0,0.0,0.0,0,0,fhi:git
county,Agder,2021-01-03,3,0,3,0,0.0009764639635974,0.0,3,3,fhi:git
county,Agder,2021-01-04,0,0,3,0,0.0009713673290312,0.0,0,3,fhi:git
county,Agder,2021-01-05,79,0,82,0,0.026550706993521,0.0,79,82,fhi:git
county,Agder,2021-01-06,791,0,873,0,0.282667892748095,0.0,791,873,fhi:git
county,Agder,2021-01-07,230,0,1103,0,0.357139387973825,0.0,230,1103,fhi:git
county,Agder,2021-01-08,49,0,1152,0,0.373005054348002,0.0,49,1152,fhi:git
county,Agder,2021-01-09,0,0,1152,0,0.373005054348002,0.0,0,1152,fhi:git
county,Agder,2021-01-10,0,0,1152,0,0.373005054348002,0.0,0,1152,fhi:git
county,Agder,2021-01-11,1,0,1153,0,0.373328843457679,0.0,1,1153,fhi:git
county,Agder,2021-01-12,226,0,1379,0,0.4465051822447,0.0,226,1379,fhi:git
county,Agder,2021-01-13,848,0,2227,0,0.721078347250869,0.0,848,2227,fhi:git
county,Agder,2021-01-14,512,0,2739,0,0.886858371405536,0.0,512,2739,fhi:git
county,Agder,2021-01-15,119,0,2858,0,0.925389275457109,0.0,119,2858,fhi:git
county,Agder,2021-01-16,1,0,2859,0,0.925713064566786,0.0,1,2859,fhi:git
county,Agder,2021-01-17,2,0,2861,0,0.92636064278614,0.0,2,2861,fhi:git
county,Agder,2021-01-18,15,0,2876,0,0.931217479431297,0.0,15,2876,fhi:git
county,Agder,2021-01-19,347,0,3223,0,1.04357230048925,0.0,347,3223,fhi:git
county,Agder,2021-01-20,460,0,3683,0,1.1925152909407,0.0,460,3683,fhi:git
county,Agder,2021-01-21,337,0,4020,0,1.30163222090188,0.0,337,4020,fhi:git
county,Agder,2021-01-22,67,0,4087,0,1.32332609125025,0.0,67,4087,fhi:git
county,Agder,2021-01-23,2,0,4089,0,1.3239736694696,0.0,2,4089,fhi:git
county,Agder,2021-01-24,0,0,4089,0,1.3239736694696,0.0,0,4089,fhi:git
county,Agder,2021-01-25,3,0,4092,0,1.32494503679863,0.0,3,4092,fhi:git
county,Agder,2021-01-26,63,66,4155,66,1.34534375070829,0.0213700812386876,129,4221,fhi:git
county,Agder,2021-01-27,567,681,4722,747,1.5289321758952,0.241870464928783,1248,5469,fhi:git
county,Agder,2021-01-28,952,248,5674,995,1.83717940830778,0.3221701641287,1200,6669,fhi:git
county,Agder,2021-01-29,204,61,5878,1056,1.90323238668191,0.341921299819002,265,6934,fhi:git
county,Agder,2021-01-30,32,0,5910,1056,1.91359363819157,0.341921299819002,32,6966,fhi:git
county,Agder,2021-01-31,24,0,5934,1056,1.92136457682382,0.341921299819002,24,6990,fhi:git
county,Agder,2021-02-01,1,2,5935,1058,1.9216883659335,0.342568878038356,3,6993,fhi:git
county,Agder,2021-02-02,203,170,6138,1228,1.98741755519795,0.397613026683461,373,7366,fhi:git
county,Agder,2021-02-03,1331,593,7469,1821,2.41838086017815,0.589619968721972,1924,9290,fhi:git
county,Agder,2021-02-04,1708,496,9177,2317,2.97141265950661,0.750219367121806,2204,11494,fhi:git
county,Agder,2021-02-05,619,135,9796,2452,3.17183811839673,0.793930896928213,754,12248,fhi:git
county,Agder,2021-02-06,512,2,10308,2454,3.33761814255139,0.794578475147567,514,12762,fhi:git
county,Agder,2021-02-07,83,2,10391,2456,3.36449263865459,0.795226053366921,85,12847,fhi:git
county,Agder,2021-02-08,13,2,10404,2458,3.36870189708039,0.795873631586275,15,12862,fhi:git
county,Agder,2021-02-09,189,255,10593,2713,3.42989803880936,0.878439854553932,444,13306,fhi:git
county,Agder,2021-02-10,1151,371,11744,3084,3.80257930404769,0.99856561424413,1522,14828,fhi:git
county,Agder,2021-02-11,1009,409,12753,3493,4.12928251571187,1.13099536010206,1418,16246,fhi:git
county,Agder,2021-02-12,356,69,13109,3562,4.24455143875691,1.15333680866978,425,16671,fhi:git
county,Agder,2021-02-13,509,3,13618,3565,4.40936009558255,1.15430817599881,512,17183,fhi:git
county,Agder,2021-02-14,0,0,13618,3565,4.40936009558255,1.15430817599881,0,17183,fhi:git
county,Agder,2021-02-15,1,1,13619,3566,4.40968388469222,1.15463196510849,2,17185,fhi:git
county,Agder,2021-02-16,141,117,13760,3683,4.45533814915669,1.1925152909407,258,17443,fhi:git
county,Agder,2021-02-17,1218,435,14978,4118,4.84971328474338,1.33336355365024,1653,19096,fhi:git
county,Agder,2021-02-18,1089,820,16067,4938,5.20231962518173,1.59887062358545,1909,21005,fhi:git
county,Agder,2021-02-19,721,343,16788,5281,5.43577157325891,1.70993028820469,1064,22069,fhi:git
county,Agder,2021-02-20,355,37,17143,5318,5.55071670719427,1.72191048526274,392,22461,fhi:git
county,Agder,2021-02-21,52,23,17195,5341,5.56755374089748,1.72935763478531,75,22536,fhi:git
county,Agder,2021-02-22,223,1,17418,5342,5.63975871235547,1.72968142389499,224,22760,fhi:git
county,Agder,2021-02-23,294,201,17712,5543,5.73495271060053,1.79476303494008,495,23255,fhi:git
county,Agder,2021-02-24,976,1110,18688,6653,6.05097088164537,2.15416894668165,2086,25341,fhi:git
county,Agder,2021-02-25,717,1564,19405,8217,6.28312767328384,2.66057511421661,2281,27622,fhi:git
county,Agder,2021-02-26,399,466,19804,8683,6.41231952804499,2.81146083932613,865,28487,fhi:git
county,Agder,2021-02-27,0,1,19804,8684,6.41231952804499,2.81178462843581,1,28488,fhi:git
county,Agder,2021-02-28,10,82,19814,8766,6.41555741914177,2.83833533542933,92,28580,fhi:git
county,Agder,2021-03-01,262,0,20076,8766,6.50039016587716,2.83833533542933,262,28842,fhi:git
county,Agder,2021-03-02,578,192,20654,8958,6.68754027127052,2.90050284448733,770,29612,fhi:git
county,Agder,2021-03-03,635,878,21289,9836,6.89314635591547,3.18478968278381,1513,31125,fhi:git
county,Agder,2021-03-04,796,1067,22085,10903,7.15088248721843,3.53027266280926,1863,32988,fhi:git
county,Agder,2021-03-05,961,382,23046,11285,7.46204382161811,3.65396010270591,1343,34331,fhi:git
county,Agder,2021-03-06,36,405,23082,11690,7.47370022956648,3.78509469212513,441,34772,fhi:git
county,Agder,2021-03-07,3,0,23085,11690,7.47467159689551,3.78509469212513,3,34775,fhi:git
county,Agder,2021-03-08,226,0,23311,11690,7.54784793568253,3.78509469212513,226,35001,fhi:git
county,Agder,2021-03-09,723,141,24034,11831,7.78194746197906,3.83074895658959,864,35865,fhi:git
county,Agder,2021-03-10,1031,784,25065,12615,8.11577403405614,4.08459961857643,1815,37680,fhi:git
county,Agder,2021-03-11,647,813,25712,13428,8.32526558801721,4.3478401647439,1460,39140,fhi:git
county,Agder,2021-03-12,97,325,25809,13753,8.35667313165589,4.45307162538895,422,39562,fhi:git
county,Agder,2021-03-13,0,0,25809,13753,8.35667313165589,4.45307162538895,0,39562,fhi:git
county,Agder,2021-03-14,0,0,25809,13753,8.35667313165589,4.45307162538895,0,39562,fhi:git
county,Agder,2021-03-15,0,3,25809,13756,8.35667313165589,4.45404299271798,3,39565,fhi:git
county,Agder,2021-03-16,239,14,26048,13770,8.43405872886871,4.45857604025346,253,39818,fhi:git
county,Agder,2021-03-17,1608,47,27656,13817,8.95471161722947,4.47379412840828,1655,41473,fhi:git
county,Agder,2021-03-18,1249,89,28905,13906,9.35912421521614,4.50261135916955,1338,42811,fhi:git
county,Agder,2021-03-19,264,41,29169,13947,9.4446045401709,4.51588671266631,305,43116,fhi:git
county,Agder,2021-03-20,0,0,29169,13947,9.4446045401709,4.51588671266631,0,43116,fhi:git
county,Agder,2021-03-21,17,53,29186,14000,9.45010895503541,4.53304753547919,70,43186,fhi:git
county,Agder,2021-03-22,9,1,29195,14001,9.4530230570225,4.53337132458887,10,43196,fhi:git
county,Agder,2021-03-23,313,14,29508,14015,9.55436904835143,4.53790437212435,327,43523,fhi:git
county,Agder,2021-03-24,2267,75,31775,14090,10.2883989599894,4.56218855535013,2342,45865,fhi:git
county,Agder,2021-03-25,2037,54,33812,14144,10.9479573764016,4.57967316727269,2091,47956,fhi:git
county,Agder,2021-03-26,772,12,34584,14156,11.1979225690723,4.58355863658882,784,48740,fhi:git
county,Agder,2021-03-27,0,0,34584,14156,11.1979225690723,4.58355863658882,0,48740,fhi:git
county,Agder,2021-03-28,173,1,34757,14157,11.2539380850464,4.58388242569849,174,48914,fhi:git
county,Agder,2021-03-29,107,0,34864,14157,11.2885835197819,4.58388242569849,107,49021,fhi:git
county,Agder,2021-03-30,686,71,35550,14228,11.5107028490204,4.60687145248557,757,49778,fhi:git
county,Innlandet,2020-12-27,0,0,0,0,0.0,0.0,0,0,fhi:git
county,Innlandet,2020-12-28,272,0,272,0,0.0732393607711674,0.0,272,272,fhi:git
county,Innlandet,2020-12-29,260,0,532,0,0.143247573273019,0.0,260,532,fhi:git
county,Innlandet,2020-12-30,149,0,681,0,0.183367664283695,0.0,149,681,fhi:git
county,Innlandet,2020-12-31,0,0,681,0,0.183367664283695,0.0,0,681,fhi:git
county,Innlandet,2021-01-01,0,0,681,0,0.183367664283695,0.0,0,681,fhi:git
county,Innlandet,2021-01-02,0,0,681,0,0.183367664283695,0.0,0,681,fhi:git
county,Innlandet,2021-01-03,0,0,681,0,0.183367664283695,0.0,0,681,fhi:git
county,Innlandet,2021-01-04,0,0,681,0,0.183754583745949,0.0,0,681,fhi:git
county,Innlandet,2021-01-05,271,0,952,0,0.256878654517098,0.0,271,952,fhi:git
county,Innlandet,2021-01-06,703,0,1655,0,0.446569509690963,0.0,703,1655,fhi:git
county,Innlandet,2021-01-07,696,0,2351,0,0.634371551228673,0.0,696,2351,fhi:git
county,Innlandet,2021-01-08,75,0,2426,0,0.654608840187478,0.0,75,2426,fhi:git
county,Innlandet,2021-01-09,0,0,2426,0,0.654608840187478,0.0,0,2426,fhi:git
county,Innlandet,2021-01-10,0,0,2426,0,0.654608840187478,0.0,0,2426,fhi:git
county,Innlandet,2021-01-11,50,0,2476,0,0.668100366160015,0.0,50,2476,fhi:git
county,Innlandet,2021-01-12,403,0,2879,0,0.77684206549866,0.0,403,2879,fhi:git
county,Innlandet,2021-01-13,993,0,3872,0,1.04478377131324,0.0,993,3872,fhi:git
county,Innlandet,2021-01-14,957,0,4829,0,1.30301157842759,0.0,957,4829,fhi:git
county,Innlandet,2021-01-15,280,0,5109,0,1.3785641238738,0.0,280,5109,fhi:git
county,Innlandet,2021-01-16,4,0,5113,0,1.3796434459516,0.0,4,5113,fhi:git
county,Innlandet,2021-01-17,0,0,5113,0,1.3796434459516,0.0,0,5113,fhi:git
county,Innlandet,2021-01-18,62,0,5175,0,1.39637293815754,0.0,62,5175,fhi:git
county,Innlandet,2021-01-19,331,318,5506,318,1.48568684009574,0.0858061051853331,649,5824,fhi:git
county,Innlandet,2021-01-20,663,252,6169,570,1.66458447449157,0.153803396086918,915,6739,fhi:git
county,Innlandet,2021-01-21,834,48,7003,618,1.88962312771348,0.166755261020553,882,7621,fhi:git
county,Innlandet,2021-01-22,239,0,7242,618,1.95411262186221,0.166755261020553,239,7860,fhi:git
county,Innlandet,2021-01-23,6,0,7248,618,1.95573160497891,0.166755261020553,6,7866,fhi:git
county,Innlandet,2021-01-24,0,0,7248,618,1.95573160497891,0.166755261020553,0,7866,fhi:git
county,Innlandet,2021-01-25,1,0,7249,618,1.95600143549836,0.166755261020553,1,7867,fhi:git
county,Innlandet,2021-01-26,152,131,7401,749,1.99701567445487,0.202103059068599,283,8150,fhi:git
county,Innlandet,2021-01-27,935,604,8336,1353,2.24930721014131,0.365080692816842,1539,9689,fhi:git
county,Innlandet,2021-01-28,903,708,9239,2061,2.49296416920532,0.556120700587961,1611,11300,fhi:git
county,Innlandet,2021-01-29,319,132,9558,2193,2.57904010491011,0.591738329155457,451,11751,fhi:git
county,Innlandet,2021-01-30,2,0,9560,2193,2.57957976594901,0.591738329155457,2,11753,fhi:git
county,Innlandet,2021-01-31,1,0,9561,2193,2.57984959646846,0.591738329155457,1,11754,fhi:git
county,Innlandet,2021-02-01,9,49,9570,2242,2.58227807114351,0.604960024608543,58,11812,fhi:git
county,Innlandet,2021-02-02,610,341,10180,2583,2.74687468800846,0.696972231741243,951,12763,fhi:git
county,Innlandet,2021-02-03,2310,872,12490,3455,3.37018318793966,0.932264444702282,3182,15945,fhi:git
county,Innlandet,2021-02-04,2656,997,15146,4452,4.0868530476008,1.20128547259466,3653,19598,fhi:git
county,Innlandet,2021-02-05,814,271,15960,4723,4.3064950904337,1.27440954336581,1085,20683,fhi:git
county,Innlandet,2021-02-06,7,4,15967,4727,4.30838390406985,1.27548886544361,11,20694,fhi:git
county,Innlandet,2021-02-07,0,0,15967,4727,4.30838390406985,1.27548886544361,0,20694,fhi:git
county,Innlandet,2021-02-08,2,62,15969,4789,4.30892356510875,1.29221835764956,64,20758,fhi:git
county,Innlandet,2021-02-09,257,269,16226,5058,4.37827000860759,1.36480276738181,526,21284,fhi:git
county,Innlandet,2021-02-10,2056,589,18282,5647,4.9330415565983,1.52373294333829,2645,23929,fhi:git
county,Innlandet,2021-02-11,2237,848,20519,6495,5.53665242860959,1.75254922383251,3085,27014,fhi:git
county,Innlandet,2021-02-12,430,283,20949,6778,5.65267955197341,1.82891126083707,713,27727,fhi:git
county,Innlandet,2021-02-13,0,5,20949,6783,5.65267955197341,1.83026041343432,5,27732,fhi:git
county,Innlandet,2021-02-14,1,1,20950,6784,5.65294938249286,1.83053024395377,2,27734,fhi:git
county,Innlandet,2021-02-15,86,14,21036,6798,5.67615480716562,1.83430787122608,100,27834,fhi:git
county,Innlandet,2021-02-16,530,92,21566,6890,5.81916498247451,1.85913227901555,622,28456,fhi:git
county,Innlandet,2021-02-17,1573,782,23139,7672,6.24360838957051,2.07013974522602,2355,30811,fhi:git
county,Innlandet,2021-02-18,1467,902,24606,8574,6.63944976160474,2.31352687377058,2369,33180,fhi:git
county,Innlandet,2021-02-19,542,296,25148,8870,6.78569790314703,2.393396707528,838,34018,fhi:git
county,Innlandet,2021-02-20,0,3,25148,8873,6.78569790314703,2.39420619908635,3,34021,fhi:git
county,Innlandet,2021-02-21,0,1,25148,8874,6.78569790314703,2.3944760296058,1,34022,fhi:git
county,Innlandet,2021-02-22,283,3,25431,8877,6.86205994015159,2.39528552116416,286,34308,fhi:git
county,Innlandet,2021-02-23,320,306,25751,9183,6.94840570637583,2.47785366011608,626,34934,fhi:git
county,Innlandet,2021-02-24,850,2319,26601,11502,7.17776164790895,3.10359063472233,3169,38103,fhi:git
county,Innlandet,2021-02-25,1748,2451,28349,13953,7.64942539590883,3.76494523789608,4199,42302,fhi:git
county,Innlandet,2021-02-26,676,813,29025,14766,7.83183082705753,3.98431745020952,1489,43791,fhi:git
county,Innlandet,2021-02-27,3,1,29028,14767,7.83264031861588,3.98458728072897,4,43795,fhi:git
county,Innlandet,2021-02-28,3,6,29031,14773,7.83344981017423,3.98620626384568,9,43804,fhi:git
county,Innlandet,2021-03-01,189,7,29220,14780,7.88444777835042,3.98809507748183,196,44000,fhi:git
county,Innlandet,2021-03-02,527,159,29747,14939,8.02664846210096,4.0309981300745,686,44686,fhi:git
county,Innlandet,2021-03-03,1598,1969,31345,16908,8.45783763218322,4.56229442287299,3567,48253,fhi:git
county,Innlandet,2021-03-04,1520,2263,32865,19171,8.86798002174834,5.17292088839,3783,52036,fhi:git
county,Innlandet,2021-03-05,547,421,33412,19592,9.01557731588789,5.28651953707876,968,53004,fhi:git
county,Innlandet,2021-03-06,7,3,33419,19595,9.01746612952405,5.28732902863711,10,53014,fhi:git
county,Innlandet,2021-03-07,0,0,33419,19595,9.01746612952405,5.28732902863711,0,53014,fhi:git
county,Innlandet,2021-03-08,112,0,33531,19595,9.04768714770253,5.28732902863711,112,53126,fhi:git
county,Innlandet,2021-03-09,936,311,34467,19906,9.30024851390841,5.37124632018629,1247,54373,fhi:git
county,Innlandet,2021-03-10,2024,1308,36491,21214,9.8463854852767,5.72418463962785,3332,57705,fhi:git
county,Innlandet,2021-03-11,1015,968,37506,22182,10.1202634625192,5.98538058245616,1983,59688,fhi:git
county,Innlandet,2021-03-12,43,180,37549,22362,10.1318661748556,6.03395007595729,223,59911,fhi:git
county,Innlandet,2021-03-13,0,0,37549,22362,10.1318661748556,6.03395007595729,0,59911,fhi:git
county,Innlandet,2021-03-14,0,7,37549,22369,10.1318661748556,6.03583888959345,7,59918,fhi:git
county,Innlandet,2021-03-15,25,3,37574,22372,10.1386119378418,6.0366483811518,28,59946,fhi:git
county,Innlandet,2021-03-16,360,9,37934,22381,10.2357509248441,6.03907685582686,369,60315,fhi:git
county,Innlandet,2021-03-17,1803,152,39737,22533,10.7222553514138,6.08009109478337,1955,62270,fhi:git
county,Innlandet,2021-03-18,1650,104,41387,22637,11.1674757085075,6.10815346880624,1754,64024,fhi:git
county,Innlandet,2021-03-19,189,20,41576,22657,11.2184736766837,6.11355007919526,209,64233,fhi:git
county,Innlandet,2021-03-20,0,0,41576,22657,11.2184736766837,6.11355007919526,0,64233,fhi:git
county,Innlandet,2021-03-21,1,0,41577,22657,11.2187435072031,6.11355007919526,1,64234,fhi:git
county,Innlandet,2021-03-22,98,9,41675,22666,11.2451868981093,6.11597855387031,107,64341,fhi:git
county,Innlandet,2021-03-23,809,51,42484,22717,11.4634797883449,6.1297399103623,860,65201,fhi:git
county,Innlandet,2021-03-24,3234,519,45718,23236,12.3361116882486,6.26978194995723,3753,68954,fhi:git
county,Innlandet,2021-03-25,3194,318,48912,23554,13.1979503673743,6.35558805514257,3512,72466,fhi:git
county,Innlandet,2021-03-26,610,52,49522,23606,13.3625469842392,6.369619242154,662,73128,fhi:git
county,Innlandet,2021-03-27,0,0,49522,23606,13.3625469842392,6.369619242154,0,73128,fhi:git
county,Innlandet,2021-03-28,0,0,49522,23606,13.3625469842392,6.369619242154,0,73128,fhi:git
county,Innlandet,2021-03-29,291,2,49813,23608,13.4410676653994,6.3701589031929,293,73421,fhi:git
county,Innlandet,2021-03-30,2299,205,52112,23813,14.0614080296166,6.4254741596803,2504,75925,fhi:git
county,Møre og Romsdal,2020-12-27,0,0,0,0,0.0,0.0,0,0,fhi:git
county,Møre og Romsdal,2020-12-28,1,0,1,0,0.0003770198840286,0.0,1,1,fhi:git
county,Møre og Romsdal,2020-12-29,0,0,1,0,0.0003770198840286,0.0,0,1,fhi:git
county,Møre og Romsdal,2020-12-30,0,0,1,0,0.0003770198840286,0.0,0,1,fhi:git
county,Møre og Romsdal,2020-12-31,0,0,1,0,0.0003770198840286,0.0,0,1,fhi:git
county,Møre og Romsdal,2021-01-01,0,0,1,0,0.0003770198840286,0.0,0,1,fhi:git
county,Møre og Romsdal,2021-01-02,0,0,1,0,0.0003770198840286,0.0,0,1,fhi:git
county,Møre og Romsdal,2021-01-03,0,0,1,0,0.0003770198840286,0.0,0,1,fhi:git
county,Møre og Romsdal,2021-01-04,0,0,1,0,0.0003765854246377,0.0,0,1,fhi:git
county,Møre og Romsdal,2021-01-05,186,0,187,0,0.0704214744072545,0.0,186,187,fhi:git
county,Møre og Romsdal,2021-01-06,496,0,683,0,0.257207845027566,0.0,496,683,fhi:git
county,Møre og Romsdal,2021-01-07,457,0,1140,0,0.429307384087006,0.0,457,1140,fhi:git
county,Møre og Romsdal,2021-01-08,36,0,1176,0,0.442864459373964,0.0,36,1176,fhi:git
county,Møre og Romsdal,2021-01-09,1,0,1177,0,0.443241044798602,0.0,1,1177,fhi:git
county,Møre og Romsdal,2021-01-10,0,0,1177,0,0.443241044798602,0.0,0,1177,fhi:git
county,Møre og Romsdal,2021-01-11,1,0,1178,0,0.44361763022324,0.0,1,1178,fhi:git
county,Møre og Romsdal,2021-01-12,225,0,1403,0,0.528349350766728,0.0,225,1403,fhi:git
county,Møre og Romsdal,2021-01-13,387,0,1790,0,0.674087910101528,0.0,387,1790,fhi:git
county,Møre og Romsdal,2021-01-14,410,0,2200,0,0.828487934202995,0.0,410,2200,fhi:git
county,Møre og Romsdal,2021-01-15,151,0,2351,0,0.885352333323291,0.0,151,2351,fhi:git
county,Møre og Romsdal,2021-01-16,1,0,2352,0,0.885728918747929,0.0,1,2352,fhi:git
county,Møre og Romsdal,2021-01-17,2,0,2354,0,0.886482089597204,0.0,2,2354,fhi:git
county,Møre og Romsdal,2021-01-18,11,0,2365,0,0.890624529268219,0.0,11,2365,fhi:git
county,Møre og Romsdal,2021-01-19,203,0,2568,0,0.967071370469677,0.0,203,2568,fhi:git
county,Møre og Romsdal,2021-01-20,501,0,3069,0,1.15574066821318,0.0,501,3069,fhi:git
county,Møre og Romsdal,2021-01-21,800,0,3869,0,1.45700900792336,0.0,800,3869,fhi:git
county,Møre og Romsdal,2021-01-22,212,0,4081,0,1.53684511794656,0.0,212,4081,fhi:git
county,Møre og Romsdal,2021-01-23,0,0,4081,0,1.53684511794656,0.0,0,4081,fhi:git
county,Møre og Romsdal,2021-01-24,0,0,4081,0,1.53684511794656,0.0,0,4081,fhi:git
county,Møre og Romsdal,2021-01-25,3,0,4084,0,1.53797487422047,0.0,3,4084,fhi:git
county,Møre og Romsdal,2021-01-26,78,129,4162,129,1.56734853734221,0.0485795197782665,207,4291,fhi:git
county,Møre og Romsdal,2021-01-27,543,358,4705,487,1.7718344229205,0.183397101798572,901,5192,fhi:git
county,Møre og Romsdal,2021-01-28,493,509,5198,996,1.95749103726689,0.375079082939174,1002,6194,fhi:git
county,Møre og Romsdal,2021-01-29,99,78,5297,1074,1.99477299430603,0.404452746060916,177,6371,fhi:git
county,Møre og Romsdal,2021-01-30,0,1,5297,1075,1.99477299430603,0.404829331485554,1,6372,fhi:git
county,Møre og Romsdal,2021-01-31,0,0,5297,1075,1.99477299430603,0.404829331485554,0,6372,fhi:git
county,Møre og Romsdal,2021-02-01,0,0,5297,1075,1.99477299430603,0.404829331485554,0,6372,fhi:git
county,Møre og Romsdal,2021-02-02,291,193,5588,1268,2.10435935287561,0.477510318440635,484,6856,fhi:git
county,Møre og Romsdal,2021-02-03,1063,312,6651,1580,2.50466965926551,0.595004970927605,1375,8231,fhi:git
county,Møre og Romsdal,2021-02-04,1545,463,8196,2043,3.08649414033079,0.769364022534872,2008,10239,fhi:git
county,Møre og Romsdal,2021-02-05,219,155,8415,2198,3.16896634832645,0.827734763353719,374,10613,fhi:git
county,Møre og Romsdal,2021-02-06,1,2,8416,2200,3.16934293375109,0.828487934202995,3,10616,fhi:git
county,Møre og Romsdal,2021-02-07,0,1,8416,2201,3.16934293375109,0.828864519627632,1,10617,fhi:git
county,Møre og Romsdal,2021-02-08,1,2,8417,2203,3.16971951917573,0.829617690476908,3,10620,fhi:git
county,Møre og Romsdal,2021-02-09,326,183,8743,2386,3.29248636760763,0.898532823185611,509,11129,fhi:git
county,Møre og Romsdal,2021-02-10,1258,436,10001,2822,3.76623083180189,1.06272406832766,1694,12823,fhi:git
county,Møre og Romsdal,2021-02-11,1254,804,11255,3626,4.23846895429759,1.36549874973639,2058,14881,fhi:git
county,Møre og Romsdal,2021-02-12,295,207,11550,3833,4.34956165456572,1.4434519326364,502,15383,fhi:git
county,Møre og Romsdal,2021-02-13,24,0,11574,3833,4.35859970475703,1.4434519326364,24,15407,fhi:git
county,Møre og Romsdal,2021-02-14,0,0,11574,3833,4.35859970475703,1.4434519326364,0,15407,fhi:git
county,Møre og Romsdal,2021-02-15,1,8,11575,3841,4.35897629018166,1.4464646160335,9,15416,fhi:git
county,Møre og Romsdal,2021-02-16,354,58,11929,3899,4.49228753050342,1.46830657066249,412,15828,fhi:git
county,Møre og Romsdal,2021-02-17,1204,424,13133,4323,4.94569638176724,1.62797879070888,1628,17456,fhi:git
county,Møre og Romsdal,2021-02-18,1165,522,14298,4845,5.38441840147019,1.82455638236978,1687,19143,fhi:git
county,Møre og Romsdal,2021-02-19,499,94,14797,4939,5.57233452836441,1.85995541228572,593,19736,fhi:git
county,Møre og Romsdal,2021-02-20,11,0,14808,4939,5.57647696803543,1.85995541228572,11,19747,fhi:git
county,Møre og Romsdal,2021-02-21,0,0,14808,4939,5.57647696803543,1.85995541228572,0,19747,fhi:git
county,Møre og Romsdal,2021-02-22,15,0,14823,4939,5.582125749405,1.85995541228572,15,19762,fhi:git
county,Møre og Romsdal,2021-02-23,392,223,15215,5162,5.72974723586298,1.94393396197994,615,20377,fhi:git
county,Møre og Romsdal,2021-02-24,729,876,15944,6038,6.00427801042388,2.27382279396258,1605,21982,fhi:git
county,Møre og Romsdal,2021-02-25,704,1474,16648,7512,6.26939414936884,2.82890970987859,2178,24160,fhi:git
county,Møre og Romsdal,2021-02-26,260,203,16908,7715,6.36730635977465,2.90535655108005,463,24623,fhi:git
county,Møre og Romsdal,2021-02-27,2,1,16910,7716,6.36805953062393,2.90573313650468,3,24626,fhi:git
county,Møre og Romsdal,2021-02-28,0,0,16910,7716,6.36805953062393,2.90573313650468,0,24626,fhi:git
county,Møre og Romsdal,2021-03-01,101,1,17011,7717,6.40609465851234,2.90610972192932,102,24728,fhi:git
county,Møre og Romsdal,2021-03-02,741,251,17752,7968,6.68514445816889,3.00063266351339,992,25720,fhi:git
county,Møre og Romsdal,2021-03-03,869,1116,18621,9084,7.01239719217907,3.42090199740909,1985,27705,fhi:git
county,Møre og Romsdal,2021-03-04,988,1303,19609,10387,7.38446359172115,3.91159280571205,2291,29996,fhi:git
county,Møre og Romsdal,2021-03-05,815,274,20424,10661,7.69138071280089,4.01477721206278,1089,31085,fhi:git
county,Møre og Romsdal,2021-03-06,3,6,20427,10667,7.69251046907481,4.01703672461061,9,31094,fhi:git
county,Møre og Romsdal,2021-03-07,0,0,20427,10667,7.69251046907481,4.01703672461061,0,31094,fhi:git
county,Møre og Romsdal,2021-03-08,157,0,20584,10667,7.75163438074293,4.01703672461061,157,31251,fhi:git
county,Møre og Romsdal,2021-03-09,670,238,21254,10905,8.0039466152502,4.10666405567439,908,32159,fhi:git
county,Møre og Romsdal,2021-03-10,1286,946,22540,11851,8.48823547133432,4.46291386738168,2232,34391,fhi:git
county,Møre og Romsdal,2021-03-11,539,973,23079,12824,8.69121501521405,4.82933148555418,1512,35903,fhi:git
county,Møre og Romsdal,2021-03-12,67,248,23146,13072,8.71644623866478,4.92272467086434,315,36218,fhi:git
county,Møre og Romsdal,2021-03-13,0,16,23146,13088,8.71644623866478,4.92875003765854,16,36234,fhi:git
county,Møre og Romsdal,2021-03-14,0,0,23146,13088,8.71644623866478,4.92875003765854,0,36234,fhi:git
county,Møre og Romsdal,2021-03-15,0,1,23146,13089,8.71644623866478,4.92912662308318,1,36235,fhi:git
county,Møre og Romsdal,2021-03-16,334,10,23480,13099,8.84222577049378,4.93289247732956,344,36579,fhi:git
county,Møre og Romsdal,2021-03-17,1536,128,25016,13227,9.42066098273732,4.98109541168319,1664,38243,fhi:git
county,Møre og Romsdal,2021-03-18,1485,60,26501,13287,9.97989033832435,5.00369053716145,1545,39788,fhi:git
county,Møre og Romsdal,2021-03-19,205,37,26706,13324,10.0570903503751,5.01762419787305,242,40030,fhi:git
county,Møre og Romsdal,2021-03-20,18,0,26724,13324,10.0638688880186,5.01762419787305,18,40048,fhi:git
county,Møre og Romsdal,2021-03-21,0,0,26724,13324,10.0638688880186,5.01762419787305,0,40048,fhi:git
county,Møre og Romsdal,2021-03-22,1,7,26725,13331,10.0642454734432,5.02026029584551,8,40056,fhi:git
county,Møre og Romsdal,2021-03-23,600,19,27325,13350,10.2901967282258,5.02741541891363,619,40675,fhi:git
county,Møre og Romsdal,2021-03-24,1808,48,29133,13398,10.9710631759708,5.04549151929624,1856,42531,fhi:git
county,Møre og Romsdal,2021-03-25,2316,70,31449,13468,11.8432350194318,5.07185249902088,2386,44917,fhi:git
county,Møre og Romsdal,2021-03-26,225,19,31674,13487,11.9279667399753,5.079007622089,244,45161,fhi:git
county,Møre og Romsdal,2021-03-27,25,1,31699,13488,11.9373813755912,5.07938420751363,26,45187,fhi:git
county,Møre og Romsdal,2021-03-28,0,0,31699,13488,11.9373813755912,5.07938420751363,0,45187,fhi:git
county,Møre og Romsdal,2021-03-29,7,0,31706,13488,11.9400174735637,5.07938420751363,7,45194,fhi:git
county,Møre og Romsdal,2021-03-30,1846,90,33552,13578,12.6351941674449,5.11327689573103,1936,47130,fhi:git
county,Nordland,2020-12-27,0,0,0,0,0.0,0.0,0,0,fhi:git
county,Nordland,2020-12-28,0,0,0,0,0.0,0.0,0,0,fhi:git
county,Nordland,2020-12-29,0,0,0,0,0.0,0.0,0,0,fhi:git
county,Nordland,2020-12-30,1,0,1,0,0.0004145335461272,0.0,1,1,fhi:git
county,Nordland,2020-12-31,0,0,1,0,0.0004145335461272,0.0,0,1,fhi:git
county,Nordland,2021-01-01,0,0,1,0,0.0004145335461272,0.0,0,1,fhi:git
county,Nordland,2021-01-02,0,0,1,0,0.0004145335461272,0.0,0,1,fhi:git
county,Nordland,2021-01-03,0,0,1,0,0.0004145335461272,0.0,0,1,fhi:git
county,Nordland,2021-01-04,0,0,1,0,0.0004160685681,0.0,0,1,fhi:git
county,Nordland,2021-01-05,200,0,201,0,0.0836297821881046,0.0,200,201,fhi:git
county,Nordland,2021-01-06,686,0,887,0,0.36905281990472,0.0,686,887,fhi:git
county,Nordland,2021-01-07,238,0,1125,0,0.468077139112526,0.0,238,1125,fhi:git
county,Nordland,2021-01-08,114,0,1239,0,0.515508955875928,0.0,114,1239,fhi:git
county,Nordland,2021-01-09,0,0,1239,0,0.515508955875928,0.0,0,1239,fhi:git
county,Nordland,2021-01-10,0,0,1239,0,0.515508955875928,0.0,0,1239,fhi:git
county,Nordland,2021-01-11,0,0,1239,0,0.515508955875928,0.0,0,1239,fhi:git
county,Nordland,2021-01-12,292,0,1531,0,0.637000977761135,0.0,292,1531,fhi:git
county,Nordland,2021-01-13,627,0,2158,0,0.897875969959849,0.0,627,2158,fhi:git
county,Nordland,2021-01-14,272,0,2430,0,1.01104662048306,0.0,272,2430,fhi:git
county,Nordland,2021-01-15,69,0,2499,0,1.03975535168196,0.0,69,2499,fhi:git
county,Nordland,2021-01-16,0,0,2499,0,1.03975535168196,0.0,0,2499,fhi:git
county,Nordland,2021-01-17,1,0,2500,0,1.04017142025006,0.0,1,2500,fhi:git
county,Nordland,2021-01-18,0,0,2500,0,1.04017142025006,0.0,0,2500,fhi:git
county,Nordland,2021-01-19,313,0,2813,0,1.17040088206536,0.0,313,2813,fhi:git
county,Nordland,2021-01-20,786,0,3599,0,1.49743077659198,0.0,786,3599,fhi:git
county,Nordland,2021-01-21,616,0,4215,0,1.7537290145416,0.0,616,4215,fhi:git
county,Nordland,2021-01-22,173,0,4388,0,1.8257088768229,0.0,173,4388,fhi:git
county,Nordland,2021-01-23,4,0,4392,0,1.8273731510953,0.0,4,4392,fhi:git
county,Nordland,2021-01-24,0,0,4392,0,1.8273731510953,0.0,0,4392,fhi:git
county,Nordland,2021-01-25,51,0,4443,0,1.8485926480684,0.0,51,4443,fhi:git
county,Nordland,2021-01-26,119,90,4562,90,1.8981048076723,0.0374461711290021,209,4652,fhi:git
county,Nordland,2021-01-27,626,528,5188,618,2.15856373130292,0.257130375085814,1154,5806,fhi:git
county,Nordland,2021-01-28,471,365,5659,983,2.35453202687803,0.408995402442323,836,6642,fhi:git
county,Nordland,2021-01-29,212,144,5871,1127,2.44273856331523,0.468909276248726,356,6998,fhi:git
county,Nordland,2021-01-30,1,0,5872,1127,2.44315463188333,0.468909276248726,1,6999,fhi:git
county,Nordland,2021-01-31,0,0,5872,1127,2.44315463188333,0.468909276248726,0,6999,fhi:git
county,Nordland,2021-02-01,9,4,5881,1131,2.44689924899624,0.470573550521126,13,7012,fhi:git
county,Nordland,2021-02-02,111,200,5992,1331,2.49308286005534,0.553787264141131,311,7323,fhi:git
county,Nordland,2021-02-03,1419,456,7411,1787,3.08348415818927,0.743514531194741,1875,9198,fhi:git
county,Nordland,2021-02-04,1670,347,9081,2134,3.77831866691631,0.887890324325449,2017,11215,fhi:git
county,Nordland,2021-02-05,329,155,9410,2289,3.91520522582122,0.952380952380952,484,11699,fhi:git
county,Nordland,2021-02-06,0,0,9410,2289,3.91520522582122,0.952380952380952,0,11699,fhi:git
county,Nordland,2021-02-07,1,0,9411,2289,3.91562129438932,0.952380952380952,1,11700,fhi:git
county,Nordland,2021-02-08,7,1,9418,2290,3.91853377436602,0.952797020949052,8,11708,fhi:git
county,Nordland,2021-02-09,70,262,9488,2552,3.94765857413302,1.06180698579126,332,12040,fhi:git
county,Nordland,2021-02-10,2030,633,11518,3185,4.79227776737606,1.32517838939857,2663,14703,fhi:git
county,Nordland,2021-02-11,1222,583,12740,3768,5.30071355759429,1.56774636460089,1805,16508,fhi:git
county,Nordland,2021-02-12,287,238,13027,4006,5.420125236639,1.66677068380869,525,17033,fhi:git
county,Nordland,2021-02-13,53,3,13080,4009,5.4421768707483,1.66801888951299,56,17089,fhi:git
county,Nordland,2021-02-14,0,0,13080,4009,5.4421768707483,1.66801888951299,0,17089,fhi:git
county,Nordland,2021-02-15,0,1,13080,4010,5.4421768707483,1.66843495808109,1,17090,fhi:git
county,Nordland,2021-02-16,223,71,13303,4081,5.5349601614346,1.69797582641619,294,17384,fhi:git
county,Nordland,2021-02-17,1490,515,14793,4596,6.15490232790364,1.91225113898771,2005,19389,fhi:git
county,Nordland,2021-02-18,849,607,15642,5203,6.50814454222056,2.16480475982442,1456,20845,fhi:git
county,Nordland,2021-02-19,306,231,15948,5434,6.63546152405917,2.26091659905552,537,21382,fhi:git
county,Nordland,2021-02-20,1,1,15949,5435,6.63587759262727,2.26133266762362,2,21384,fhi:git
county,Nordland,2021-02-21,0,0,15949,5435,6.63587759262727,2.26133266762362,0,21384,fhi:git
county,Nordland,2021-02-22,270,0,16219,5435,6.74821610601427,2.26133266762362,270,21654,fhi:git
county,Nordland,2021-02-23,308,56,16527,5491,6.87636522498908,2.28463250743723,364,22018,fhi:git
county,Nordland,2021-02-24,973,1008,17500,6499,7.2811999417504,2.70402962408205,1981,23999,fhi:git
county,Nordland,2021-02-25,591,1849,18091,8348,7.52709646549751,3.47334040649899,2440,26439,fhi:git
county,Nordland,2021-02-26,423,396,18514,8744,7.70309346980382,3.6381035594666,819,27258,fhi:git
county,Nordland,2021-02-27,1,4,18515,8748,7.70350953837192,3.639767833739,5,27263,fhi:git
county,Nordland,2021-02-28,0,1,18515,8749,7.70350953837192,3.6401839023071,1,27264,fhi:git
county,Nordland,2021-03-01,240,0,18755,8749,7.80336599471593,3.6401839023071,240,27504,fhi:git
county,Nordland,2021-03-02,517,50,19272,8799,8.01847344442364,3.6609873307121,567,28071,fhi:git
county,Nordland,2021-03-03,621,1582,19893,10381,8.27685202521376,4.31920780544634,2203,30274,fhi:git
county,Nordland,2021-03-04,718,1366,20611,11747,8.57558925710957,4.88755746947097,2084,32358,fhi:git
county,Nordland,2021-03-05,440,339,21051,12086,8.75865942707358,5.02860471405688,779,33137,fhi:git
county,Nordland,2021-03-06,13,51,21064,12137,8.76406831845888,5.04982421102998,64,33201,fhi:git
county,Nordland,2021-03-07,0,0,21064,12137,8.76406831845888,5.04982421102998,0,33201,fhi:git
county,Nordland,2021-03-08,360,0,21424,12137,8.91385300297489,5.04982421102998,360,33561,fhi:git
county,Nordland,2021-03-09,653,51,22077,12188,9.18554577794421,5.07104370800308,704,34265,fhi:git
county,Nordland,2021-03-10,1208,1184,23285,13372,9.68815660820903,5.56366889263351,2392,36657,fhi:git
county,Nordland,2021-03-11,730,989,24015,14361,9.99188666292205,5.97516070648443,1719,38376,fhi:git
county,Nordland,2021-03-12,70,252,24085,14613,10.0210114626891,6.08000998564564,322,38698,fhi:git
county,Nordland,2021-03-13,3,2,24088,14615,10.0222596683934,6.08084212278183,5,38703,fhi:git
county,Nordland,2021-03-14,0,0,24088,14615,10.0222596683934,6.08084212278183,0,38703,fhi:git
county,Nordland,2021-03-15,0,1,24088,14616,10.0222596683934,6.08125819134993,1,38704,fhi:git
county,Nordland,2021-03-16,118,5,24206,14621,10.0713557594292,6.08333853419043,123,38827,fhi:git
county,Nordland,2021-03-17,902,64,25108,14685,10.4466496078554,6.10996692254884,966,39793,fhi:git
county,Nordland,2021-03-18,1162,73,26270,14758,10.9301212839876,6.14033992802014,1235,41028,fhi:git
county,Nordland,2021-03-19,226,28,26496,14786,11.0241527803782,6.15198984792694,254,41282,fhi:git
county,Nordland,2021-03-20,39,0,26535,14786,11.0403794545341,6.15198984792694,39,41321,fhi:git
county,Nordland,2021-03-21,0,0,26535,14786,11.0403794545341,6.15198984792694,0,41321,fhi:git
county,Nordland,2021-03-22,36,2,26571,14788,11.0553579229857,6.15282198506314,38,41359,fhi:git
county,Nordland,2021-03-23,560,8,27131,14796,11.2883563211217,6.15615053360794,568,41927,fhi:git
county,Nordland,2021-03-24,2159,48,29290,14844,12.1866483596497,6.17612182487674,2207,44134,fhi:git
county,Nordland,2021-03-25,1586,62,30876,14906,12.8465331086563,6.20191807609894,1648,45782,fhi:git
county,Nordland,2021-03-26,337,11,31213,14917,12.986748216106,6.20649483034804,348,46130,fhi:git
county,Nordland,2021-03-27,0,0,31213,14917,12.986748216106,6.20649483034804,0,46130,fhi:git
county,Nordland,2021-03-28,0,0,31213,14917,12.986748216106,6.20649483034804,0,46130,fhi:git
county,Nordland,2021-03-29,9,1,31222,14918,12.9904928332189,6.20691089891614,10,46140,fhi:git
county,Nordland,2021-03-30,1464,93,32686,15011,13.5996172169173,6.24560527574944,1557,47697,fhi:git
county,Oslo,2020-12-27,5,0,5,0,0.0007209867713347,0.0,5,5,fhi:git
county,Oslo,2020-12-28,264,0,269,0,0.0387890882978079,0.0,264,269,fhi:git
county,Oslo,2020-12-29,118,0,387,0,0.0558043761013073,0.0,118,387,fhi:git
county,Oslo,2020-12-30,58,0,445,0,0.06416782264879,0.0,58,445,fhi:git
county,Oslo,2020-12-31,5,0,450,0,0.0648888094201248,0.0,5,450,fhi:git
county,Oslo,2021-01-01,6,0,456,0,0.0657539935457264,0.0,6,456,fhi:git
county,Oslo,2021-01-02,0,0,456,0,0.0657539935457264,0.0,0,456,fhi:git
county,Oslo,2021-01-03,0,0,456,0,0.0657539935457264,0.0,0,456,fhi:git
county,Oslo,2021-01-04,0,0,456,0,0.065422303840691,0.0,0,456,fhi:git
county,Oslo,2021-01-05,479,0,935,0,0.134144416866329,0.0,479,935,fhi:git
county,Oslo,2021-01-06,603,0,1538,0,0.220656805497769,0.0,603,1538,fhi:git
county,Oslo,2021-01-07,966,0,2504,0,0.359248791265549,0.0,966,2504,fhi:git
county,Oslo,2021-01-08,450,0,2954,0,0.423810275318862,0.0,450,2954,fhi:git
county,Oslo,2021-01-09,127,0,3081,0,0.442030960818353,0.0,127,3081,fhi:git
county,Oslo,2021-01-10,100,0,3181,0,0.456377957274645,0.0,100,3181,fhi:git
county,Oslo,2021-01-11,78,0,3259,0,0.467568614510552,0.0,78,3259,fhi:git
county,Oslo,2021-01-12,241,0,3500,0,0.502144875970216,0.0,241,3500,fhi:git
county,Oslo,2021-01-13,489,0,3989,0,0.572301688641483,0.0,489,3989,fhi:git
county,Oslo,2021-01-14,1239,0,5228,0,0.750060974734939,0.0,1239,5228,fhi:git
county,Oslo,2021-01-15,1636,0,6864,0,0.984777836759874,0.0,1636,6864,fhi:git
county,Oslo,2021-01-16,643,0,7507,0,1.07702902397383,0.0,643,7507,fhi:git
county,Oslo,2021-01-17,276,5,7783,5,1.1166267341932,0.0007173498228145,281,7788,fhi:git
county,Oslo,2021-01-18,759,231,8542,236,1.22552043729645,0.0338589116368488,990,8778,fhi:git
county,Oslo,2021-01-19,811,70,9353,306,1.34187457855698,0.0439018091562531,881,9659,fhi:git
county,Oslo,2021-01-20,991,99,10344,405,1.48405331343883,0.0581053356479821,1090,10749,fhi:git
county,Oslo,2021-01-21,1022,21,11366,426,1.63067961722213,0.0611182049038034,1043,11792,fhi:git
county,Oslo,2021-01-22,669,6,12035,432,1.72666102351473,0.0619790246911809,675,12467,fhi:git
county,Oslo,2021-01-23,232,0,12267,432,1.75994605529332,0.0619790246911809,232,12699,fhi:git
county,Oslo,2021-01-24,67,0,12334,432,1.76955854291904,0.0619790246911809,67,12766,fhi:git
county,Oslo,2021-01-25,258,0,12592,432,1.80657379377627,0.0619790246911809,258,13024,fhi:git
county,Oslo,2021-01-26,312,404,12904,836,1.8513364227199,0.1199408903746,716,13740,fhi:git
county,Oslo,2021-01-27,1035,528,13939,1364,1.99982783604252,0.195693031663821,1563,15303,fhi:git
county,Oslo,2021-01-28,870,842,14809,2206,2.12464670521226,0.316494741825799,1712,17015,fhi:git
county,Oslo,2021-01-29,427,504,15236,2710,2.18590838008063,0.38880360396551,931,17946,fhi:git
county,Oslo,2021-01-30,94,152,15330,2862,2.19939455674954,0.410611038579073,246,18192,fhi:git
county,Oslo,2021-01-31,61,45,15391,2907,2.20814622458788,0.417067186984405,106,18298,fhi:git
county,Oslo,2021-02-01,53,48,15444,2955,2.21575013270972,0.423953745283425,101,18399,fhi:git
county,Oslo,2021-02-02,1523,151,16967,3106,2.43425488873904,0.445617709932426,1674,20073,fhi:git
county,Oslo,2021-02-03,2456,456,19423,3562,2.78661712170557,0.511040013773117,2912,22985,fhi:git
county,Oslo,2021-02-04,2051,1236,21474,4798,3.08087401902412,0.688368889972884,3287,26272,fhi:git
county,Oslo,2021-02-05,1383,1567,22857,6365,3.27929298001463,0.913186324442978,2950,29222,fhi:git
county,Oslo,2021-02-06,243,630,23100,6995,3.31415618140342,1.00357240211762,873,30095,fhi:git
county,Oslo,2021-02-07,215,270,23315,7265,3.34500222378445,1.0423092925496,485,30580,fhi:git
county,Oslo,2021-02-08,46,443,23361,7708,3.35160184215435,1.10586648685098,489,31069,fhi:git
county,Oslo,2021-02-09,1166,245,24527,7953,3.51888782083471,1.14101662816889,1411,32480,fhi:git
county,Oslo,2021-02-10,1830,812,26357,8765,3.78143785598485,1.25751423939398,2642,35122,fhi:git
county,Oslo,2021-02-11,1584,746,27941,9511,4.00869427985251,1.36454283295792,2330,37452,fhi:git
county,Oslo,2021-02-12,1358,424,29299,9935,4.20352649172896,1.4253740979326,1782,39234,fhi:git
county,Oslo,2021-02-13,273,193,29572,10128,4.24269379205463,1.45306380109324,466,39700,fhi:git
county,Oslo,2021-02-14,103,0,29675,10128,4.25747119840461,1.45306380109324,103,39803,fhi:git
county,Oslo,2021-02-15,261,444,29936,10572,4.29491685915554,1.51676446535918,705,40508,fhi:git
county,Oslo,2021-02-16,723,771,30659,11343,4.39864564353453,1.62737980803719,1494,42002,fhi:git
county,Oslo,2021-02-17,1461,1081,32120,12424,4.60825526176095,1.7824708397297,2542,44544,fhi:git
county,Oslo,2021-02-18,1072,920,33192,13344,4.7620550637724,1.91446320712759,1992,46536,fhi:git
county,Oslo,2021-02-19,1493,970,34685,14314,4.97625572086484,2.05362907275362,2463,48999,fhi:git
county,Oslo,2021-02-20,100,114,34785,14428,4.99060271732113,2.06998464871379,214,49213,fhi:git
county,Oslo,2021-02-21,4,61,34789,14489,4.99117659717938,2.07873631655213,65,49278,fhi:git
county,Oslo,2021-02-22,603,112,35392,14601,5.07768898581082,2.09480495258318,715,49993,fhi:git
county,Oslo,2021-02-23,339,1527,35731,16128,5.12632530379765,2.31388358847075,1866,51859,fhi:git
county,Oslo,2021-02-24,687,2341,36418,18469,5.22488916945238,2.64974677551255,3028,54887,fhi:git
county,Oslo,2021-02-25,597,1952,37015,20421,5.31054073829644,2.92980014633936,2549,57436,fhi:git
county,Oslo,2021-02-26,766,1373,37781,21794,5.42043873115163,3.12678440768425,2139,59575,fhi:git
county,Oslo,2021-02-27,258,103,38039,21897,5.45745398200887,3.14156181403423,361,59936,fhi:git
county,Oslo,2021-02-28,101,62,38140,21959,5.47194444842972,3.15045695183713,163,60099,fhi:git
county,Oslo,2021-03-01,1041,38,39181,21997,5.62129668153972,3.15590881049052,1079,61178,fhi:git
county,Oslo,2021-03-02,767,136,39948,22133,5.73133814435948,3.17542072567108,903,62081,fhi:git
county,Oslo,2021-03-03,1360,168,41308,22301,5.92645729616505,3.19952367971765,1528,63609,fhi:git
county,Oslo,2021-03-04,1181,203,42489,22504,6.09589532431386,3.22864808252392,1384,64993,fhi:git
county,Oslo,2021-03-05,1289,67,43778,22571,6.28082810863546,3.23826057014964,1356,66349,fhi:git
county,Oslo,2021-03-06,102,3,43880,22574,6.29546204502088,3.23869098004333,105,66454,fhi:git
county,Oslo,2021-03-07,69,0,43949,22574,6.30536147257572,3.23869098004333,69,66523,fhi:git
county,Oslo,2021-03-08,651,10,44600,22584,6.39876041950618,3.24012567968896,661,67184,fhi:git
county,Oslo,2021-03-09,775,1329,45375,23913,6.50994964204244,3.43079726259308,2104,69288,fhi:git
county,Oslo,2021-03-10,1192,2390,46567,26303,6.68096583980144,3.77369047789845,3582,72870,fhi:git
county,Oslo,2021-03-11,875,2371,47442,28674,6.80650205879399,4.11385776387713,3246,76116,fhi:git
county,Oslo,2021-03-12,278,1636,47720,30310,6.84638670894248,4.34857462590207,1914,78030,fhi:git
county,Oslo,2021-03-13,15,266,47735,30576,6.84853875841093,4.3867376364758,281,78311,fhi:git
county,Oslo,2021-03-14,1,97,47736,30673,6.84868222837549,4.40065422303841,98,78409,fhi:git
county,Oslo,2021-03-15,24,358,47760,31031,6.852125507525,4.45201647035193,382,78791,fhi:git
county,Oslo,2021-03-16,1009,119,48769,31150,6.99688670176898,4.46908939613492,1128,79919,fhi:git
county,Oslo,2021-03-17,2738,93,51507,31243,7.38970746474226,4.48243210283927,2831,82750,fhi:git
county,Oslo,2021-03-18,2026,112,53533,31355,7.68037761294673,4.49850073887032,2138,84888,fhi:git
county,Oslo,2021-03-19,1994,186,55527,31541,7.96645672228519,4.52518615227902,2180,87068,fhi:git
county,Oslo,2021-03-20,394,18,55921,31559,8.02298388832298,4.52776861164115,412,87480,fhi:git
county,Oslo,2021-03-21,162,14,56083,31573,8.04622602258217,4.52977719114503,176,87656,fhi:git
county,Oslo,2021-03-22,936,11,57019,31584,8.18051390941307,4.53135536075523,947,88603,fhi:git
county,Oslo,2021-03-23,3314,104,60333,31688,8.65597337197458,4.54627623706977,3418,92021,fhi:git
county,Oslo,2021-03-24,5124,213,65457,31901,9.39111347039497,4.57683533952167,5337,97358,fhi:git
county,Oslo,2021-03-25,5121,48,70578,31949,10.1258231589217,4.58372189782069,5169,102527,fhi:git
county,Oslo,2021-03-26,4143,82,74721,32031,10.7202192221059,4.59548643491485,4225,106752,fhi:git
county,Oslo,2021-03-27,533,1,75254,32032,10.7966887132179,4.59562990487941,534,107286,fhi:git
county,Oslo,2021-03-28,151,0,75405,32032,10.8183526778669,4.59562990487941,151,107437,fhi:git
county,Oslo,2021-03-29,2182,9,77587,32041,11.1314041405432,4.59692113456048,2191,109628,fhi:git
county,Oslo,2021-03-30,4149,208,81736,32249,11.7266610235147,4.62676288718957,4357,113985,fhi:git
county,Rogaland,2020-12-27,0,0,0,0,0.0,0.0,0,0,fhi:git
county,Rogaland,2020-12-28,1,0,1,0,0.0002083802188825,0.0,1,1,fhi:git
county,Rogaland,2020-12-29,0,0,1,0,0.0002083802188825,0.0,0,1,fhi:git
county,Rogaland,2020-12-30,0,0,1,0,0.0002083802188825,0.0,0,1,fhi:git
county,Rogaland,2020-12-31,0,0,1,0,0.0002083802188825,0.0,0,1,fhi:git
county,Rogaland,2021-01-01,0,0,1,0,0.0002083802188825,0.0,0,1,fhi:git
county,Rogaland,2021-01-02,0,0,1,0,0.0002083802188825,0.0,0,1,fhi:git
county,Rogaland,2021-01-03,0,0,1,0,0.0002083802188825,0.0,0,1,fhi:git
county,Rogaland,2021-01-04,0,0,1,0,0.0002071916211708,0.0,0,1,fhi:git
county,Rogaland,2021-01-05,548,0,549,0,0.113748200022791,0.0,548,549,fhi:git
county,Rogaland,2021-01-06,641,0,1190,0,0.246558029193299,0.0,641,1190,fhi:git
county,Rogaland,2021-01-07,212,0,1402,0,0.290482652881517,0.0,212,1402,fhi:git
county,Rogaland,2021-01-08,20,0,1422,0,0.294626485304934,0.0,20,1422,fhi:git
county,Rogaland,2021-01-09,1,0,1423,0,0.294833676926105,0.0,1,1423,fhi:git
county,Rogaland,2021-01-10,0,0,1423,0,0.294833676926105,0.0,0,1423,fhi:git
county,Rogaland,2021-01-11,2,0,1425,0,0.295248060168447,0.0,2,1425,fhi:git
county,Rogaland,2021-01-12,117,0,1542,0,0.319489479845435,0.0,117,1542,fhi:git
county,Rogaland,2021-01-13,761,0,2303,0,0.477162303556444,0.0,761,2303,fhi:git
county,Rogaland,2021-01-14,535,0,2838,0,0.588009820882844,0.0,535,2838,fhi:git
county,Rogaland,2021-01-15,291,0,3129,0,0.648302582643558,0.0,291,3129,fhi:git
county,Rogaland,2021-01-16,0,0,3129,0,0.648302582643558,0.0,0,3129,fhi:git
county,Rogaland,2021-01-17,2,0,3131,0,0.6487169658859,0.0,2,3131,fhi:git
county,Rogaland,2021-01-18,71,0,3202,0,0.663427570989029,0.0,71,3202,fhi:git
county,Rogaland,2021-01-19,512,0,3714,0,0.769509681028499,0.0,512,3714,fhi:git
county,Rogaland,2021-01-20,656,0,4370,0,0.90542738451657,0.0,656,4370,fhi:git
county,Rogaland,2021-01-21,429,0,4799,0,0.99431258999886,0.0,429,4799,fhi:git
county,Rogaland,2021-01-22,272,0,5071,0,1.05066871095733,0.0,272,5071,fhi:git
county,Rogaland,2021-01-23,0,0,5071,0,1.05066871095733,0.0,0,5071,fhi:git
county,Rogaland,2021-01-24,0,0,5071,0,1.05066871095733,0.0,0,5071,fhi:git
county,Rogaland,2021-01-25,150,0,5221,0,1.08174745413296,0.0,150,5221,fhi:git
county,Rogaland,2021-01-26,338,381,5559,381,1.1517782220887,0.07894000766609,719,5940,fhi:git
county,Rogaland,2021-01-27,865,603,6424,984,1.33099897440148,0.203876555232106,1468,7408,fhi:git
county,Rogaland,2021-01-28,524,283,6948,1267,1.439567383895,0.262511784023454,807,8215,fhi:git
county,Rogaland,2021-01-29,410,22,7358,1289,1.52451594857504,0.267069999689213,432,8647,fhi:git
county,Rogaland,2021-01-30,4,1,7362,1290,1.52534471505972,0.267277191310383,5,8652,fhi:git
county,Rogaland,2021-01-31,1,0,7363,1290,1.52555190668089,0.267277191310383,1,8653,fhi:git
county,Rogaland,2021-02-01,13,5,7376,1295,1.52824539775611,0.268313149416238,18,8671,fhi:git
county,Rogaland,2021-02-02,451,77,7827,1372,1.62168881890416,0.284266904246392,528,9199,fhi:git
county,Rogaland,2021-02-03,2431,635,10258,2007,2.12537164997048,0.415833583689876,3066,12265,fhi:git
county,Rogaland,2021-02-04,1887,550,12145,2557,2.51634223911985,0.529788975333838,2437,14702,fhi:git
county,Rogaland,2021-02-05,656,281,12801,2838,2.65225994260792,0.588009820882844,937,15639,fhi:git
county,Rogaland,2021-02-06,0,0,12801,2838,2.65225994260792,0.588009820882844,0,15639,fhi:git
county,Rogaland,2021-02-07,0,1,12801,2839,2.65225994260792,0.588217012504014,1,15640,fhi:git
county,Rogaland,2021-02-08,7,71,12808,2910,2.65371028395612,0.602927617607144,78,15718,fhi:git
county,Rogaland,2021-02-09,587,394,13395,3304,2.7753317655834,0.684561116348455,981,16699,fhi:git
county,Rogaland,2021-02-10,1923,683,15318,3987,3.17376125309493,0.826072993608139,2606,19305,fhi:git
county,Rogaland,2021-02-11,1181,495,16499,4482,3.41845455769769,0.928632846087704,1676,20981,fhi:git
county,Rogaland,2021-02-12,482,268,16981,4750,3.51832091910203,0.984160200561489,750,21731,fhi:git
county,Rogaland,2021-02-13,1,0,16982,4750,3.5185281107232,0.984160200561489,1,21732,fhi:git
county,Rogaland,2021-02-14,0,0,16982,4750,3.5185281107232,0.984160200561489,0,21732,fhi:git
county,Rogaland,2021-02-15,0,147,16982,4897,3.5185281107232,1.0146173688736,147,21879,fhi:git
county,Rogaland,2021-02-16,480,314,17462,5211,3.61798008888521,1.07967553792125,794,22673,fhi:git
county,Rogaland,2021-02-17,1488,783,18950,5994,3.92628122118742,1.24190657729801,2271,24944,fhi:git
county,Rogaland,2021-02-18,1101,472,20051,6466,4.15439919609651,1.33970102249065,1573,26517,fhi:git
county,Rogaland,2021-02-19,441,411,20492,6877,4.24577070103285,1.42485677879187,852,27369,fhi:git
county,Rogaland,2021-02-20,1,2,20493,6879,4.24597789265402,1.42527116203421,3,27372,fhi:git
county,Rogaland,2021-02-21,0,1,20493,6880,4.24597789265402,1.42547835365538,1,27373,fhi:git
county,Rogaland,2021-02-22,252,13,20745,6893,4.29819018118907,1.4281718447306,265,27638,fhi:git
county,Rogaland,2021-02-23,379,407,21124,7300,4.37671580561282,1.51249883454713,786,28424,fhi:git
county,Rogaland,2021-02-24,819,2168,21943,9468,4.54640574335174,1.96169026924551,2987,31411,fhi:git
county,Rogaland,2021-02-25,1229,1812,23172,11280,4.8010442457707,2.33712148680707,3041,34452,fhi:git
county,Rogaland,2021-02-26,999,674,24171,11954,5.00802867532037,2.47676863947622,1673,36125,fhi:git
county,Rogaland,2021-02-27,1,1,24172,11955,5.00823586694154,2.47697583109739,2,36127,fhi:git
county,Rogaland,2021-02-28,4,0,24176,11955,5.00906463342623,2.47697583109739,4,36131,fhi:git
county,Rogaland,2021-03-01,647,2,24823,11957,5.14311761232376,2.47739021433973,649,36780,fhi:git
county,Rogaland,2021-03-02,794,545,25617,12502,5.3076277595334,2.59030964787784,1339,38119,fhi:git
county,Rogaland,2021-03-03,1243,1460,26860,13962,5.56516694464876,2.89280941478727,2703,40822,fhi:git
county,Rogaland,2021-03-04,1067,1477,27927,15439,5.78624040443804,3.1988314392566,2544,43366,fhi:git
county,Rogaland,2021-03-05,590,424,28517,15863,5.90848346092884,3.28668068663303,1014,44380,fhi:git
county,Rogaland,2021-03-06,3,1,28520,15864,5.90910503579235,3.2868878782542,4,44384,fhi:git
county,Rogaland,2021-03-07,0,0,28520,15864,5.90910503579235,3.2868878782542,0,44384,fhi:git
county,Rogaland,2021-03-08,541,0,29061,15864,6.02119570284578,3.2868878782542,541,44925,fhi:git
county,Rogaland,2021-03-09,1460,465,30521,16329,6.3236954697552,3.38323198209864,1925,46850,fhi:git
county,Rogaland,2021-03-10,2128,1078,32649,17407,6.76459923960675,3.60658454972081,3206,50056,fhi:git
county,Rogaland,2021-03-11,1398,1056,34047,18463,7.05425312600359,3.82537890167722,2454,52510,fhi:git
county,Rogaland,2021-03-12,116,546,34163,19009,7.0782873540594,3.9385055268365,662,53172,fhi:git
county,Rogaland,2021-03-13,0,0,34163,19009,7.0782873540594,3.9385055268365,0,53172,fhi:git
county,Rogaland,2021-03-14,0,0,34163,19009,7.0782873540594,3.9385055268365,0,53172,fhi:git
county,Rogaland,2021-03-15,0,1,34163,19010,7.0782873540594,3.93871271845767,1,53173,fhi:git
county,Rogaland,2021-03-16,585,93,34748,19103,7.19949445244434,3.95798153922655,678,53851,fhi:git
county,Rogaland,2021-03-17,2394,95,37142,19198,7.69551119352733,3.97766474323778,2489,56340,fhi:git
county,Rogaland,2021-03-18,1674,83,38816,19281,8.04234996736732,3.99486164779496,1757,58097,fhi:git
county,Rogaland,2021-03-19,272,25,39088,19306,8.09870608832579,4.00004143832423,297,58394,fhi:git
county,Rogaland,2021-03-20,0,0,39088,19306,8.09870608832579,4.00004143832423,0,58394,fhi:git
county,Rogaland,2021-03-21,0,0,39088,19306,8.09870608832579,4.00004143832423,0,58394,fhi:git
county,Rogaland,2021-03-22,12,17,39100,19323,8.10119238777984,4.00356369588414,29,58423,fhi:git
county,Rogaland,2021-03-23,827,48,39927,19371,8.27253985848812,4.01350889370034,875,59298,fhi:git
county,Rogaland,2021-03-24,3405,80,43332,19451,8.97802732857483,4.03008422339401,3485,62783,fhi:git
county,Rogaland,2021-03-25,3235,166,46567,19617,9.6482922230625,4.06447803250837,3401,66184,fhi:git
county,Rogaland,2021-03-26,805,77,47372,19694,9.81508147810503,4.08043178733852,882,67066,fhi:git
county,Rogaland,2021-03-27,0,0,47372,19694,9.81508147810503,4.08043178733852,0,67066,fhi:git
county,Rogaland,2021-03-28,1,1,47373,19695,9.8152886697262,4.08063897895969,2,67068,fhi:git
county,Rogaland,2021-03-29,232,0,47605,19695,9.86335712583783,4.08063897895969,232,67300,fhi:git
county,Rogaland,2021-03-30,3522,337,51127,20032,10.5930860156015,4.15046255529426,3859,71159,fhi:git
county,Troms og Finnmark,2020-12-27,0,0,0,0,0.0,0.0,0,0,fhi:git
county,Troms og Finnmark,2020-12-28,1,0,1,0,0.0004109966257177,0.0,1,1,fhi:git
county,Troms og Finnmark,2020-12-29,0,0,1,0,0.0004109966257177,0.0,0,1,fhi:git
county,Troms og Finnmark,2020-12-30,0,0,1,0,0.0004109966257177,0.0,0,1,fhi:git
county,Troms og Finnmark,2020-12-31,0,0,1,0,0.0004109966257177,0.0,0,1,fhi:git
county,Troms og Finnmark,2021-01-01,0,0,1,0,0.0004109966257177,0.0,0,1,fhi:git
county,Troms og Finnmark,2021-01-02,0,0,1,0,0.0004109966257177,0.0,0,1,fhi:git
county,Troms og Finnmark,2021-01-03,0,0,1,0,0.0004109966257177,0.0,0,1,fhi:git
county,Troms og Finnmark,2021-01-04,0,0,1,0,0.0004129364738528,0.0,0,1,fhi:git
county,Troms og Finnmark,2021-01-05,53,0,54,0,0.0222985695880546,0.0,53,54,fhi:git
county,Troms og Finnmark,2021-01-06,530,0,584,0,0.241154900730072,0.0,530,584,fhi:git
county,Troms og Finnmark,2021-01-07,188,0,772,0,0.31878695781441,0.0,188,772,fhi:git
county,Troms og Finnmark,2021-01-08,247,0,1019,0,0.420782266856067,0.0,247,1019,fhi:git
county,Troms og Finnmark,2021-01-09,0,0,1019,0,0.420782266856067,0.0,0,1019,fhi:git
county,Troms og Finnmark,2021-01-10,0,0,1019,0,0.420782266856067,0.0,0,1019,fhi:git
county,Troms og Finnmark,2021-01-11,1,0,1020,0,0.42119520332992,0.0,1,1020,fhi:git
county,Troms og Finnmark,2021-01-12,191,0,1211,0,0.500066069835817,0.0,191,1211,fhi:git
county,Troms og Finnmark,2021-01-13,569,0,1780,0,0.735026923458095,0.0,569,1780,fhi:git
county,Troms og Finnmark,2021-01-14,330,0,2110,0,0.87129595982954,0.0,330,2110,fhi:git
county,Troms og Finnmark,2021-01-15,37,0,2147,0,0.886574609362096,0.0,37,2147,fhi:git
county,Troms og Finnmark,2021-01-16,2,0,2149,0,0.887400482309802,0.0,2,2149,fhi:git
county,Troms og Finnmark,2021-01-17,0,0,2149,0,0.887400482309802,0.0,0,2149,fhi:git
county,Troms og Finnmark,2021-01-18,0,1,2149,1,0.887400482309802,0.0004129364738528,1,2150,fhi:git
county,Troms og Finnmark,2021-01-19,251,0,2400,1,0.99104753724687,0.0004129364738528,251,2401,fhi:git
county,Troms og Finnmark,2021-01-20,923,0,3323,1,1.37218790261306,0.0004129364738528,923,3324,fhi:git
county,Troms og Finnmark,2021-01-21,247,0,3570,1,1.47418321165472,0.0004129364738528,247,3571,fhi:git
county,Troms og Finnmark,2021-01-22,81,0,3651,1,1.5076310660368,0.0004129364738528,81,3652,fhi:git
county,Troms og Finnmark,2021-01-23,12,0,3663,1,1.51258630372304,0.0004129364738528,12,3664,fhi:git
county,Troms og Finnmark,2021-01-24,0,0,3663,1,1.51258630372304,0.0004129364738528,0,3664,fhi:git
county,Troms og Finnmark,2021-01-25,6,0,3669,1,1.51506392256615,0.0004129364738528,6,3670,fhi:git
county,Troms og Finnmark,2021-01-26,85,0,3754,1,1.55016352284365,0.0004129364738528,85,3755,fhi:git
county,Troms og Finnmark,2021-01-27,667,357,4421,358,1.82559215090351,0.147831257639325,1024,4779,fhi:git
county,Troms og Finnmark,2021-01-28,235,276,4656,634,1.92263222225893,0.261801724422715,511,5290,fhi:git
county,Troms og Finnmark,2021-01-29,104,243,4760,877,1.96557761553963,0.36214528756896,347,5637,fhi:git
county,Troms og Finnmark,2021-01-30,0,0,4760,877,1.96557761553963,0.36214528756896,0,5637,fhi:git
county,Troms og Finnmark,2021-01-31,0,0,4760,877,1.96557761553963,0.36214528756896,0,5637,fhi:git
county,Troms og Finnmark,2021-02-01,0,2,4760,879,1.96557761553963,0.362971160516666,2,5639,fhi:git
county,Troms og Finnmark,2021-02-02,119,24,4879,903,2.01471705592812,0.372881635889135,143,5782,fhi:git
county,Troms og Finnmark,2021-02-03,1159,562,6038,1465,2.49331042912358,0.604951934194444,1721,7503,fhi:git
county,Troms og Finnmark,2021-02-04,1149,380,7187,1845,2.96777443758052,0.761867794258531,1529,9032,fhi:git
county,Troms og Finnmark,2021-02-05,287,140,7474,1985,3.08628720557629,0.819678900597932,427,9459,fhi:git
county,Troms og Finnmark,2021-02-06,1,1,7475,1986,3.08670014205015,0.820091837071785,2,9461,fhi:git
county,Troms og Finnmark,2021-02-07,0,0,7475,1986,3.08670014205015,0.820091837071785,0,9461,fhi:git
county,Troms og Finnmark,2021-02-08,0,0,7475,1986,3.08670014205015,0.820091837071785,0,9461,fhi:git
county,Troms og Finnmark,2021-02-09,71,29,7546,2015,3.1160186316937,0.832066994813518,100,9561,fhi:git
county,Troms og Finnmark,2021-02-10,1408,813,8954,2828,3.69743318687853,1.1677843480559,2221,11782,fhi:git
county,Troms og Finnmark,2021-02-11,995,465,9949,3293,4.10830497836213,1.35979980839748,1460,13242,fhi:git
county,Troms og Finnmark,2021-02-12,293,113,10242,3406,4.22929536520102,1.40646162994285,406,13648,fhi:git
county,Troms og Finnmark,2021-02-13,5,2,10247,3408,4.23136004757028,1.40728750289056,7,13655,fhi:git
county,Troms og Finnmark,2021-02-14,0,0,10247,3408,4.23136004757028,1.40728750289056,0,13655,fhi:git
county,Troms og Finnmark,2021-02-15,0,6,10247,3414,4.23136004757028,1.40976512173367,6,13661,fhi:git
county,Troms og Finnmark,2021-02-16,133,52,10380,3466,4.28628059859271,1.43123781837402,185,13846,fhi:git
county,Troms og Finnmark,2021-02-17,969,582,11349,4048,4.68641604175614,1.67156684615639,1551,15397,fhi:git
county,Troms og Finnmark,2021-02-18,1295,263,12644,4311,5.22116877539559,1.78016913877969,1558,16955,fhi:git
county,Troms og Finnmark,2021-02-19,232,133,12876,4444,5.31697003732946,1.83508968980212,365,17320,fhi:git
county,Troms og Finnmark,2021-02-20,0,0,12876,4444,5.31697003732946,1.83508968980212,0,17320,fhi:git
county,Troms og Finnmark,2021-02-21,0,0,12876,4444,5.31697003732946,1.83508968980212,0,17320,fhi:git
county,Troms og Finnmark,2021-02-22,107,0,12983,4444,5.36115424003171,1.83508968980212,107,17427,fhi:git
county,Troms og Finnmark,2021-02-23,79,78,13062,4522,5.39377622146609,1.86729873476264,157,17584,fhi:git
county,Troms og Finnmark,2021-02-24,430,989,13492,5511,5.57133890522282,2.27569290740313,1419,19003,fhi:git
county,Troms og Finnmark,2021-02-25,567,1054,14059,6565,5.80547388589739,2.71092795084404,1621,20624,fhi:git
county,Troms og Finnmark,2021-02-26,282,404,14341,6969,5.9219219715239,2.8777542862806,686,21310,fhi:git
county,Troms og Finnmark,2021-02-27,0,0,14341,6969,5.9219219715239,2.8777542862806,0,21310,fhi:git
county,Troms og Finnmark,2021-02-28,3,0,14344,6969,5.92316078094546,2.8777542862806,3,21313,fhi:git
county,Troms og Finnmark,2021-03-01,340,0,14684,6969,6.06355918205543,2.8777542862806,340,21653,fhi:git
county,Troms og Finnmark,2021-03-02,555,72,15239,7041,6.29273892504377,2.90748571239801,627,22280,fhi:git
county,Troms og Finnmark,2021-03-03,598,1179,15837,8220,6.53967493640778,3.39433781507053,1777,24057,fhi:git
county,Troms og Finnmark,2021-03-04,879,933,16716,9153,6.90264609692445,3.77960754517525,1812,25869,fhi:git
county,Troms og Finnmark,2021-03-05,702,374,17418,9527,7.19252750156916,3.93404578639622,1076,26945,fhi:git
county,Troms og Finnmark,2021-03-06,0,1,17418,9528,7.19252750156916,3.93445872287007,1,26946,fhi:git
county,Troms og Finnmark,2021-03-07,0,0,17418,9528,7.19252750156916,3.93445872287007,0,26946,fhi:git
county,Troms og Finnmark,2021-03-08,408,0,17826,9528,7.36100558290113,3.93445872287007,408,27354,fhi:git
county,Troms og Finnmark,2021-03-09,611,51,18437,9579,7.61330976842523,3.95551848303657,662,28016,fhi:git
county,Troms og Finnmark,2021-03-10,938,698,19375,10277,8.00064418089921,4.24374814178587,1636,29652,fhi:git
county,Troms og Finnmark,2021-03-11,793,1041,20168,11318,8.32810280466453,4.6736150110667,1834,31486,fhi:git
county,Troms og Finnmark,2021-03-12,68,209,20236,11527,8.35618248488652,4.75991873410195,277,31763,fhi:git
county,Troms og Finnmark,2021-03-13,0,0,20236,11527,8.35618248488652,4.75991873410195,0,31763,fhi:git
county,Troms og Finnmark,2021-03-14,0,0,20236,11527,8.35618248488652,4.75991873410195,0,31763,fhi:git
county,Troms og Finnmark,2021-03-15,2,5,20238,11532,8.35700835783423,4.76198341647121,7,31770,fhi:git
county,Troms og Finnmark,2021-03-16,19,2,20257,11534,8.36485415083743,4.76280928941892,21,31791,fhi:git
county,Troms og Finnmark,2021-03-17,545,45,20802,11579,8.58990452908725,4.78139143074229,590,32381,fhi:git
county,Troms og Finnmark,2021-03-18,1112,122,21914,11701,9.04908988801163,4.83176968055234,1234,33615,fhi:git
county,Troms og Finnmark,2021-03-19,406,33,22320,11734,9.21674209639589,4.84539658418949,439,34054,fhi:git
county,Troms og Finnmark,2021-03-20,0,0,22320,11734,9.21674209639589,4.84539658418949,0,34054,fhi:git
county,Troms og Finnmark,2021-03-21,1,0,22321,11734,9.21715503286974,4.84539658418949,1,34055,fhi:git
county,Troms og Finnmark,2021-03-22,3,0,22324,11734,9.2183938422913,4.84539658418949,3,34058,fhi:git
county,Troms og Finnmark,2021-03-23,429,14,22753,11748,9.39554358957418,4.85117769482343,443,34501,fhi:git
county,Troms og Finnmark,2021-03-24,1864,41,24617,11789,10.1652571768359,4.8681080902514,1905,36406,fhi:git
county,Troms og Finnmark,2021-03-25,1941,37,26558,11826,10.9667668725843,4.88338673978395,1978,38384,fhi:git
county,Troms og Finnmark,2021-03-26,486,15,27044,11841,11.1674539988768,4.88958078689174,501,38885,fhi:git
county,Troms og Finnmark,2021-03-27,1,0,27045,11841,11.1678669353507,4.88958078689174,1,38886,fhi:git
county,Troms og Finnmark,2021-03-28,0,0,27045,11841,11.1678669353507,4.88958078689174,0,38886,fhi:git
county,Troms og Finnmark,2021-03-29,176,0,27221,11841,11.2405437547488,4.88958078689174,176,39062,fhi:git
county,Troms og Finnmark,2021-03-30,1354,146,28575,11987,11.7996597403455,4.94986951207426,1500,40562,fhi:git
county,Trøndelag,2020-12-27,0,0,0,0,0.0,0.0,0,0,fhi:git
county,Trøndelag,2020-12-28,0,0,0,0,0.0,0.0,0,0,fhi:git
county,Trøndelag,2020-12-29,0,0,0,0,0.0,0.0,0,0,fhi:git
county,Trøndelag,2020-12-30,0,0,0,0,0.0,0.0,0,0,fhi:git
county,Trøndelag,2020-12-31,0,0,0,0,0.0,0.0,0,0,fhi:git
county,Trøndelag,2021-01-01,0,0,0,0,0.0,0.0,0,0,fhi:git
county,Trøndelag,2021-01-02,0,0,0,0,0.0,0.0,0,0,fhi:git
county,Trøndelag,2021-01-03,0,0,0,0,0.0,0.0,0,0,fhi:git
county,Trøndelag,2021-01-04,3,0,3,0,0.0006367750316264,0.0,3,3,fhi:git
county,Trøndelag,2021-01-05,407,0,410,0,0.0870259209889541,0.0,407,410,fhi:git
county,Trøndelag,2021-01-06,674,0,1084,0,0.23008804476104,0.0,674,1084,fhi:git
county,Trøndelag,2021-01-07,484,0,1568,0,0.332821083196781,0.0,484,1568,fhi:git
county,Trøndelag,2021-01-08,141,0,1709,0,0.362749509683226,0.0,141,1709,fhi:git
county,Trøndelag,2021-01-09,0,0,1709,0,0.362749509683226,0.0,0,1709,fhi:git
county,Trøndelag,2021-01-10,0,0,1709,0,0.362749509683226,0.0,0,1709,fhi:git
county,Trøndelag,2021-01-11,95,0,1804,0,0.382914052351398,0.0,95,1804,fhi:git
county,Trøndelag,2021-01-12,500,0,2304,0,0.489043224289147,0.0,500,2304,fhi:git
county,Trøndelag,2021-01-13,860,0,3164,0,0.671585400022075,0.0,860,3164,fhi:git
county,Trøndelag,2021-01-14,670,0,3834,0,0.813798490418659,0.0,670,3834,fhi:git
county,Trøndelag,2021-01-15,253,0,4087,0,0.867499851419159,0.0,253,4087,fhi:git
county,Trøndelag,2021-01-16,0,0,4087,0,0.867499851419159,0.0,0,4087,fhi:git
county,Trøndelag,2021-01-17,0,0,4087,0,0.867499851419159,0.0,0,4087,fhi:git
county,Trøndelag,2021-01-18,152,0,4239,0,0.899763119688235,0.0,152,4239,fhi:git
county,Trøndelag,2021-01-19,567,0,4806,0,1.02011360066564,0.0,567,4806,fhi:git
county,Trøndelag,2021-01-20,738,0,5544,0,1.17676025844576,0.0,738,5544,fhi:git
county,Trøndelag,2021-01-21,535,0,6079,0,1.29031847241915,0.0,535,6079,fhi:git
county,Trøndelag,2021-01-22,283,0,6362,0,1.35038758373592,0.0,283,6362,fhi:git
county,Trøndelag,2021-01-23,1,0,6363,0,1.35059984207979,0.0,1,6363,fhi:git
county,Trøndelag,2021-01-24,0,0,6363,0,1.35059984207979,0.0,0,6363,fhi:git
county,Trøndelag,2021-01-25,1,0,6364,0,1.35081210042367,0.0,1,6364,fhi:git
county,Trøndelag,2021-01-26,313,184,6677,184,1.4172489620567,0.0390555352730916,497,6861,fhi:git
county,Trøndelag,2021-01-27,1013,604,7690,788,1.63226666440258,0.167259574973892,1617,8478,fhi:git
county,Trøndelag,2021-01-28,727,483,8417,1271,1.78657848040006,0.269780355065758,1210,9688,fhi:git
county,Trøndelag,2021-01-29,423,229,8840,1500,1.8763637598594,0.318387515813247,652,10340,fhi:git
county,Trøndelag,2021-01-30,1,0,8841,1500,1.87657601820328,0.318387515813247,1,10341,fhi:git
county,Trøndelag,2021-01-31,2,1,8843,1501,1.87700053489103,0.318599774157122,3,10344,fhi:git
county,Trøndelag,2021-02-01,14,86,8857,1587,1.87997215170528,0.336853991730415,100,10444,fhi:git
county,Trøndelag,2021-02-02,836,392,9693,1979,2.0574201271852,0.42005926252961,1228,11672,fhi:git
county,Trøndelag,2021-02-03,2124,810,11817,2789,2.50825684957676,0.591988521068763,2934,14606,fhi:git
county,Trøndelag,2021-02-04,2143,607,13960,3396,2.96312648050195,0.72082933580119,2750,17356,fhi:git
county,Trøndelag,2021-02-05,1293,319,15253,3715,3.23757651913297,0.788539747497474,1612,18968,fhi:git
county,Trøndelag,2021-02-06,7,0,15260,3715,3.2390623275401,0.788539747497474,7,18975,fhi:git
county,Trøndelag,2021-02-07,1,0,15261,3715,3.23927458588397,0.788539747497474,1,18976,fhi:git
county,Trøndelag,2021-02-08,3,150,15264,3865,3.2399113609156,0.820378499078799,153,19129,fhi:git
county,Trøndelag,2021-02-09,836,522,16100,4387,3.41735933639551,0.931177354581809,1358,20487,fhi:git
county,Trøndelag,2021-02-10,2231,628,18331,5015,3.89090770158175,1.06447559453562,2859,23346,fhi:git
county,Trøndelag,2021-02-11,2361,586,20692,5601,4.3920496514718,1.18885898404666,2947,26293,fhi:git
county,Trøndelag,2021-02-12,888,352,21580,5953,4.58053506083324,1.26357392109084,1240,27533,fhi:git
county,Trøndelag,2021-02-13,2,0,21582,5953,4.58095957752099,1.26357392109084,2,27535,fhi:git
county,Trøndelag,2021-02-14,0,0,21582,5953,4.58095957752099,1.26357392109084,0,27535,fhi:git
county,Trøndelag,2021-02-15,0,2,21582,5955,4.58095957752099,1.26399843777859,2,27537,fhi:git
county,Trøndelag,2021-02-16,344,210,21926,6165,4.65397644781416,1.30857268999244,554,28091,fhi:git
county,Trøndelag,2021-02-17,2224,922,24150,7087,5.12603900459327,1.50427488304565,3146,31237,fhi:git
county,Trøndelag,2021-02-18,2118,752,26268,7839,5.57560217692158,1.66389315764003,2870,34107,fhi:git
county,Trøndelag,2021-02-19,1262,410,27530,8249,5.84347220689245,1.75091907862898,1672,35779,fhi:git
county,Trøndelag,2021-02-20,1,1,27531,8250,5.84368446523633,1.75113133697286,2,35781,fhi:git
county,Trøndelag,2021-02-21,0,4,27531,8254,5.84368446523633,1.75198037034836,4,35785,fhi:git
county,Trøndelag,2021-02-22,17,2,27548,8256,5.84729285708221,1.75240488703611,19,35804,fhi:git
county,Trøndelag,2021-02-23,334,674,27882,8930,5.91818714393663,1.8954670108082,1008,36812,fhi:git
county,Trøndelag,2021-02-24,1011,2046,28893,10976,6.13278032959476,2.32974758237746,3057,39869,fhi:git
county,Trøndelag,2021-02-25,474,1982,29367,12958,6.23339078459174,2.7504436199387,2456,42325,fhi:git
county,Trøndelag,2021-02-26,611,1155,29978,14113,6.36308063269967,2.9956020071149,1766,44091,fhi:git
county,Trøndelag,2021-02-27,4,1,29982,14114,6.36392966607517,2.99581426545878,5,44096,fhi:git
county,Trøndelag,2021-02-28,1,0,29983,14114,6.36414192441905,2.99581426545878,1,44097,fhi:git
county,Trøndelag,2021-03-01,527,0,30510,14114,6.47600207164144,2.99581426545878,527,44624,fhi:git
county,Trøndelag,2021-03-02,819,785,31329,14899,6.64984165527547,3.16243706540104,1604,46228,fhi:git
county,Trøndelag,2021-03-03,2014,2141,33343,17040,7.07732995984072,3.61688217963848,4155,50383,fhi:git
county,Trøndelag,2021-03-04,1875,2282,35218,19322,7.47531435460728,4.10125572036237,4157,54540,fhi:git
county,Trøndelag,2021-03-05,1049,982,36267,20304,7.69797335733268,4.30969341404811,2031,56571,fhi:git
county,Trøndelag,2021-03-06,2,0,36269,20304,7.69839787402043,4.30969341404811,2,56573,fhi:git
county,Trøndelag,2021-03-07,0,1,36269,20305,7.69839787402043,4.30990567239198,1,56574,fhi:git
county,Trøndelag,2021-03-08,435,0,36704,20305,7.79073025360627,4.30990567239198,435,57009,fhi:git
county,Trøndelag,2021-03-09,1172,301,37876,20606,8.03949703262835,4.37379543389851,1473,58482,fhi:git
county,Trøndelag,2021-03-10,1684,1500,39560,22106,8.39694008371469,4.69218294971175,3184,61666,fhi:git
county,Trøndelag,2021-03-11,826,1195,40386,23301,8.57226547575585,4.94583167064297,2021,63687,fhi:git
county,Trøndelag,2021-03-12,122,501,40508,23802,8.59816099370866,5.0521731009246,623,64310,fhi:git
county,Trøndelag,2021-03-13,0,1,40508,23803,8.59816099370866,5.05238535926847,1,64311,fhi:git
county,Trøndelag,2021-03-14,0,0,40508,23803,8.59816099370866,5.05238535926847,0,64311,fhi:git
county,Trøndelag,2021-03-15,3,6,40511,23809,8.59879776874029,5.05365890933173,9,64320,fhi:git
county,Trøndelag,2021-03-16,606,12,41117,23821,8.72742632512884,5.05620600945823,618,64938,fhi:git
county,Trøndelag,2021-03-17,1977,122,43094,23943,9.1470610709707,5.08210152741104,2099,67037,fhi:git
county,Trøndelag,2021-03-18,1498,123,44592,24066,9.4650240700962,5.10820930370773,1621,68658,fhi:git
county,Trøndelag,2021-03-19,542,88,45134,24154,9.58006809247671,5.12688803796877,630,69288,fhi:git
county,Trøndelag,2021-03-20,0,0,45134,24154,9.58006809247671,5.12688803796877,0,69288,fhi:git
county,Trøndelag,2021-03-21,0,0,45134,24154,9.58006809247671,5.12688803796877,0,69288,fhi:git
county,Trøndelag,2021-03-22,1,0,45135,24154,9.58028035082059,5.12688803796877,1,69289,fhi:git
county,Trøndelag,2021-03-23,1047,216,46182,24370,9.80251483685824,5.17273584024588,1263,70552,fhi:git
county,Trøndelag,2021-03-24,3109,544,49291,24914,10.4624260279672,5.28820437931415,3653,74205,fhi:git
county,Trøndelag,2021-03-25,2887,304,52178,25218,11.0752158667357,5.3527309158523,3191,77396,fhi:git
county,Trøndelag,2021-03-26,1980,216,54158,25434,11.4954873876092,5.39857871812941,2196,79592,fhi:git
county,Trøndelag,2021-03-27,0,3,54158,25437,11.4954873876092,5.39921549316104,3,79595,fhi:git
county,Trøndelag,2021-03-28,0,0,54158,25437,11.4954873876092,5.39921549316104,0,79595,fhi:git
county,Trøndelag,2021-03-29,3,0,54161,25437,11.4961241626408,5.39921549316104,3,79598,fhi:git
county,Trøndelag,2021-03-30,1163,352,55324,25789,11.742980616568,5.47393043020521,1515,81113,fhi:git
county,Vestfold og Telemark,2020-12-27,0,0,0,0,0.0,0.0,0,0,fhi:git
county,Vestfold og Telemark,2020-12-28,0,0,0,0,0.0,0.0,0,0,fhi:git
county,Vestfold og Telemark,2020-12-29,0,0,0,0,0.0,0.0,0,0,fhi:git
county,Vestfold og Telemark,2020-12-30,0,0,0,0,0.0,0.0,0,0,fhi:git
county,Vestfold og Telemark,2020-12-31,0,0,0,0,0.0,0.0,0,0,fhi:git
county,Vestfold og Telemark,2021-01-01,0,0,0,0,0.0,0.0,0,0,fhi:git
county,Vestfold og Telemark,2021-01-02,0,0,0,0,0.0,0.0,0,0,fhi:git
county,Vestfold og Telemark,2021-01-03,0,0,0,0,0.0,0.0,0,0,fhi:git
county,Vestfold og Telemark,2021-01-04,1,0,1,0,0.0002370331040433,0.0,1,1,fhi:git
county,Vestfold og Telemark,2021-01-05,218,0,219,0,0.051910249785485,0.0,218,219,fhi:git
county,Vestfold og Telemark,2021-01-06,1026,0,1245,0,0.295106214533922,0.0,1026,1245,fhi:git
county,Vestfold og Telemark,2021-01-07,442,0,1687,0,0.399874846521065,0.0,442,1687,fhi:git
county,Vestfold og Telemark,2021-01-08,63,0,1750,0,0.414807932075794,0.0,63,1750,fhi:git
county,Vestfold og Telemark,2021-01-09,0,0,1750,0,0.414807932075794,0.0,0,1750,fhi:git
county,Vestfold og Telemark,2021-01-10,3,0,1753,0,0.415519031387924,0.0,3,1753,fhi:git
county,Vestfold og Telemark,2021-01-11,3,0,1756,0,0.416230130700054,0.0,3,1756,fhi:git
county,Vestfold og Telemark,2021-01-12,420,0,2176,0,0.515784034398244,0.0,420,2176,fhi:git
county,Vestfold og Telemark,2021-01-13,1164,0,3340,0,0.791690567504658,0.0,1164,3340,fhi:git
county,Vestfold og Telemark,2021-01-14,583,0,3923,0,0.929880867161908,0.0,583,3923,fhi:git
county,Vestfold og Telemark,2021-01-15,157,0,4080,0,0.967095064496707,0.0,157,4080,fhi:git
county,Vestfold og Telemark,2021-01-16,3,0,4083,0,0.967806163808838,0.0,3,4083,fhi:git
county,Vestfold og Telemark,2021-01-17,42,0,4125,0,0.977761554178656,0.0,42,4125,fhi:git
county,Vestfold og Telemark,2021-01-18,7,0,4132,0,0.97942078590696,0.0,7,4132,fhi:git
county,Vestfold og Telemark,2021-01-19,232,0,4364,0,1.03441246604501,0.0,232,4364,fhi:git
county,Vestfold og Telemark,2021-01-20,1606,0,5970,0,1.41508763113856,0.0,1606,5970,fhi:git
county,Vestfold og Telemark,2021-01-21,829,0,6799,0,1.61158807439047,0.0,829,6799,fhi:git
county,Vestfold og Telemark,2021-01-22,181,0,6980,0,1.65449106622231,0.0,181,6980,fhi:git
county,Vestfold og Telemark,2021-01-23,3,0,6983,0,1.65520216553444,0.0,3,6983,fhi:git
county,Vestfold og Telemark,2021-01-24,0,0,6983,0,1.65520216553444,0.0,0,6983,fhi:git
county,Vestfold og Telemark,2021-01-25,44,0,7027,0,1.66563162211234,0.0,44,7027,fhi:git
county,Vestfold og Telemark,2021-01-26,103,179,7130,179,1.69004603182881,0.0424289256237526,282,7309,fhi:git
county,Vestfold og Telemark,2021-01-27,1625,899,8755,1078,2.07522482589919,0.255521686158689,2524,9833,fhi:git
county,Vestfold og Telemark,2021-01-28,654,449,9409,1527,2.23024447594351,0.361949549874135,1103,10936,fhi:git
county,Vestfold og Telemark,2021-01-29,86,90,9495,1617,2.25062932289124,0.383282529238033,176,11112,fhi:git
county,Vestfold og Telemark,2021-01-30,0,0,9495,1617,2.25062932289124,0.383282529238033,0,11112,fhi:git
county,Vestfold og Telemark,2021-01-31,1,2,9496,1619,2.25086635599528,0.38375659544612,3,11115,fhi:git
county,Vestfold og Telemark,2021-02-01,50,1,9546,1620,2.26271801119744,0.383993628550163,51,11166,fhi:git
county,Vestfold og Telemark,2021-02-02,464,327,10010,1947,2.37270137147354,0.461503453572326,791,11957,fhi:git
county,Vestfold og Telemark,2021-02-03,3215,847,13225,2794,3.13476280097278,0.66227049269701,4062,16019,fhi:git
county,Vestfold og Telemark,2021-02-04,1904,708,15129,3502,3.58607383107125,0.830089930359674,2612,18631,fhi:git
county,Vestfold og Telemark,2021-02-05,964,245,16093,3747,3.814573743369,0.888163040850285,1209,19840,fhi:git
county,Vestfold og Telemark,2021-02-06,0,4,16093,3751,3.814573743369,0.889111173266458,4,19844,fhi:git
county,Vestfold og Telemark,2021-02-07,2,1,16095,3752,3.81504780957709,0.889348206370502,3,19847,fhi:git
county,Vestfold og Telemark,2021-02-08,17,46,16112,3798,3.81907737234582,0.900251729156494,63,19910,fhi:git
county,Vestfold og Telemark,2021-02-09,356,208,16468,4006,3.90346115738524,0.949554614797503,564,20474,fhi:git
county,Vestfold og Telemark,2021-02-10,2891,1395,19359,5401,4.58872386117445,1.28021579493792,4286,24760,fhi:git
county,Vestfold og Telemark,2021-02-11,1540,878,20899,6279,4.95375484140115,1.48833086028795,2418,27178,fhi:git
county,Vestfold og Telemark,2021-02-12,602,213,21501,6492,5.09644877003522,1.53881891144917,815,27993,fhi:git
county,Vestfold og Telemark,2021-02-13,2,2,21503,6494,5.09692283624331,1.53929297765726,4,27997,fhi:git
county,Vestfold og Telemark,2021-02-14,0,0,21503,6494,5.09692283624331,1.53929297765726,0,27997,fhi:git
county,Vestfold og Telemark,2021-02-15,4,2,21507,6496,5.09787096865948,1.53976704386535,6,28003,fhi:git
county,Vestfold og Telemark,2021-02-16,581,75,22088,6571,5.23558720210865,1.55754452666859,656,28659,fhi:git
county,Vestfold og Telemark,2021-02-17,3041,1532,25129,8103,5.95640487150435,1.92067924206295,4573,33232,fhi:git
county,Vestfold og Telemark,2021-02-18,1819,629,26948,8732,6.38756808775914,2.06977306450619,2448,35680,fhi:git
county,Vestfold og Telemark,2021-02-19,284,83,27232,8815,6.45488548930744,2.08944681214178,367,36047,fhi:git
county,Vestfold og Telemark,2021-02-20,0,1,27232,8816,6.45488548930744,2.08968384524583,1,36048,fhi:git
county,Vestfold og Telemark,2021-02-21,1,1,27233,8817,6.45512252241148,2.08992087834987,2,36050,fhi:git
county,Vestfold og Telemark,2021-02-22,50,0,27283,8817,6.46697417761365,2.08992087834987,50,36100,fhi:git
county,Vestfold og Telemark,2021-02-23,626,385,27909,9202,6.61535690074476,2.18117862340655,1011,37111,fhi:git
county,Vestfold og Telemark,2021-02-24,665,2870,28574,12072,6.77298391493356,2.86146363201085,3535,40646,fhi:git
county,Vestfold og Telemark,2021-02-25,701,1992,29275,14064,6.93914412086792,3.33363357526512,2693,43339,fhi:git
county,Vestfold og Telemark,2021-02-26,542,845,29817,14909,7.0676160632594,3.53392654818172,1387,44726,fhi:git
county,Vestfold og Telemark,2021-02-27,3,2,29820,14911,7.06832716257153,3.53440061438981,5,44731,fhi:git
county,Vestfold og Telemark,2021-02-28,0,0,29820,14911,7.06832716257153,3.53440061438981,0,44731,fhi:git
county,Vestfold og Telemark,2021-03-01,604,0,30424,14911,7.21149515741369,3.53440061438981,604,45335,fhi:git
county,Vestfold og Telemark,2021-03-02,844,354,31268,15265,7.41155109722624,3.61831033322114,1198,46533,fhi:git
county,Vestfold og Telemark,2021-03-03,1975,2813,33243,18078,7.87969147771178,4.28508445489497,4788,51321,fhi:git
county,Vestfold og Telemark,2021-03-04,1012,1431,34255,19509,8.11956897900361,4.62427882678095,2443,53764,fhi:git
county,Vestfold og Telemark,2021-03-05,1476,585,35731,20094,8.46942984057153,4.76294319264629,2061,55825,fhi:git
county,Vestfold og Telemark,2021-03-06,2,1,35733,20095,8.46990390677962,4.76318022575033,3,55828,fhi:git
county,Vestfold og Telemark,2021-03-07,0,0,35733,20095,8.46990390677962,4.76318022575033,0,55828,fhi:git
county,Vestfold og Telemark,2021-03-08,236,0,35969,20095,8.52584371933384,4.76318022575033,236,56064,fhi:git
county,Vestfold og Telemark,2021-03-09,934,142,36903,20237,8.74723263851029,4.79683892652448,1076,57140,fhi:git
county,Vestfold og Telemark,2021-03-10,1587,2262,38490,22499,9.12340417462703,5.33300780787045,3849,60989,fhi:git
county,Vestfold og Telemark,2021-03-11,296,835,38786,23334,9.19356597342385,5.53093044974661,1131,62120,fhi:git
county,Vestfold og Telemark,2021-03-12,35,126,38821,23460,9.20186213206536,5.56079662085607,161,62281,fhi:git
county,Vestfold og Telemark,2021-03-13,1,1,38822,23461,9.20209916516941,5.56103365396011,2,62283,fhi:git
county,Vestfold og Telemark,2021-03-14,0,0,38822,23461,9.20209916516941,5.56103365396011,0,62283,fhi:git
county,Vestfold og Telemark,2021-03-15,2,3,38824,23464,9.20257323137749,5.56174475327224,5,62288,fhi:git
county,Vestfold og Telemark,2021-03-16,402,25,39226,23489,9.2978605392029,5.56767058087333,427,62715,fhi:git
county,Vestfold og Telemark,2021-03-17,3101,166,42327,23655,10.0329001948412,5.60701807614451,3267,65982,fhi:git
county,Vestfold og Telemark,2021-03-18,911,52,43238,23707,10.2488373526247,5.61934379755477,963,66945,fhi:git
county,Vestfold og Telemark,2021-03-19,27,32,43265,23739,10.2552372464338,5.62692885688415,59,67004,fhi:git
county,Vestfold og Telemark,2021-03-20,0,0,43265,23739,10.2552372464338,5.62692885688415,0,67004,fhi:git
county,Vestfold og Telemark,2021-03-21,0,0,43265,23739,10.2552372464338,5.62692885688415,0,67004,fhi:git
county,Vestfold og Telemark,2021-03-22,0,1,43265,23740,10.2552372464338,5.6271658899882,1,67005,fhi:git
county,Vestfold og Telemark,2021-03-23,660,58,43925,23798,10.4116790951024,5.64091381002271,718,67723,fhi:git
county,Vestfold og Telemark,2021-03-24,4609,813,48534,24611,11.504164671638,5.83362172360992,5422,73145,fhi:git
county,Vestfold og Telemark,2021-03-25,2940,262,51474,24873,12.2010419975254,5.89572439686927,3202,76347,fhi:git
county,Vestfold og Telemark,2021-03-26,896,152,52370,25025,12.4134236587482,5.93175342868385,1048,77395,fhi:git
county,Vestfold og Telemark,2021-03-27,0,0,52370,25025,12.4134236587482,5.93175342868385,0,77395,fhi:git
county,Vestfold og Telemark,2021-03-28,0,0,52370,25025,12.4134236587482,5.93175342868385,0,77395,fhi:git
county,Vestfold og Telemark,2021-03-29,184,3,52554,25028,12.4570377498922,5.93246452799598,187,77582,fhi:git
county,Vestfold og Telemark,2021-03-30,2662,77,55216,25105,13.0880198728554,5.95071607700732,2739,80321,fhi:git
county,Vestland,2020-12-27,0,0,0,0,0.0,0.0,0,0,fhi:git
county,Vestland,2020-12-28,0,0,0,0,0.0,0.0,0,0,fhi:git
county,Vestland,2020-12-29,0,0,0,0,0.0,0.0,0,0,fhi:git
county,Vestland,2020-12-30,0,0,0,0,0.0,0.0,0,0,fhi:git
county,Vestland,2020-12-31,0,0,0,0,0.0,0.0,0,0,fhi:git
county,Vestland,2021-01-01,0,0,0,0,0.0,0.0,0,0,fhi:git
county,Vestland,2021-01-02,0,0,0,0,0.0,0.0,0,0,fhi:git
county,Vestland,2021-01-03,0,0,0,0,0.0,0.0,0,0,fhi:git
county,Vestland,2021-01-04,2,0,2,0,0.0003130767460681,0.0,2,2,fhi:git
county,Vestland,2021-01-05,416,0,418,0,0.0654330399282428,0.0,416,418,fhi:git
county,Vestland,2021-01-06,1256,0,1674,0,0.262045236459039,0.0,1256,1674,fhi:git
county,Vestland,2021-01-07,715,0,2389,0,0.373970173178402,0.0,715,2389,fhi:git
county,Vestland,2021-01-08,139,0,2528,0,0.395729007030138,0.0,139,2528,fhi:git
county,Vestland,2021-01-09,0,0,2528,0,0.395729007030138,0.0,0,2528,fhi:git
county,Vestland,2021-01-10,0,0,2528,0,0.395729007030138,0.0,0,2528,fhi:git
county,Vestland,2021-01-11,65,0,2593,0,0.405904001277353,0.0,65,2593,fhi:git
county,Vestland,2021-01-12,856,0,3449,0,0.53990084859452,0.0,856,3449,fhi:git
county,Vestland,2021-01-13,1127,0,4576,0,0.716319595003921,0.0,1127,4576,fhi:git
county,Vestland,2021-01-14,999,0,5575,0,0.872701429664961,0.0,999,5575,fhi:git
county,Vestland,2021-01-15,425,0,6000,0,0.939230238204442,0.0,425,6000,fhi:git
county,Vestland,2021-01-16,2,0,6002,0,0.93954331495051,0.0,2,6002,fhi:git
county,Vestland,2021-01-17,1,0,6003,0,0.939699853323544,0.0,1,6003,fhi:git
county,Vestland,2021-01-18,62,0,6065,0,0.949405232451657,0.0,62,6065,fhi:git
county,Vestland,2021-01-19,368,0,6433,0,1.0070113537282,0.0,368,6433,fhi:git
county,Vestland,2021-01-20,1235,0,7668,0,1.20033624442528,0.0,1235,7668,fhi:git
county,Vestland,2021-01-21,781,0,8449,0,1.32259271376489,0.0,781,8449,fhi:git
county,Vestland,2021-01-22,312,0,8761,0,1.37143268615152,0.0,312,8761,fhi:git
county,Vestland,2021-01-23,0,0,8761,0,1.37143268615152,0.0,0,8761,fhi:git
county,Vestland,2021-01-24,0,0,8761,0,1.37143268615152,0.0,0,8761,fhi:git
county,Vestland,2021-01-25,2,0,8763,0,1.37174576289759,0.0,2,8763,fhi:git
county,Vestland,2021-01-26,152,174,8915,174,1.39553959559877,0.0272376769079288,326,9089,fhi:git
county,Vestland,2021-01-27,1590,1211,10505,1385,1.64443560872294,0.216805646652192,2801,11890,fhi:git
county,Vestland,2021-01-28,1959,695,12464,2080,1.95109428149669,0.325599815910873,2654,14544,fhi:git
county,Vestland,2021-01-29,481,176,12945,2256,2.02638923892608,0.35315056956487,657,15201,fhi:git
county,Vestland,2021-01-30,3,0,12948,2256,2.02685885404519,0.35315056956487,3,15204,fhi:git
county,Vestland,2021-01-31,1,0,12949,2256,2.02701539241822,0.35315056956487,1,15205,fhi:git
county,Vestland,2021-02-01,13,59,12962,2315,2.02905039126766,0.362386333573881,72,15277,fhi:git
county,Vestland,2021-02-02,722,582,13684,2897,2.14207109659826,0.453491666679712,1304,16581,fhi:git
county,Vestland,2021-02-03,2831,1049,16515,3946,2.58523123065773,0.617700419992455,3880,20461,fhi:git
county,Vestland,2021-02-04,2589,1114,19104,5060,2.99050907844294,0.792084167552413,3703,24164,fhi:git
county,Vestland,2021-02-05,911,487,20015,5547,3.13311553627699,0.868318355220007,1398,25562,fhi:git
county,Vestland,2021-02-06,0,2,20015,5549,3.13311553627699,0.868631431966075,2,25564,fhi:git
county,Vestland,2021-02-07,2,1,20017,5550,3.13342861302305,0.868787970339109,3,25567,fhi:git
county,Vestland,2021-02-08,8,49,20025,5599,3.13468092000733,0.876458350617779,57,25624,fhi:git
county,Vestland,2021-02-09,891,307,20916,5906,3.27415661038069,0.924515631139239,1198,26822,fhi:git
county,Vestland,2021-02-10,2757,971,23673,6877,3.70573290483563,1.07651439135532,3728,30550,fhi:git
county,Vestland,2021-02-11,2700,834,26373,7711,4.12838651202763,1.20706739446574,3534,34084,fhi:git
county,Vestland,2021-02-12,620,458,26993,8169,4.22544030330875,1.27876196931535,1078,35162,fhi:git
county,Vestland,2021-02-13,0,0,26993,8169,4.22544030330875,1.27876196931535,0,35162,fhi:git
county,Vestland,2021-02-14,0,2,26993,8171,4.22544030330875,1.27907504606142,2,35164,fhi:git
county,Vestland,2021-02-15,94,1,27087,8172,4.24015491037395,1.27923158443445,95,35259,fhi:git
county,Vestland,2021-02-16,1087,55,28174,8227,4.41031212186199,1.28784119495132,1142,36401,fhi:git
county,Vestland,2021-02-17,2689,1328,30863,9555,4.83124380695062,1.49572415434057,4017,40418,fhi:git
county,Vestland,2021-02-18,2004,1999,32867,11554,5.1449467065109,1.80864436203569,4003,44421,fhi:git
county,Vestland,2021-02-19,1157,540,34024,12094,5.32606160411132,1.89317508347409,1697,46118,fhi:git
county,Vestland,2021-02-20,3,4,34027,12098,5.32653121923043,1.89380123696622,7,46125,fhi:git
county,Vestland,2021-02-21,0,1,34027,12099,5.32653121923043,1.89395777533926,1,46126,fhi:git
county,Vestland,2021-02-22,48,2,34075,12101,5.33404506113606,1.89427085208533,50,46176,fhi:git
county,Vestland,2021-02-23,540,591,34615,12692,5.41857578257446,1.98678503054846,1131,47307,fhi:git
county,Vestland,2021-02-24,1341,2401,35956,15093,5.62849374081316,2.36263366420327,3742,51049,fhi:git
county,Vestland,2021-02-25,1259,2647,37215,17740,5.82557555246305,2.77699073762447,3906,54955,fhi:git
county,Vestland,2021-02-26,1397,875,38612,18615,6.04425965959165,2.91396181402928,2272,57227,fhi:git
county,Vestland,2021-02-27,1,0,38613,18615,6.04441619796469,2.91396181402928,1,57228,fhi:git
county,Vestland,2021-02-28,0,7,38613,18622,6.04441619796469,2.91505758264052,7,57235,fhi:git
county,Vestland,2021-03-01,440,11,39053,18633,6.11329308209968,2.9167795047439,451,57686,fhi:git
county,Vestland,2021-03-02,1350,758,40403,19391,6.32461988569568,3.03543559150372,2108,59794,fhi:git
county,Vestland,2021-03-03,1749,2043,42152,21434,6.59840550013228,3.35524348761234,3792,63586,fhi:git
county,Vestland,2021-03-04,1795,2846,43947,24280,6.87939187972844,3.80075169726731,4641,68227,fhi:git
county,Vestland,2021-03-05,1250,894,45197,25174,7.07506484602103,3.94069700275977,2144,70371,fhi:git
county,Vestland,2021-03-06,1,6,45198,25180,7.07522138439406,3.94163623299798,7,70378,fhi:git
county,Vestland,2021-03-07,2,0,45200,25180,7.07553446114013,3.94163623299798,2,70380,fhi:git
county,Vestland,2021-03-08,630,14,45830,25194,7.1741536361516,3.94382777022045,644,71024,fhi:git
county,Vestland,2021-03-09,1499,527,47329,25721,7.40880465732968,4.02632349280941,2026,73050,fhi:git
county,Vestland,2021-03-10,2439,1829,49768,27550,7.79060174915978,4.31263217708873,4268,77318,fhi:git
county,Vestland,2021-03-11,1400,1540,51168,29090,8.00975547140748,4.5537012715612,2940,80258,fhi:git
county,Vestland,2021-03-12,178,929,51346,30019,8.03761930180755,4.69912542010986,1107,81365,fhi:git
county,Vestland,2021-03-13,8,10,51354,30029,8.03887160879182,4.7006908038402,18,81383,fhi:git
county,Vestland,2021-03-14,0,0,51354,30029,8.03887160879182,4.7006908038402,0,81383,fhi:git
county,Vestland,2021-03-15,7,8,51361,30037,8.03996737740306,4.70194311082447,15,81398,fhi:git
county,Vestland,2021-03-16,1191,33,52552,30070,8.22640457968664,4.7071088771346,1224,82622,fhi:git
county,Vestland,2021-03-17,2429,222,54981,30292,8.60663628778641,4.74186039594816,2651,85273,fhi:git
county,Vestland,2021-03-18,2313,145,57294,30437,8.96870954461422,4.7645584600381,2458,87731,fhi:git
county,Vestland,2021-03-19,587,115,57881,30552,9.06059756958522,4.78256037293702,702,88433,fhi:git
county,Vestland,2021-03-20,1,2,57882,30554,9.06075410795825,4.78287344968309,3,88436,fhi:git
county,Vestland,2021-03-21,0,0,57882,30554,9.06075410795825,4.78287344968309,0,88436,fhi:git
county,Vestland,2021-03-22,8,13,57890,30567,9.06200641494253,4.78490844853253,21,88457,fhi:git
county,Vestland,2021-03-23,2048,339,59938,30906,9.38259700291631,4.83797495699108,2387,90844,fhi:git
county,Vestland,2021-03-24,4004,502,63942,31408,10.0093766485447,4.91655722025419,4506,95350,fhi:git
county,Vestland,2021-03-25,3128,372,67070,31780,10.4990286793953,4.97478949502286,3500,98850,fhi:git
county,Vestland,2021-03-26,993,187,68063,31967,10.6544712838182,5.00406217078024,1180,100030,fhi:git
county,Vestland,2021-03-27,2,0,68065,31967,10.6547843605642,5.00406217078024,2,100032,fhi:git
county,Vestland,2021-03-28,0,0,68065,31967,10.6547843605642,5.00406217078024,0,100032,fhi:git
county,Vestland,2021-03-29,114,2,68179,31969,10.6726297350901,5.0043752475263,116,100148,fhi:git
county,Vestland,2021-03-30,3445,569,71624,32538,11.2119044301925,5.09344558178269,4014,104162,fhi:git
county,Viken,2020-12-27,0,0,0,0,0.0,0.0,0,0,fhi:git
county,Viken,2020-12-28,65,0,65,0,0.0052370152236004,0.0,65,65,fhi:git
county,Viken,2020-12-29,689,0,754,0,0.0607493765937647,0.0,689,754,fhi:git
county,Viken,2020-12-30,219,0,973,0,0.0783940894240492,0.0,219,973,fhi:git
county,Viken,2020-12-31,67,0,1040,0,0.0837922435776065,0.0,67,1040,fhi:git
county,Viken,2021-01-01,0,0,1040,0,0.0837922435776065,0.0,0,1040,fhi:git
county,Viken,2021-01-02,0,0,1040,0,0.0837922435776065,0.0,0,1040,fhi:git
county,Viken,2021-01-03,0,0,1040,0,0.0837922435776065,0.0,0,1040,fhi:git
county,Viken,2021-01-04,0,0,1040,0,0.0830416230165828,0.0,0,1040,fhi:git
county,Viken,2021-01-05,526,0,1566,0,0.125041520811508,0.0,526,1566,fhi:git
county,Viken,2021-01-06,1649,0,3215,0,0.256710401921455,0.0,1649,3215,fhi:git
county,Viken,2021-01-07,1922,0,5137,0,0.410177709073256,0.0,1922,5137,fhi:git
county,Viken,2021-01-08,282,0,5419,0,0.43269476454506,0.0,282,5419,fhi:git
county,Viken,2021-01-09,6,0,5425,0,0.433173850831694,0.0,6,5425,fhi:git
county,Viken,2021-01-10,5,0,5430,0,0.433573089403889,0.0,5,5430,fhi:git
county,Viken,2021-01-11,58,0,5488,0,0.438204256841352,0.0,58,5488,fhi:git
county,Viken,2021-01-12,788,0,6276,0,0.501124255819302,0.0,788,6276,fhi:git
county,Viken,2021-01-13,1945,0,8221,0,0.656428060403199,0.0,1945,8221,fhi:git
county,Viken,2021-01-14,1951,0,10172,0,0.812210951273731,0.0,1951,10172,fhi:git
county,Viken,2021-01-15,1049,0,11221,0,0.895971203720265,0.0,1049,11221,fhi:git
county,Viken,2021-01-16,90,0,11311,0,0.903157498019777,0.0,90,11311,fhi:git
county,Viken,2021-01-17,23,0,11334,0,0.904993995451874,0.0,23,11334,fhi:git
county,Viken,2021-01-18,144,51,11478,51,0.916492066331093,0.0040722334363901,195,11529,fhi:git
county,Viken,2021-01-19,648,384,12126,435,0.968233385287579,0.0347337557809745,1032,12561,fhi:git
county,Viken,2021-01-20,1492,342,13618,777,1.0873661752306,0.06204167411912,1834,14395,fhi:git
county,Viken,2021-01-21,1997,100,15615,877,1.24682206096533,0.0700264455630222,2097,16492,fhi:git
county,Viken,2021-01-22,822,1,16437,878,1.3124568822342,0.0701062932774612,823,17315,fhi:git
county,Viken,2021-01-23,98,0,16535,878,1.32028195824923,0.0701062932774612,98,17413,fhi:git
county,Viken,2021-01-24,0,0,16535,878,1.32028195824923,0.0701062932774612,0,17413,fhi:git
county,Viken,2021-01-25,62,0,16597,878,1.32523251654445,0.0701062932774612,62,17475,fhi:git
county,Viken,2021-01-26,563,402,17160,1280,1.37018677977362,0.102205074481948,965,18440,fhi:git
county,Viken,2021-01-27,1941,1218,19101,2498,1.52517119349976,0.199459590668677,3159,21599,fhi:git
county,Viken,2021-01-28,3104,1710,22205,4208,1.77301849911848,0.335999182359404,4814,26413,fhi:git
county,Viken,2021-01-29,1041,427,23246,4635,1.8561399698495,0.370094156424867,1468,27881,fhi:git
county,Viken,2021-01-30,10,18,23256,4653,1.85693844699389,0.371531415284769,28,27909,fhi:git
county,Viken,2021-01-31,10,3,23266,4656,1.85773692413828,0.371770958428086,13,27922,fhi:git
county,Viken,2021-02-01,36,46,23302,4702,1.86061144185809,0.375443953292281,82,28004,fhi:git
county,Viken,2021-02-02,1023,687,24325,5389,1.94229565372921,0.430299333111889,1710,29714,fhi:git
county,Viken,2021-02-03,4778,1723,29103,7112,2.32380803331885,0.567876945090324,6501,36215,fhi:git
county,Viken,2021-02-04,6641,1750,35744,8862,2.8540767049084,0.707610445358612,8391,44606,fhi:git
county,Viken,2021-02-05,3143,1098,38887,9960,3.10503807139025,0.795283235812658,4241,48847,fhi:git
county,Viken,2021-02-06,37,90,38924,10050,3.10799243682449,0.80246953011217,127,48974,fhi:git
county,Viken,2021-02-07,15,20,38939,10070,3.10919015254107,0.804066484400951,35,49009,fhi:git
county,Viken,2021-02-08,15,95,38954,10165,3.11038786825766,0.811652017272658,110,49119,fhi:git
county,Viken,2021-02-09,792,566,39746,10731,3.17362725809336,0.856845823645144,1358,50477,fhi:git
county,Viken,2021-02-10,3446,1325,43192,12056,3.44878248205023,0.962644045276848,4771,55248,fhi:git
county,Viken,2021-02-11,4847,1917,48039,13973,3.83580435393617,1.11571211385645,6764,62012,fhi:git
county,Viken,2021-02-12,2429,978,50468,14951,4.02975445230856,1.19380317857782,3407,65419,fhi:git
county,Viken,2021-02-13,24,97,50492,15048,4.03167079745509,1.2015484068784,121,65540,fhi:git
county,Viken,2021-02-14,6,0,50498,15048,4.03214988374173,1.2015484068784,6,65546,fhi:git
county,Viken,2021-02-15,355,125,50853,15173,4.06049582236758,1.21152937118328,480,66026,fhi:git
county,Viken,2021-02-16,1424,359,52277,15532,4.17419896772875,1.24019470066689,1783,67809,fhi:git
county,Viken,2021-02-17,4432,1811,56709,17343,4.52808403812249,1.38479891151596,6243,74052,fhi:git
county,Viken,2021-02-18,4890,2924,61599,20267,4.91853936172931,1.61827362853566,7814,81866,fhi:git
county,Viken,2021-02-19,3798,1282,65397,21549,5.22180098116872,1.72063839844648,5080,86946,fhi:git
county,Viken,2021-02-20,28,9,65425,21558,5.22403671717301,1.72135702787643,37,86983,fhi:git
county,Viken,2021-02-21,1,9,65426,21567,5.22411656488745,1.72207565730639,10,86993,fhi:git
county,Viken,2021-02-22,702,8,66128,21575,5.28016966042364,1.7227144390219,710,87703,fhi:git
county,Viken,2021-02-23,2128,755,68256,22330,5.45008559674988,1.78299946342336,2883,90586,fhi:git
county,Viken,2021-02-24,2463,4196,70719,26526,5.64675051741319,2.11804047320949,6659,97245,fhi:git
county,Viken,2021-02-25,2544,6263,73263,32789,5.84988310294606,2.61812670874109,8807,106052,fhi:git
county,Viken,2021-02-26,1931,2719,75194,35508,6.00406903952781,2.83523264430079,4650,110702,fhi:git
county,Viken,2021-02-27,166,88,75360,35596,6.01732376012469,2.84225924317142,254,110956,fhi:git
county,Viken,2021-02-28,416,1,75776,35597,6.05054040933132,2.84233909088586,417,111373,fhi:git
county,Viken,2021-03-01,1520,2,77296,35599,6.17190893527864,2.84249878631474,1522,112895,fhi:git
county,Viken,2021-03-02,3012,518,80308,36117,6.41241025116897,2.88385990239415,3530,116425,fhi:git
county,Viken,2021-03-03,4947,2696,85255,38813,6.80741689449881,3.09912934052176,7643,124068,fhi:git
county,Viken,2021-03-04,4393,3261,89648,42074,7.15818790402944,3.35951273730741,7654,131722,fhi:git
county,Viken,2021-03-05,2721,1781,92369,43855,7.37545353501801,3.50172151672331,4502,136224,fhi:git
county,Viken,2021-03-06,210,1,92579,43856,7.39222155505021,3.50180136443774,211,136435,fhi:git
county,Viken,2021-03-07,17,0,92596,43856,7.39357896619567,3.50180136443774,17,136452,fhi:git
county,Viken,2021-03-08,1130,22,93726,43878,7.48380688351177,3.5035580141554,1152,137604,fhi:git
county,Viken,2021-03-09,2887,713,96613,44591,7.71432723509722,3.56048943455043,3600,141204,fhi:git
county,Viken,2021-03-10,5390,3194,102003,47785,8.14470641592355,3.81552303446866,8584,149788,fhi:git
county,Viken,2021-03-11,3411,4760,105414,52545,8.41706696987506,4.19559815519841,8171,157959,fhi:git
county,Viken,2021-03-12,1218,3303,106632,55848,8.51432148606178,4.4593351559905,4521,162480,fhi:git
county,Viken,2021-03-13,6,8,106638,55856,8.51480057234842,4.45997393770601,14,162494,fhi:git
county,Viken,2021-03-14,2,5,106640,55861,8.5149602677773,4.4603731762782,7,162501,fhi:git
county,Viken,2021-03-15,35,47,106675,55908,8.51775493778266,4.46412601885684,82,162583,fhi:git
county,Viken,2021-03-16,774,302,107449,56210,8.57955706875847,4.48824002861742,1076,163659,fhi:git
county,Viken,2021-03-17,3977,413,111426,56623,8.89711142908245,4.52121713468074,4390,168049,fhi:git
county,Viken,2021-03-18,5903,433,117329,57056,9.368452487416,4.55579119503283,6336,174385,fhi:git
county,Viken,2021-03-19,2022,365,119351,57421,9.5299045660117,4.58493561080308,2387,176772,fhi:git
county,Viken,2021-03-20,6,1,119357,57422,9.53038365229834,4.58501545851752,7,176779,fhi:git
county,Viken,2021-03-21,6,1,119363,57423,9.53086273858497,4.58509530623195,7,176786,fhi:git
county,Viken,2021-03-22,399,24,119762,57447,9.56272197664614,4.58701165137849,423,177209,fhi:git
county,Viken,2021-03-23,2466,81,122228,57528,9.75962644045277,4.59347931624805,2547,179756,fhi:git
county,Viken,2021-03-24,7371,746,129599,58274,10.3481839435828,4.65304571121956,8117,187873,fhi:git
county,Viken,2021-03-25,10141,616,139740,58890,11.1579196157089,4.702231903314,10757,198630,fhi:git
county,Viken,2021-03-26,5864,315,145604,59205,11.6261466131793,4.72738393336229,6179,204809,fhi:git
county,Viken,2021-03-27,4,1,145608,59206,11.6264660040371,4.72746378107673,5,204814,fhi:git
county,Viken,2021-03-28,4,0,145612,59206,11.6267853948949,4.72746378107673,4,204818,fhi:git
county,Viken,2021-03-29,1313,3,146925,59209,11.7316254439533,4.72770332422005,1316,206134,fhi:git
county,Viken,2021-03-30,5909,1598,152834,60807,12.2034455885735,4.8552999718936,7507,213641,fhi:git
nation,Norge,2020-12-27,5,0,5,0,9.31518486915891e-05,0.0,5,5,fhi:git
nation,Norge,2020-12-28,604,0,609,0,0.0113458951706356,0.0,604,609,fhi:git
nation,Norge,2020-12-29,1067,0,1676,0,0.0312244996814207,0.0,1067,1676,fhi:git
nation,Norge,2020-12-30,427,0,2103,0,0.0391796675596824,0.0,427,2103,fhi:git
nation,Norge,2020-12-31,72,0,2175,0,0.0405210541808413,0.0,72,2175,fhi:git
nation,Norge,2021-01-01,6,0,2181,0,0.0406328363992712,0.0,6,2181,fhi:git
nation,Norge,2021-01-02,0,0,2181,0,0.0406328363992712,0.0,0,2181,fhi:git
nation,Norge,2021-01-03,3,0,2184,0,0.0406887275084861,0.0,3,2184,fhi:git
nation,Norge,2021-01-04,6,0,2190,0,0.0406204806237525,0.0,6,2190,fhi:git
nation,Norge,2021-01-05,3385,0,5575,0,0.103406018026219,0.0,3385,5575,fhi:git
nation,Norge,2021-01-06,9064,0,14639,0,0.271526582580417,0.0,9064,14639,fhi:git
nation,Norge,2021-01-07,6553,0,21192,0,0.393072705652312,0.0,6553,21192,fhi:git
nation,Norge,2021-01-08,1616,0,22808,0,0.423046539756414,0.0,1616,22808,fhi:git
nation,Norge,2021-01-09,135,0,22943,0,0.425550541986646,0.0,135,22943,fhi:git
nation,Norge,2021-01-10,108,0,23051,0,0.427553743770831,0.0,108,23051,fhi:git
nation,Norge,2021-01-11,355,0,23406,0,0.434138342228106,0.0,355,23406,fhi:git
nation,Norge,2021-01-12,4260,0,27666,0,0.513153523715405,0.0,4260,27666,fhi:git
nation,Norge,2021-01-13,9776,0,37442,0,0.69448038151349,0.0,9776,37442,fhi:git
nation,Norge,2021-01-14,8472,0,45914,0,0.851620432584006,0.0,8472,45914,fhi:git
nation,Norge,2021-01-15,4477,0,50391,0,0.934660565804344,0.0,4477,50391,fhi:git
nation,Norge,2021-01-16,746,0,51137,0,0.948497496646956,0.0,746,51137,fhi:git
nation,Norge,2021-01-17,349,5,51486,5,0.95497080611622,9.27408233419007e-05,354,51491,fhi:git
nation,Norge,2021-01-18,1284,283,52770,288,0.97878664955042,0.0053418714244934,1567,53058,fhi:git
nation,Norge,2021-01-19,4589,772,57359,1060,1.06390417721362,0.019661054548483,5361,58419,fhi:git
nation,Norge,2021-01-20,10062,693,67421,1753,1.25053581010686,0.0325149326636704,10755,69174,fhi:git
nation,Norge,2021-01-21,8435,169,75856,1922,1.40698957908464,0.0356495724926266,8604,77778,fhi:git
nation,Norge,2021-01-22,3317,7,79173,1929,1.46851384128966,0.0357794096453053,3324,81102,fhi:git
nation,Norge,2021-01-23,359,0,79532,1929,1.47517263240561,0.0357794096453053,359,81461,fhi:git
nation,Norge,2021-01-24,67,0,79599,1929,1.47641535943839,0.0357794096453053,67,81528,fhi:git
nation,Norge,2021-01-25,581,0,80180,1929,1.48719184311072,0.0357794096453053,581,82109,fhi:git
nation,Norge,2021-01-26,2278,2142,82458,4071,1.52944456222529,0.0755095783649756,4420,86529,fhi:git
nation,Norge,2021-01-27,11417,7596,93875,11667,1.74120895824419,0.216401437185991,19013,105542,fhi:git
nation,Norge,2021-01-28,10900,6572,104775,18239,1.94338395312953,0.338299975386586,17472,123014,fhi:git
nation,Norge,2021-01-29,3812,2107,108587,20346,2.0140895568454,0.377380958342862,5919,128933,fhi:git
nation,Norge,2021-01-30,147,172,108734,20518,2.01681613705165,0.380571242665824,319,129252,fhi:git
nation,Norge,2021-01-31,101,51,108835,20569,2.01868950168315,0.381517199063911,152,129404,fhi:git
nation,Norge,2021-02-01,198,303,109033,20872,2.02236203828749,0.38713729295843,501,129905,fhi:git
nation,Norge,2021-02-02,6357,3144,115390,24016,2.14027272108439,0.445452722675818,9501,139406,fhi:git
nation,Norge,2021-02-03,25134,8320,140524,32336,2.60646229185945,0.59977345271674,33454,172860,fhi:git
nation,Norge,2021-02-04,25969,8660,166493,40996,3.08813958013262,0.760400558744912,34629,207489,fhi:git
nation,Norge,2021-02-05,10625,4864,177118,45860,3.28521382973416,0.850618831691913,15489,222978,fhi:git
nation,Norge,2021-02-06,808,736,177926,46596,3.30020074678621,0.864270280887841,1544,224522,fhi:git
nation,Norge,2021-02-07,320,296,178246,46892,3.30613615948009,0.869760537629682,616,225138,fhi:git
nation,Norge,2021-02-08,120,922,178366,47814,3.30836193924029,0.886861945453928,1042,226180,fhi:git
nation,Norge,2021-02-09,5542,3241,183908,51055,3.41115586783246,0.946976547144148,8783,234963,fhi:git
nation,Norge,2021-02-10,22993,8665,206901,59720,3.83763381805252,1.10769639399566,31658,266621,fhi:git
nation,Norge,2021-02-11,20938,8573,227839,68293,4.22599528987906,1.26670980969769,29511,296132,fhi:git
nation,Norge,2021-02-12,8042,3610,235881,71903,4.37515963014218,1.33366868415054,11652,307784,fhi:git
nation,Norge,2021-02-13,893,306,236774,72209,4.39172314119104,1.33934442253906,1199,308983,fhi:git
nation,Norge,2021-02-14,110,3,236884,72212,4.39376343930456,1.33940006703307,113,309096,fhi:git
nation,Norge,2021-02-15,803,751,237687,72963,4.40865761553327,1.35332973869902,1554,310650,fhi:git
nation,Norge,2021-02-16,6026,2175,243713,75138,4.52042885582493,1.39367199685275,8201,318851,fhi:git
nation,Norge,2021-02-17,21814,10203,265527,85341,4.92503851990098,1.58291892096423,32017,350868,fhi:git
nation,Norge,2021-02-18,18888,10816,284415,96157,5.27537625415734,1.78353587001743,29704,380572,fhi:git
nation,Norge,2021-02-19,10738,4798,295153,100955,5.47454644636641,1.87252996409632,15536,396108,fhi:git
nation,Norge,2021-02-20,500,172,295653,101127,5.4838205287006,1.87572024841928,672,396780,fhi:git
nation,Norge,2021-02-21,58,101,295711,101228,5.48489632225136,1.87759361305079,159,396939,fhi:git
nation,Norge,2021-02-22,2572,141,298283,101369,5.53260220177844,1.88020890426903,2713,399652,fhi:git
nation,Norge,2021-02-23,5749,5205,304032,106574,5.63923560045695,1.97675210136795,10954,410606,fhi:git
nation,Norge,2021-02-24,10962,22333,314994,128907,5.84256058155174,2.39098826290688,33295,443901,fhi:git
nation,Norge,2021-02-25,11146,25057,326140,153964,6.0492984249455,2.85574962500248,36203,480104,fhi:git
nation,Norge,2021-02-26,8299,9930,334439,163894,6.20322964352839,3.0399329001595,18229,498333,fhi:git
nation,Norge,2021-02-27,440,202,334879,164096,6.21139083598248,3.04367962942251,642,498975,fhi:git
nation,Norge,2021-02-28,538,159,335417,164255,6.22136974857406,3.04662878760478,697,499672,fhi:git
nation,Norge,2021-03-01,5918,62,341335,164317,6.33113778708154,3.04777877381422,5980,505652,fhi:git
nation,Norge,2021-03-02,10517,3822,351852,168139,6.52620883489889,3.11866985917677,14339,519991,fhi:git
nation,Norge,2021-03-03,17627,18055,369479,186194,6.85315733350843,3.45355697226437,35682,555673,fhi:git
nation,Norge,2021-03-04,16231,18442,385710,204636,7.15421259424091,3.79562222507864,34673,590346,fhi:git
nation,Norge,2021-03-05,11878,6526,397588,211162,7.37452769417193,3.91666754770449,18404,608750,fhi:git
nation,Norge,2021-03-06,380,478,397968,211640,7.38157599674591,3.92553357041597,858,609608,fhi:git
nation,Norge,2021-03-07,91,1,398059,211641,7.38326387973073,3.92555211858064,92,609700,fhi:git
nation,Norge,2021-03-08,4890,46,402949,211687,7.47396440495911,3.92640533415539,4936,614636,fhi:git
nation,Norge,2021-03-09,12332,4271,415281,215958,7.70270037164958,4.00562454545404,16603,631239,fhi:git
nation,Norge,2021-03-10,20946,17191,436227,233149,8.09121022879347,4.32448604426816,38137,669376,fhi:git
nation,Norge,2021-03-11,11943,16561,448170,249710,8.31273095942793,4.63166219934121,28504,697880,fhi:git
nation,Norge,2021-03-12,2312,8256,450482,257966,8.35561431614122,4.78479584684335,10568,708448,fhi:git
nation,Norge,2021-03-13,33,304,450515,258270,8.35622640557528,4.79043448890254,337,708785,fhi:git
nation,Norge,2021-03-14,3,109,450518,258379,8.35628205006929,4.79245623885139,112,708897,fhi:git
nation,Norge,2021-03-15,99,436,450617,258815,8.35811831837146,4.80054323864681,535,709432,fhi:git
nation,Norge,2021-03-16,5641,625,456258,259440,8.46274851526579,4.81213584156455,6266,715698,fhi:git
nation,Norge,2021-03-17,23018,1552,479276,260992,8.88969016960256,4.84092259312987,24570,740268,fhi:git
nation,Norge,2021-03-18,20991,1399,500267,262391,9.27903469415653,4.86687147550094,22390,762658,fhi:git
nation,Norge,2021-03-19,6741,970,507008,263361,9.40406787218608,4.88486319522926,7711,770369,fhi:git
nation,Norge,2021-03-20,458,21,507466,263382,9.4125629316042,4.8852527066873,479,770848,fhi:git
nation,Norge,2021-03-21,187,68,507653,263450,9.41603143839719,4.88651398188475,255,771103,fhi:git
nation,Norge,2021-03-22,1504,86,509157,263536,9.44392787805843,4.88810912404623,1590,772693,fhi:git
nation,Norge,2021-03-23,13088,953,522245,264489,9.68668625723819,4.9057855249752,14041,786734,fhi:git
nation,Norge,2021-03-24,38985,3630,561230,268119,10.409786456835,4.97311536272142,42615,829349,fhi:git
nation,Norge,2021-03-25,38539,2310,599769,270429,11.1246141749897,5.01596162310537,40849,870198,fhi:git
nation,Norge,2021-03-26,17124,1138,616893,271567,11.442232946771,5.03706943449799,18262,888460,fhi:git
nation,Norge,2021-03-27,565,6,617458,271573,11.4527126598087,5.037180723486,571,889031,fhi:git
nation,Norge,2021-03-28,329,2,617787,271575,11.4588150059846,5.03721781981534,331,889362,fhi:git
nation,Norge,2021-03-29,4619,20,622406,271595,11.5444889785878,5.03758878310871,4639,894001,fhi:git
nation,Norge,2021-03-30,28502,3746,650908,275341,12.073148767966,5.10707020795646,32248,926249,fhi:git
