granularity_geo,location_name,date,new_dose_1,new_dose_2,total_dose_1,total_dose_2,total_pr100_dose_1,total_pr100_dose_2,new_doses,total_doses,source
county,Agder,2020-12-27,0,0,0,0,0.0,0.0,0,0,fhi:git
county,Agder,2020-12-28,0,0,0,0,0.0,0.0,0,0,fhi:git
county,Agder,2020-12-29,0,0,0,0,0.0,0.0,0,0,fhi:git
county,Agder,2020-12-30,0,0,0,0,0.0,0.0,0,0,fhi:git
county,Agder,2020-12-31,0,0,0,0,0.0,0.0,0,0,fhi:git
county,Agder,2021-01-01,0,0,0,0,0.0,0.0,0,0,fhi:git
county,Agder,2021-01-02,0,0,0,0,0.0,0.0,0,0,fhi:git
county,Agder,2021-01-03,3,0,3,0,0.0009764639635974,0.0,3,3,fhi:git
county,Agder,2021-01-04,0,0,3,0,0.0009713673290312,0.0,0,3,fhi:git
county,Agder,2021-01-05,79,0,82,0,0.026550706993521,0.0,79,82,fhi:git
county,Agder,2021-01-06,794,0,876,0,0.283639260077127,0.0,794,876,fhi:git
county,Agder,2021-01-07,230,0,1106,0,0.358110755302856,0.0,230,1106,fhi:git
county,Agder,2021-01-08,49,0,1155,0,0.373976421677033,0.0,49,1155,fhi:git
county,Agder,2021-01-09,0,0,1155,0,0.373976421677033,0.0,0,1155,fhi:git
county,Agder,2021-01-10,0,0,1155,0,0.373976421677033,0.0,0,1155,fhi:git
county,Agder,2021-01-11,1,0,1156,0,0.37430021078671,0.0,1,1156,fhi:git
county,Agder,2021-01-12,226,0,1382,0,0.447476549573732,0.0,226,1382,fhi:git
county,Agder,2021-01-13,862,0,2244,0,0.726582762115379,0.0,862,2244,fhi:git
county,Agder,2021-01-14,516,0,2760,0,0.893657942708755,0.0,516,2760,fhi:git
county,Agder,2021-01-15,119,0,2879,0,0.932188846760328,0.0,119,2879,fhi:git
county,Agder,2021-01-16,1,0,2880,0,0.932512635870005,0.0,1,2880,fhi:git
county,Agder,2021-01-17,2,0,2882,0,0.933160214089359,0.0,2,2882,fhi:git
county,Agder,2021-01-18,15,0,2897,0,0.938017050734516,0.0,15,2897,fhi:git
county,Agder,2021-01-19,346,0,3243,0,1.05004808268279,0.0,346,3243,fhi:git
county,Agder,2021-01-20,460,0,3703,0,1.19899107313425,0.0,460,3703,fhi:git
county,Agder,2021-01-21,338,0,4041,0,1.3084317922051,0.0,338,4041,fhi:git
county,Agder,2021-01-22,67,0,4108,0,1.33012566255347,0.0,67,4108,fhi:git
county,Agder,2021-01-23,2,0,4110,0,1.33077324077282,0.0,2,4110,fhi:git
county,Agder,2021-01-24,0,0,4110,0,1.33077324077282,0.0,0,4110,fhi:git
county,Agder,2021-01-25,3,0,4113,0,1.33174460810185,0.0,3,4113,fhi:git
county,Agder,2021-01-26,63,66,4176,66,1.35214332201151,0.0213700812386876,129,4242,fhi:git
county,Agder,2021-01-27,567,681,4743,747,1.53573174719841,0.241870464928783,1248,5490,fhi:git
county,Agder,2021-01-28,951,251,5694,998,1.84365519050132,0.323141531457731,1202,6692,fhi:git
county,Agder,2021-01-29,204,61,5898,1059,1.90970816887545,0.342892667148033,265,6957,fhi:git
county,Agder,2021-01-30,32,0,5930,1059,1.92006942038512,0.342892667148033,32,6989,fhi:git
county,Agder,2021-01-31,25,0,5955,1059,1.92816414812704,0.342892667148033,25,7014,fhi:git
county,Agder,2021-02-01,1,2,5956,1061,1.92848793723672,0.343540245367387,3,7017,fhi:git
county,Agder,2021-02-02,203,170,6159,1231,1.99421712650117,0.398584394012492,373,7390,fhi:git
county,Agder,2021-02-03,1333,603,7492,1834,2.42582800970072,0.593829227147774,1936,9326,fhi:git
county,Agder,2021-02-04,1709,504,9201,2338,2.97918359813886,0.757018938425025,2213,11539,fhi:git
county,Agder,2021-02-05,620,135,9821,2473,3.17993284613865,0.800730468231432,755,12294,fhi:git
county,Agder,2021-02-06,512,2,10333,2475,3.34571287029332,0.801378046450786,514,12808,fhi:git
county,Agder,2021-02-07,87,2,10420,2477,3.37388252283523,0.80202562467014,89,12897,fhi:git
county,Agder,2021-02-08,13,2,10433,2479,3.37809178126103,0.802673202889494,15,12912,fhi:git
county,Agder,2021-02-09,189,254,10622,2733,3.43928792299,0.884915636747474,443,13355,fhi:git
county,Agder,2021-02-10,1152,371,11774,3104,3.812292977338,1.00504139643767,1523,14878,fhi:git
county,Agder,2021-02-11,1010,412,12784,3516,4.13931997811186,1.13844250962463,1422,16300,fhi:git
county,Agder,2021-02-12,358,69,13142,3585,4.25523647937625,1.16078395819235,427,16727,fhi:git
county,Agder,2021-02-13,510,3,13652,3588,4.42036892531157,1.16175532552138,513,17240,fhi:git
county,Agder,2021-02-14,0,0,13652,3588,4.42036892531157,1.16175532552138,0,17240,fhi:git
county,Agder,2021-02-15,1,1,13653,3589,4.42069271442124,1.16207911463106,2,17242,fhi:git
county,Agder,2021-02-16,141,117,13794,3706,4.46634697888571,1.19996244046328,258,17500,fhi:git
county,Agder,2021-02-17,1222,435,15016,4141,4.86201727091111,1.34081070317281,1657,19157,fhi:git
county,Agder,2021-02-18,1087,823,16103,4964,5.2139760331301,1.60728914043705,1910,21067,fhi:git
county,Agder,2021-02-19,721,343,16824,5307,5.44742798120728,1.71834880505629,1064,22131,fhi:git
county,Agder,2021-02-20,355,37,17179,5344,5.56237311514265,1.73032900211434,392,22523,fhi:git
county,Agder,2021-02-21,52,24,17231,5368,5.57921014884585,1.73809994074659,76,22599,fhi:git
county,Agder,2021-02-22,223,1,17454,5369,5.65141512030384,1.73842372985627,224,22823,fhi:git
county,Agder,2021-02-23,294,201,17748,5570,5.74660911854891,1.80350534090136,495,23318,fhi:git
county,Agder,2021-02-24,976,1111,18724,6681,6.06262728959374,2.16323504175261,2087,25405,fhi:git
county,Agder,2021-02-25,717,1568,19441,8249,6.29478408123221,2.67093636572628,2285,27690,fhi:git
county,Agder,2021-02-26,399,466,19840,8715,6.42397593599337,2.8218220908358,865,28555,fhi:git
county,Agder,2021-02-27,0,1,19840,8716,6.42397593599337,2.82214587994547,1,28556,fhi:git
county,Agder,2021-02-28,10,82,19850,8798,6.42721382709014,2.84869658693899,92,28648,fhi:git
county,Agder,2021-03-01,263,0,20113,8798,6.51237036293521,2.84869658693899,263,28911,fhi:git
county,Agder,2021-03-02,578,192,20691,8990,6.69952046832857,2.910864095997,770,29681,fhi:git
county,Agder,2021-03-03,635,878,21326,9868,6.90512655297352,3.19515093429348,1513,31194,fhi:git
county,Agder,2021-03-04,795,1070,22121,10938,7.1625388951668,3.54160528164796,1865,33059,fhi:git
county,Agder,2021-03-05,961,383,23082,11321,7.47370022956648,3.66561651065428,1344,34403,fhi:git
county,Agder,2021-03-06,36,405,23118,11726,7.48535663751485,3.7967511000735,441,34844,fhi:git
county,Agder,2021-03-07,3,1,23121,11727,7.48632800484389,3.79707488918318,4,34848,fhi:git
county,Agder,2021-03-08,226,0,23347,11727,7.55950434363091,3.79707488918318,226,35074,fhi:git
county,Agder,2021-03-09,723,141,24070,11868,7.79360386992744,3.84272915364765,864,35938,fhi:git
county,Agder,2021-03-10,1035,784,25105,12652,8.12872559844322,4.09657981563448,1819,37757,fhi:git
county,Agder,2021-03-11,646,814,25751,13466,8.33789336329462,4.36014415091163,1460,39217,fhi:git
county,Agder,2021-03-12,99,327,25850,13793,8.36994848515265,4.46602318977604,426,39643,fhi:git
county,Agder,2021-03-13,0,0,25850,13793,8.36994848515265,4.46602318977604,0,39643,fhi:git
county,Agder,2021-03-14,0,0,25850,13793,8.36994848515265,4.46602318977604,0,39643,fhi:git
county,Agder,2021-03-15,0,3,25850,13796,8.36994848515265,4.46699455710507,3,39646,fhi:git
county,Agder,2021-03-16,240,14,26090,13810,8.44765787147515,4.47152760464055,254,39900,fhi:git
county,Agder,2021-03-17,1608,48,27698,13858,8.9683107598359,4.48706948190505,1656,41556,fhi:git
county,Agder,2021-03-18,1245,94,28943,13952,9.37142820138387,4.51750565821469,1339,42895,fhi:git
county,Agder,2021-03-19,265,41,29208,13993,9.4572323154483,4.53078101171145,306,43201,fhi:git
county,Agder,2021-03-20,0,0,29208,13993,9.4572323154483,4.53078101171145,0,43201,fhi:git
county,Agder,2021-03-21,17,53,29225,14046,9.46273673031281,4.54794183452434,70,43271,fhi:git
county,Agder,2021-03-22,9,1,29234,14047,9.46565083229991,4.54826562363401,10,43281,fhi:git
county,Agder,2021-03-23,314,14,29548,14061,9.56732061273851,4.55279867116949,328,43609,fhi:git
county,Agder,2021-03-24,2267,75,31815,14136,10.3013505243765,4.57708285439528,2342,45951,fhi:git
county,Agder,2021-03-25,2037,53,33852,14189,10.9609089407887,4.59424367720816,2090,48041,fhi:git
county,Agder,2021-03-26,776,12,34628,14201,11.2121692898981,4.59812914652429,788,48829,fhi:git
county,Agder,2021-03-27,1,0,34629,14201,11.2124930790078,4.59812914652429,1,48830,fhi:git
county,Agder,2021-03-28,173,1,34802,14202,11.2685085949819,4.59845293563396,174,49004,fhi:git
county,Agder,2021-03-29,107,0,34909,14202,11.3031540297174,4.59845293563396,107,49111,fhi:git
county,Agder,2021-03-30,689,71,35598,14273,11.5262447262849,4.62144196242104,760,49871,fhi:git
county,Agder,2021-03-31,3371,402,38969,14675,12.6177378150063,4.75160518451122,3773,53644,fhi:git
county,Agder,2021-04-01,237,49,39206,14724,12.6944758339998,4.7674708508854,286,53930,fhi:git
county,Agder,2021-04-02,1,0,39207,14724,12.6947996231095,4.7674708508854,1,53931,fhi:git
county,Agder,2021-04-03,12,0,39219,14724,12.6986850924256,4.7674708508854,12,53943,fhi:git
county,Agder,2021-04-04,1,5,39220,14729,12.6990088815353,4.76908979643379,6,53949,fhi:git
county,Agder,2021-04-05,0,0,39220,14729,12.6990088815353,4.76908979643379,0,53949,fhi:git
county,Agder,2021-04-06,619,1,39839,14730,12.8994343404254,4.76941358554346,620,54569,fhi:git
county,Agder,2021-04-07,3654,60,43493,14790,14.0825597471855,4.78884093212409,3714,58283,fhi:git
county,Agder,2021-04-08,2571,48,46064,14838,14.9150215481653,4.80438280938859,2619,60902,fhi:git
county,Innlandet,2020-12-27,0,0,0,0,0.0,0.0,0,0,fhi:git
county,Innlandet,2020-12-28,272,0,272,0,0.0732393607711674,0.0,272,272,fhi:git
county,Innlandet,2020-12-29,260,0,532,0,0.143247573273019,0.0,260,532,fhi:git
county,Innlandet,2020-12-30,149,0,681,0,0.183367664283695,0.0,149,681,fhi:git
county,Innlandet,2020-12-31,0,0,681,0,0.183367664283695,0.0,0,681,fhi:git
county,Innlandet,2021-01-01,0,0,681,0,0.183367664283695,0.0,0,681,fhi:git
county,Innlandet,2021-01-02,0,0,681,0,0.183367664283695,0.0,0,681,fhi:git
county,Innlandet,2021-01-03,0,0,681,0,0.183367664283695,0.0,0,681,fhi:git
county,Innlandet,2021-01-04,0,0,681,0,0.183754583745949,0.0,0,681,fhi:git
county,Innlandet,2021-01-05,271,0,952,0,0.256878654517098,0.0,271,952,fhi:git
county,Innlandet,2021-01-06,703,0,1655,0,0.446569509690963,0.0,703,1655,fhi:git
county,Innlandet,2021-01-07,696,0,2351,0,0.634371551228673,0.0,696,2351,fhi:git
county,Innlandet,2021-01-08,75,0,2426,0,0.654608840187478,0.0,75,2426,fhi:git
county,Innlandet,2021-01-09,0,0,2426,0,0.654608840187478,0.0,0,2426,fhi:git
county,Innlandet,2021-01-10,0,0,2426,0,0.654608840187478,0.0,0,2426,fhi:git
county,Innlandet,2021-01-11,50,0,2476,0,0.668100366160015,0.0,50,2476,fhi:git
county,Innlandet,2021-01-12,403,0,2879,0,0.77684206549866,0.0,403,2879,fhi:git
county,Innlandet,2021-01-13,993,0,3872,0,1.04478377131324,0.0,993,3872,fhi:git
county,Innlandet,2021-01-14,958,0,4830,0,1.30328140894704,0.0,958,4830,fhi:git
county,Innlandet,2021-01-15,280,0,5110,0,1.37883395439325,0.0,280,5110,fhi:git
county,Innlandet,2021-01-16,4,0,5114,0,1.37991327647105,0.0,4,5114,fhi:git
county,Innlandet,2021-01-17,0,0,5114,0,1.37991327647105,0.0,0,5114,fhi:git
county,Innlandet,2021-01-18,62,0,5176,0,1.39664276867699,0.0,62,5176,fhi:git
county,Innlandet,2021-01-19,331,318,5507,318,1.48595667061519,0.0858061051853331,649,5825,fhi:git
county,Innlandet,2021-01-20,662,252,6169,570,1.66458447449157,0.153803396086918,914,6739,fhi:git
county,Innlandet,2021-01-21,834,48,7003,618,1.88962312771348,0.166755261020553,882,7621,fhi:git
county,Innlandet,2021-01-22,239,0,7242,618,1.95411262186221,0.166755261020553,239,7860,fhi:git
county,Innlandet,2021-01-23,6,0,7248,618,1.95573160497891,0.166755261020553,6,7866,fhi:git
county,Innlandet,2021-01-24,0,0,7248,618,1.95573160497891,0.166755261020553,0,7866,fhi:git
county,Innlandet,2021-01-25,1,0,7249,618,1.95600143549836,0.166755261020553,1,7867,fhi:git
county,Innlandet,2021-01-26,152,131,7401,749,1.99701567445487,0.202103059068599,283,8150,fhi:git
county,Innlandet,2021-01-27,935,604,8336,1353,2.24930721014131,0.365080692816842,1539,9689,fhi:git
county,Innlandet,2021-01-28,903,708,9239,2061,2.49296416920532,0.556120700587961,1611,11300,fhi:git
county,Innlandet,2021-01-29,319,132,9558,2193,2.57904010491011,0.591738329155457,451,11751,fhi:git
county,Innlandet,2021-01-30,2,0,9560,2193,2.57957976594901,0.591738329155457,2,11753,fhi:git
county,Innlandet,2021-01-31,1,0,9561,2193,2.57984959646846,0.591738329155457,1,11754,fhi:git
county,Innlandet,2021-02-01,9,49,9570,2242,2.58227807114351,0.604960024608543,58,11812,fhi:git
county,Innlandet,2021-02-02,611,341,10181,2583,2.74714451852791,0.696972231741243,952,12764,fhi:git
county,Innlandet,2021-02-03,2310,872,12491,3455,3.37045301845911,0.932264444702282,3182,15946,fhi:git
county,Innlandet,2021-02-04,2657,998,15148,4453,4.0873927086397,1.20155530311411,3655,19601,fhi:git
county,Innlandet,2021-02-05,815,271,15963,4724,4.30730458199205,1.27467937388526,1086,20687,fhi:git
county,Innlandet,2021-02-06,7,4,15970,4728,4.30919339562821,1.27575869596307,11,20698,fhi:git
county,Innlandet,2021-02-07,0,0,15970,4728,4.30919339562821,1.27575869596307,0,20698,fhi:git
county,Innlandet,2021-02-08,2,62,15972,4790,4.30973305666711,1.29248818816901,64,20762,fhi:git
county,Innlandet,2021-02-09,257,269,16229,5059,4.37907950016595,1.36507259790126,526,21288,fhi:git
county,Innlandet,2021-02-10,2056,589,18285,5648,4.93385104815665,1.52400277385774,2645,23933,fhi:git
county,Innlandet,2021-02-11,2237,848,20522,6496,5.53746192016794,1.75281905435196,3085,27018,fhi:git
county,Innlandet,2021-02-12,430,283,20952,6779,5.65348904353176,1.82918109135652,713,27731,fhi:git
county,Innlandet,2021-02-13,0,5,20952,6784,5.65348904353176,1.83053024395377,5,27736,fhi:git
county,Innlandet,2021-02-14,1,1,20953,6785,5.65375887405121,1.83080007447322,2,27738,fhi:git
county,Innlandet,2021-02-15,86,14,21039,6799,5.67696429872397,1.83457770174553,100,27838,fhi:git
county,Innlandet,2021-02-16,530,92,21569,6891,5.81997447403286,1.859402109535,622,28460,fhi:git
county,Innlandet,2021-02-17,1572,783,23141,7674,6.24414805060941,2.07067940626493,2355,30815,fhi:git
county,Innlandet,2021-02-18,1466,903,24607,8577,6.63971959212419,2.31433636532894,2369,33184,fhi:git
county,Innlandet,2021-02-19,540,296,25147,8873,6.78542807262758,2.39420619908635,836,34020,fhi:git
county,Innlandet,2021-02-20,0,3,25147,8876,6.78542807262758,2.39501569064471,3,34023,fhi:git
county,Innlandet,2021-02-21,0,1,25147,8877,6.78542807262758,2.39528552116416,1,34024,fhi:git
county,Innlandet,2021-02-22,284,3,25431,8880,6.86205994015159,2.39609501272251,287,34311,fhi:git
county,Innlandet,2021-02-23,320,307,25751,9187,6.94840570637583,2.47893298219388,627,34938,fhi:git
county,Innlandet,2021-02-24,852,2319,26603,11506,7.17830130894785,3.10466995680013,3171,38109,fhi:git
county,Innlandet,2021-02-25,1749,2474,28352,13980,7.65023488746718,3.77223066192125,4223,42332,fhi:git
county,Innlandet,2021-02-26,677,814,29029,14794,7.83291014913533,3.99187270475414,1491,43823,fhi:git
county,Innlandet,2021-02-27,3,1,29032,14795,7.83371964069368,3.99214253527359,4,43827,fhi:git
county,Innlandet,2021-02-28,3,6,29035,14801,7.83452913225203,3.9937615183903,9,43836,fhi:git
county,Innlandet,2021-03-01,189,7,29224,14808,7.88552710042822,3.99565033202645,196,44032,fhi:git
county,Innlandet,2021-03-02,530,159,29754,14967,8.02853727573711,4.03855338461912,689,44721,fhi:git
county,Innlandet,2021-03-03,1598,1972,31352,16939,8.45972644581938,4.57065916897597,3570,48291,fhi:git
county,Innlandet,2021-03-04,1520,2287,32872,19226,8.86986883538449,5.18776156695979,3807,52098,fhi:git
county,Innlandet,2021-03-05,547,421,33419,19647,9.01746612952405,5.30136021564855,968,53066,fhi:git
county,Innlandet,2021-03-06,7,3,33426,19650,9.0193549431602,5.3021697072069,10,53076,fhi:git
county,Innlandet,2021-03-07,0,0,33426,19650,9.0193549431602,5.3021697072069,0,53076,fhi:git
county,Innlandet,2021-03-08,112,0,33538,19650,9.04957596133868,5.3021697072069,112,53188,fhi:git
county,Innlandet,2021-03-09,936,311,34474,19961,9.30213732754457,5.38608699875608,1247,54435,fhi:git
county,Innlandet,2021-03-10,2028,1306,36502,21267,9.84935362099066,5.73848565715874,3334,57769,fhi:git
county,Innlandet,2021-03-11,1014,968,37516,22235,10.1229617677137,5.99968159998705,1982,59751,fhi:git
county,Innlandet,2021-03-12,43,180,37559,22415,10.1345644800501,6.04825109348818,223,59974,fhi:git
county,Innlandet,2021-03-13,0,0,37559,22415,10.1345644800501,6.04825109348818,0,59974,fhi:git
county,Innlandet,2021-03-14,0,7,37559,22422,10.1345644800501,6.05013990712433,7,59981,fhi:git
county,Innlandet,2021-03-15,25,3,37584,22425,10.1413102430364,6.05094939868269,28,60009,fhi:git
county,Innlandet,2021-03-16,364,9,37948,22434,10.2395285521164,6.05337787335774,373,60382,fhi:git
county,Innlandet,2021-03-17,1803,153,39751,22587,10.7260329786861,6.09466194283371,1956,62338,fhi:git
county,Innlandet,2021-03-18,1650,105,41401,22692,11.1712533357798,6.12299414737603,1755,64093,fhi:git
county,Innlandet,2021-03-19,190,20,41591,22712,11.2225211344754,6.12839075776505,210,64303,fhi:git
county,Innlandet,2021-03-20,0,0,41591,22712,11.2225211344754,6.12839075776505,0,64303,fhi:git
county,Innlandet,2021-03-21,1,0,41592,22712,11.2227909649949,6.12839075776505,1,64304,fhi:git
county,Innlandet,2021-03-22,98,9,41690,22721,11.2492343559011,6.1308192324401,107,64411,fhi:git
county,Innlandet,2021-03-23,809,51,42499,22772,11.4675272461367,6.14458058893209,860,65271,fhi:git
county,Innlandet,2021-03-24,3238,522,45737,23294,12.3412384681182,6.28543212008537,3760,69031,fhi:git
county,Innlandet,2021-03-25,3199,321,48936,23615,13.2044262998411,6.37204771682906,3520,72551,fhi:git
county,Innlandet,2021-03-26,672,52,49608,23667,13.385752408912,6.3860789038405,724,73275,fhi:git
county,Innlandet,2021-03-27,0,0,49608,23667,13.385752408912,6.3860789038405,0,73275,fhi:git
county,Innlandet,2021-03-28,0,0,49608,23667,13.385752408912,6.3860789038405,0,73275,fhi:git
county,Innlandet,2021-03-29,397,2,50005,23669,13.4928751251339,6.3866185648794,399,73674,fhi:git
county,Innlandet,2021-03-30,2888,227,52893,23896,14.2721456653076,6.44787009279472,3115,76789,fhi:git
county,Innlandet,2021-03-31,2843,560,55736,24456,15.0392738321061,6.59897518368713,3403,80192,fhi:git
county,Innlandet,2021-04-01,88,18,55824,24474,15.0630189178177,6.60383213303724,106,80298,fhi:git
county,Innlandet,2021-04-02,6,1,55830,24475,15.0646379009344,6.60410196355669,7,80305,fhi:git
county,Innlandet,2021-04-03,0,6,55830,24481,15.0646379009344,6.6057209466734,6,80311,fhi:git
county,Innlandet,2021-04-04,0,0,55830,24481,15.0646379009344,6.6057209466734,0,80311,fhi:git
county,Innlandet,2021-04-05,0,0,55830,24481,15.0646379009344,6.6057209466734,0,80311,fhi:git
county,Innlandet,2021-04-06,508,31,56338,24512,15.2017118048154,6.61408569277637,539,80850,fhi:git
county,Innlandet,2021-04-07,4230,91,60568,24603,16.343094902092,6.63864027004638,4321,85171,fhi:git
county,Innlandet,2021-04-08,4364,90,64932,24693,17.520635288975,6.66292501679695,4454,89625,fhi:git
county,Møre og Romsdal,2020-12-27,0,0,0,0,0.0,0.0,0,0,fhi:git
county,Møre og Romsdal,2020-12-28,1,0,1,0,0.0003770198840286,0.0,1,1,fhi:git
county,Møre og Romsdal,2020-12-29,0,0,1,0,0.0003770198840286,0.0,0,1,fhi:git
county,Møre og Romsdal,2020-12-30,0,0,1,0,0.0003770198840286,0.0,0,1,fhi:git
county,Møre og Romsdal,2020-12-31,0,0,1,0,0.0003770198840286,0.0,0,1,fhi:git
county,Møre og Romsdal,2021-01-01,0,0,1,0,0.0003770198840286,0.0,0,1,fhi:git
county,Møre og Romsdal,2021-01-02,0,0,1,0,0.0003770198840286,0.0,0,1,fhi:git
county,Møre og Romsdal,2021-01-03,0,0,1,0,0.0003770198840286,0.0,0,1,fhi:git
county,Møre og Romsdal,2021-01-04,0,0,1,0,0.0003765854246377,0.0,0,1,fhi:git
county,Møre og Romsdal,2021-01-05,186,0,187,0,0.0704214744072545,0.0,186,187,fhi:git
county,Møre og Romsdal,2021-01-06,496,0,683,0,0.257207845027566,0.0,496,683,fhi:git
county,Møre og Romsdal,2021-01-07,457,0,1140,0,0.429307384087006,0.0,457,1140,fhi:git
county,Møre og Romsdal,2021-01-08,36,0,1176,0,0.442864459373964,0.0,36,1176,fhi:git
county,Møre og Romsdal,2021-01-09,1,0,1177,0,0.443241044798602,0.0,1,1177,fhi:git
county,Møre og Romsdal,2021-01-10,0,0,1177,0,0.443241044798602,0.0,0,1177,fhi:git
county,Møre og Romsdal,2021-01-11,1,0,1178,0,0.44361763022324,0.0,1,1178,fhi:git
county,Møre og Romsdal,2021-01-12,225,0,1403,0,0.528349350766728,0.0,225,1403,fhi:git
county,Møre og Romsdal,2021-01-13,387,0,1790,0,0.674087910101528,0.0,387,1790,fhi:git
county,Møre og Romsdal,2021-01-14,409,0,2199,0,0.828111348778357,0.0,409,2199,fhi:git
county,Møre og Romsdal,2021-01-15,150,0,2349,0,0.884599162474016,0.0,150,2349,fhi:git
county,Møre og Romsdal,2021-01-16,1,0,2350,0,0.884975747898653,0.0,1,2350,fhi:git
county,Møre og Romsdal,2021-01-17,2,0,2352,0,0.885728918747929,0.0,2,2352,fhi:git
county,Møre og Romsdal,2021-01-18,11,0,2363,0,0.889871358418944,0.0,11,2363,fhi:git
county,Møre og Romsdal,2021-01-19,203,0,2566,0,0.966318199620402,0.0,203,2566,fhi:git
county,Møre og Romsdal,2021-01-20,500,0,3066,0,1.15461091193926,0.0,500,3066,fhi:git
county,Møre og Romsdal,2021-01-21,800,0,3866,0,1.45587925164944,0.0,800,3866,fhi:git
county,Møre og Romsdal,2021-01-22,212,0,4078,0,1.53571536167264,0.0,212,4078,fhi:git
county,Møre og Romsdal,2021-01-23,0,0,4078,0,1.53571536167264,0.0,0,4078,fhi:git
county,Møre og Romsdal,2021-01-24,0,0,4078,0,1.53571536167264,0.0,0,4078,fhi:git
county,Møre og Romsdal,2021-01-25,3,0,4081,0,1.53684511794656,0.0,3,4081,fhi:git
county,Møre og Romsdal,2021-01-26,78,129,4159,129,1.5662187810683,0.0485795197782665,207,4288,fhi:git
county,Møre og Romsdal,2021-01-27,542,358,4701,487,1.77032808122194,0.183397101798572,900,5188,fhi:git
county,Møre og Romsdal,2021-01-28,492,509,5193,996,1.9556081101437,0.375079082939174,1001,6189,fhi:git
county,Møre og Romsdal,2021-01-29,99,78,5292,1074,1.99289006718284,0.404452746060916,177,6366,fhi:git
county,Møre og Romsdal,2021-01-30,0,1,5292,1075,1.99289006718284,0.404829331485554,1,6367,fhi:git
county,Møre og Romsdal,2021-01-31,0,0,5292,1075,1.99289006718284,0.404829331485554,0,6367,fhi:git
county,Møre og Romsdal,2021-02-01,0,0,5292,1075,1.99289006718284,0.404829331485554,0,6367,fhi:git
county,Møre og Romsdal,2021-02-02,291,193,5583,1268,2.10247642575242,0.477510318440635,484,6851,fhi:git
county,Møre og Romsdal,2021-02-03,1063,312,6646,1580,2.50278673214232,0.595004970927605,1375,8226,fhi:git
county,Møre og Romsdal,2021-02-04,1546,462,8192,2042,3.08498779863224,0.768987437110234,2008,10234,fhi:git
county,Møre og Romsdal,2021-02-05,219,154,8411,2196,3.1674600066279,0.826981592504444,373,10607,fhi:git
county,Møre og Romsdal,2021-02-06,1,2,8412,2198,3.16783659205254,0.827734763353719,3,10610,fhi:git
county,Møre og Romsdal,2021-02-07,0,1,8412,2199,3.16783659205254,0.828111348778357,1,10611,fhi:git
county,Møre og Romsdal,2021-02-08,1,2,8413,2201,3.16821317747718,0.828864519627632,3,10614,fhi:git
county,Møre og Romsdal,2021-02-09,327,183,8740,2384,3.29135661133372,0.897779652336336,510,11124,fhi:git
county,Møre og Romsdal,2021-02-10,1258,435,9998,2819,3.76510107552797,1.06159431205375,1693,12817,fhi:git
county,Møre og Romsdal,2021-02-11,1254,804,11252,3623,4.23733919802368,1.36436899346248,2058,14875,fhi:git
county,Møre og Romsdal,2021-02-12,295,207,11547,3830,4.34843189829181,1.44232217636249,502,15377,fhi:git
county,Møre og Romsdal,2021-02-13,24,0,11571,3830,4.35746994848311,1.44232217636249,24,15401,fhi:git
county,Møre og Romsdal,2021-02-14,0,0,11571,3830,4.35746994848311,1.44232217636249,0,15401,fhi:git
county,Møre og Romsdal,2021-02-15,1,8,11572,3838,4.35784653390775,1.44533485975959,9,15410,fhi:git
county,Møre og Romsdal,2021-02-16,354,58,11926,3896,4.49115777422951,1.46717681438858,412,15822,fhi:git
county,Møre og Romsdal,2021-02-17,1204,423,13130,4319,4.94456662549333,1.62647244901033,1627,17449,fhi:git
county,Møre og Romsdal,2021-02-18,1165,522,14295,4841,5.38328864519628,1.82305004067123,1687,19136,fhi:git
county,Møre og Romsdal,2021-02-19,499,94,14794,4935,5.5712047720905,1.85844907058717,593,19729,fhi:git
county,Møre og Romsdal,2021-02-20,11,0,14805,4935,5.57534721176152,1.85844907058717,11,19740,fhi:git
county,Møre og Romsdal,2021-02-21,0,0,14805,4935,5.57534721176152,1.85844907058717,0,19740,fhi:git
county,Møre og Romsdal,2021-02-22,15,0,14820,4935,5.58099599313108,1.85844907058717,15,19755,fhi:git
county,Møre og Romsdal,2021-02-23,393,223,15213,5158,5.72899406501371,1.94242762028138,616,20371,fhi:git
county,Møre og Romsdal,2021-02-24,730,876,15943,6034,6.00390142499925,2.27231645226403,1606,21977,fhi:git
county,Møre og Romsdal,2021-02-25,704,1476,16647,7510,6.26901756394421,2.82815653902931,2180,24157,fhi:git
county,Møre og Romsdal,2021-02-26,260,203,16907,7713,6.36692977435001,2.90460338023077,463,24620,fhi:git
county,Møre og Romsdal,2021-02-27,2,1,16909,7714,6.36768294519929,2.90497996565541,3,24623,fhi:git
county,Møre og Romsdal,2021-02-28,0,0,16909,7714,6.36768294519929,2.90497996565541,0,24623,fhi:git
county,Møre og Romsdal,2021-03-01,101,1,17010,7715,6.4057180730877,2.90535655108005,102,24725,fhi:git
county,Møre og Romsdal,2021-03-02,741,252,17751,7967,6.68476787274425,3.00025607808875,993,25718,fhi:git
county,Møre og Romsdal,2021-03-03,870,1116,18621,9083,7.01239719217907,3.42052541198446,1986,27704,fhi:git
county,Møre og Romsdal,2021-03-04,988,1308,19609,10391,7.38446359172115,3.9130991474106,2296,30000,fhi:git
county,Møre og Romsdal,2021-03-05,813,274,20422,10665,7.69062754195162,4.01628355376134,1087,31087,fhi:git
county,Møre og Romsdal,2021-03-06,3,6,20425,10671,7.69175729822553,4.01854306630916,9,31096,fhi:git
county,Møre og Romsdal,2021-03-07,0,0,20425,10671,7.69175729822553,4.01854306630916,0,31096,fhi:git
county,Møre og Romsdal,2021-03-08,157,0,20582,10671,7.75088120989365,4.01854306630916,157,31253,fhi:git
county,Møre og Romsdal,2021-03-09,670,238,21252,10909,8.00319344440093,4.10817039737294,908,32161,fhi:git
county,Møre og Romsdal,2021-03-10,1287,946,22539,11855,8.48785888590968,4.46442020908023,2233,34394,fhi:git
county,Møre og Romsdal,2021-03-11,540,973,23079,12828,8.69121501521405,4.83083782725273,1513,35907,fhi:git
county,Møre og Romsdal,2021-03-12,66,249,23145,13077,8.71606965324014,4.92460759798753,315,36222,fhi:git
county,Møre og Romsdal,2021-03-13,0,16,23145,13093,8.71606965324014,4.93063296478173,16,36238,fhi:git
county,Møre og Romsdal,2021-03-14,0,0,23145,13093,8.71606965324014,4.93063296478173,0,36238,fhi:git
county,Møre og Romsdal,2021-03-15,0,1,23145,13094,8.71606965324014,4.93100955020637,1,36239,fhi:git
county,Møre og Romsdal,2021-03-16,334,10,23479,13104,8.84184918506914,4.93477540445275,344,36583,fhi:git
county,Møre og Romsdal,2021-03-17,1536,129,25015,13233,9.42028439731269,4.98335492423101,1665,38248,fhi:git
county,Møre og Romsdal,2021-03-18,1485,60,26500,13293,9.97951375289971,5.00595004970928,1545,39793,fhi:git
county,Møre og Romsdal,2021-03-19,205,37,26705,13330,10.0567137649504,5.01988371042087,242,40035,fhi:git
county,Møre og Romsdal,2021-03-20,18,0,26723,13330,10.0634923025939,5.01988371042087,18,40053,fhi:git
county,Møre og Romsdal,2021-03-21,0,0,26723,13330,10.0634923025939,5.01988371042087,0,40053,fhi:git
county,Møre og Romsdal,2021-03-22,1,7,26724,13337,10.0638688880186,5.02251980839334,8,40061,fhi:git
county,Møre og Romsdal,2021-03-23,598,19,27322,13356,10.2890669719519,5.02967493146145,617,40678,fhi:git
county,Møre og Romsdal,2021-03-24,1808,48,29130,13404,10.9699334196969,5.04775103184406,1856,42534,fhi:git
county,Møre og Romsdal,2021-03-25,2317,70,31447,13474,11.8424818485825,5.07411201156871,2387,44921,fhi:git
county,Møre og Romsdal,2021-03-26,225,19,31672,13493,11.927213569126,5.08126713463682,244,45165,fhi:git
county,Møre og Romsdal,2021-03-27,25,1,31697,13494,11.936628204742,5.08164372006146,26,45191,fhi:git
county,Møre og Romsdal,2021-03-28,0,0,31697,13494,11.936628204742,5.08164372006146,0,45191,fhi:git
county,Møre og Romsdal,2021-03-29,7,5,31704,13499,11.9392643027144,5.08352664718465,12,45203,fhi:git
county,Møre og Romsdal,2021-03-30,2223,94,33927,13593,12.7764137016841,5.11892567710059,2317,47520,fhi:git
county,Møre og Romsdal,2021-03-31,1938,208,35865,13801,13.506236254632,5.19725544542524,2146,49666,fhi:git
county,Møre og Romsdal,2021-04-01,99,26,35964,13827,13.5435182116711,5.20704666646582,125,49791,fhi:git
county,Møre og Romsdal,2021-04-02,19,1,35983,13828,13.5506733347393,5.20742325189046,20,49811,fhi:git
county,Møre og Romsdal,2021-04-03,14,0,35997,13828,13.5559455306842,5.20742325189046,14,49825,fhi:git
county,Møre og Romsdal,2021-04-04,0,0,35997,13828,13.5559455306842,5.20742325189046,0,49825,fhi:git
county,Møre og Romsdal,2021-04-05,0,0,35997,13828,13.5559455306842,5.20742325189046,0,49825,fhi:git
county,Møre og Romsdal,2021-04-06,821,42,36818,13870,13.8651221643118,5.22323983972524,863,50688,fhi:git
county,Møre og Romsdal,2021-04-07,2436,34,39254,13904,14.7824842587293,5.23604374416293,2470,53158,fhi:git
county,Møre og Romsdal,2021-04-08,2607,70,41861,13974,15.7642424607598,5.26240472388757,2677,55835,fhi:git
county,Nordland,2020-12-27,0,0,0,0,0.0,0.0,0,0,fhi:git
county,Nordland,2020-12-28,0,0,0,0,0.0,0.0,0,0,fhi:git
county,Nordland,2020-12-29,0,0,0,0,0.0,0.0,0,0,fhi:git
county,Nordland,2020-12-30,1,0,1,0,0.0004145335461272,0.0,1,1,fhi:git
county,Nordland,2020-12-31,0,0,1,0,0.0004145335461272,0.0,0,1,fhi:git
county,Nordland,2021-01-01,0,0,1,0,0.0004145335461272,0.0,0,1,fhi:git
county,Nordland,2021-01-02,0,0,1,0,0.0004145335461272,0.0,0,1,fhi:git
county,Nordland,2021-01-03,0,0,1,0,0.0004145335461272,0.0,0,1,fhi:git
county,Nordland,2021-01-04,0,0,1,0,0.0004160685681,0.0,0,1,fhi:git
county,Nordland,2021-01-05,200,0,201,0,0.0836297821881046,0.0,200,201,fhi:git
county,Nordland,2021-01-06,686,0,887,0,0.36905281990472,0.0,686,887,fhi:git
county,Nordland,2021-01-07,238,0,1125,0,0.468077139112526,0.0,238,1125,fhi:git
county,Nordland,2021-01-08,114,0,1239,0,0.515508955875928,0.0,114,1239,fhi:git
county,Nordland,2021-01-09,0,0,1239,0,0.515508955875928,0.0,0,1239,fhi:git
county,Nordland,2021-01-10,0,0,1239,0,0.515508955875928,0.0,0,1239,fhi:git
county,Nordland,2021-01-11,0,0,1239,0,0.515508955875928,0.0,0,1239,fhi:git
county,Nordland,2021-01-12,292,0,1531,0,0.637000977761135,0.0,292,1531,fhi:git
county,Nordland,2021-01-13,626,0,2157,0,0.897459901391749,0.0,626,2157,fhi:git
county,Nordland,2021-01-14,271,0,2428,0,1.01021448334686,0.0,271,2428,fhi:git
county,Nordland,2021-01-15,69,0,2497,0,1.03892321454576,0.0,69,2497,fhi:git
county,Nordland,2021-01-16,0,0,2497,0,1.03892321454576,0.0,0,2497,fhi:git
county,Nordland,2021-01-17,1,0,2498,0,1.03933928311386,0.0,1,2498,fhi:git
county,Nordland,2021-01-18,0,0,2498,0,1.03933928311386,0.0,0,2498,fhi:git
county,Nordland,2021-01-19,313,0,2811,0,1.16956874492916,0.0,313,2811,fhi:git
county,Nordland,2021-01-20,786,0,3597,0,1.49659863945578,0.0,786,3597,fhi:git
county,Nordland,2021-01-21,617,0,4214,0,1.7533129459735,0.0,617,4214,fhi:git
county,Nordland,2021-01-22,173,0,4387,0,1.8252928082548,0.0,173,4387,fhi:git
county,Nordland,2021-01-23,4,0,4391,0,1.8269570825272,0.0,4,4391,fhi:git
county,Nordland,2021-01-24,0,0,4391,0,1.8269570825272,0.0,0,4391,fhi:git
county,Nordland,2021-01-25,51,0,4442,0,1.8481765795003,0.0,51,4442,fhi:git
county,Nordland,2021-01-26,119,90,4561,90,1.8976887391042,0.0374461711290021,209,4651,fhi:git
county,Nordland,2021-01-27,626,528,5187,618,2.15814766273482,0.257130375085814,1154,5805,fhi:git
county,Nordland,2021-01-28,471,365,5658,983,2.35411595830993,0.408995402442323,836,6641,fhi:git
county,Nordland,2021-01-29,212,144,5870,1127,2.44232249474713,0.468909276248726,356,6997,fhi:git
county,Nordland,2021-01-30,1,0,5871,1127,2.44273856331523,0.468909276248726,1,6998,fhi:git
county,Nordland,2021-01-31,0,0,5871,1127,2.44273856331523,0.468909276248726,0,6998,fhi:git
county,Nordland,2021-02-01,9,4,5880,1131,2.44648318042813,0.470573550521126,13,7011,fhi:git
county,Nordland,2021-02-02,111,200,5991,1331,2.49266679148724,0.553787264141131,311,7322,fhi:git
county,Nordland,2021-02-03,1431,455,7422,1786,3.08806091243837,0.743098462626641,1886,9208,fhi:git
county,Nordland,2021-02-04,1682,347,9104,2133,3.78788824398261,0.887474255757349,2029,11237,fhi:git
county,Nordland,2021-02-05,329,154,9433,2287,3.92477480288752,0.951548815244752,483,11720,fhi:git
county,Nordland,2021-02-06,0,0,9433,2287,3.92477480288752,0.951548815244752,0,11720,fhi:git
county,Nordland,2021-02-07,1,0,9434,2287,3.92519087145562,0.951548815244752,1,11721,fhi:git
county,Nordland,2021-02-08,7,1,9441,2288,3.92810335143232,0.951964883812852,8,11729,fhi:git
county,Nordland,2021-02-09,70,262,9511,2550,3.95722815119932,1.06097484865506,332,12061,fhi:git
county,Nordland,2021-02-10,2031,633,11542,3183,4.80226341301046,1.32434625226237,2664,14725,fhi:git
county,Nordland,2021-02-11,1222,585,12764,3768,5.31069920322869,1.56774636460089,1807,16532,fhi:git
county,Nordland,2021-02-12,286,238,13050,4006,5.4296948137053,1.66677068380869,524,17056,fhi:git
county,Nordland,2021-02-13,53,3,13103,4009,5.4517464478146,1.66801888951299,56,17112,fhi:git
county,Nordland,2021-02-14,0,0,13103,4009,5.4517464478146,1.66801888951299,0,17112,fhi:git
county,Nordland,2021-02-15,0,1,13103,4010,5.4517464478146,1.66843495808109,1,17113,fhi:git
county,Nordland,2021-02-16,223,71,13326,4081,5.54452973850091,1.69797582641619,294,17407,fhi:git
county,Nordland,2021-02-17,1491,515,14817,4596,6.16488797353804,1.91225113898771,2006,19413,fhi:git
county,Nordland,2021-02-18,849,607,15666,5203,6.51813018785496,2.16480475982442,1456,20869,fhi:git
county,Nordland,2021-02-19,306,231,15972,5434,6.64544716969357,2.26091659905552,537,21406,fhi:git
county,Nordland,2021-02-20,1,1,15973,5435,6.64586323826167,2.26133266762362,2,21408,fhi:git
county,Nordland,2021-02-21,0,0,15973,5435,6.64586323826167,2.26133266762362,0,21408,fhi:git
county,Nordland,2021-02-22,270,0,16243,5435,6.75820175164867,2.26133266762362,270,21678,fhi:git
county,Nordland,2021-02-23,308,56,16551,5491,6.88635087062348,2.28463250743723,364,22042,fhi:git
county,Nordland,2021-02-24,974,1008,17525,6499,7.2916016559529,2.70402962408205,1982,24024,fhi:git
county,Nordland,2021-02-25,592,1871,18117,8370,7.53791424826811,3.48249391499719,2463,26487,fhi:git
county,Nordland,2021-02-26,423,397,18540,8767,7.71391125257443,3.6476731365329,820,27307,fhi:git
county,Nordland,2021-02-27,1,4,18541,8771,7.71432732114252,3.6493374108053,5,27312,fhi:git
county,Nordland,2021-02-28,0,1,18541,8772,7.71432732114252,3.6497534793734,1,27313,fhi:git
county,Nordland,2021-03-01,240,0,18781,8772,7.81418377748653,3.6497534793734,240,27553,fhi:git
county,Nordland,2021-03-02,517,50,19298,8822,8.02929122719424,3.6705569077784,567,28120,fhi:git
county,Nordland,2021-03-03,621,1585,19919,10407,8.28766980798436,4.33002558821694,2206,30326,fhi:git
county,Nordland,2021-03-04,720,1366,20639,11773,8.58723917701637,4.89837525224157,2086,32412,fhi:git
county,Nordland,2021-03-05,440,340,21079,12113,8.77030934698038,5.03983856539558,780,33192,fhi:git
county,Nordland,2021-03-06,13,51,21092,12164,8.77571823836568,5.06105806236868,64,33256,fhi:git
county,Nordland,2021-03-07,0,0,21092,12164,8.77571823836568,5.06105806236868,0,33256,fhi:git
county,Nordland,2021-03-08,360,0,21452,12164,8.92550292288169,5.06105806236868,360,33616,fhi:git
county,Nordland,2021-03-09,652,51,22104,12215,9.19677962928291,5.08227755934178,703,34319,fhi:git
county,Nordland,2021-03-10,1209,1187,23313,13402,9.69980652811583,5.57615094967651,2396,36715,fhi:git
county,Nordland,2021-03-11,730,989,24043,14391,10.0035365828289,5.98764276352743,1719,38434,fhi:git
county,Nordland,2021-03-12,71,252,24114,14643,10.033077451164,6.09249204268864,323,38757,fhi:git
county,Nordland,2021-03-13,3,2,24117,14645,10.0343256568683,6.09332417982484,5,38762,fhi:git
county,Nordland,2021-03-14,0,0,24117,14645,10.0343256568683,6.09332417982484,0,38762,fhi:git
county,Nordland,2021-03-15,0,1,24117,14646,10.0343256568683,6.09374024839294,1,38763,fhi:git
county,Nordland,2021-03-16,118,5,24235,14651,10.0834217479041,6.09582059123344,123,38886,fhi:git
county,Nordland,2021-03-17,902,64,25137,14715,10.4587155963303,6.12244897959184,966,39852,fhi:git
county,Nordland,2021-03-18,1162,73,26299,14788,10.9421872724625,6.15282198506314,1235,41087,fhi:git
county,Nordland,2021-03-19,226,28,26525,14816,11.0362187688531,6.16447190496994,254,41341,fhi:git
county,Nordland,2021-03-20,39,0,26564,14816,11.052445443009,6.16447190496994,39,41380,fhi:git
county,Nordland,2021-03-21,0,0,26564,14816,11.052445443009,6.16447190496994,0,41380,fhi:git
county,Nordland,2021-03-22,36,1,26600,14817,11.0674239114606,6.16488797353804,37,41417,fhi:git
county,Nordland,2021-03-23,560,8,27160,14825,11.3004223095966,6.16821652208284,568,41985,fhi:git
county,Nordland,2021-03-24,2162,48,29322,14873,12.1999625538289,6.18818781335164,2210,44195,fhi:git
county,Nordland,2021-03-25,1586,64,30908,14937,12.8598473028355,6.21481620171004,1650,45845,fhi:git
county,Nordland,2021-03-26,342,12,31250,14949,13.0021427531257,6.21980902452724,354,46199,fhi:git
county,Nordland,2021-03-27,0,0,31250,14949,13.0021427531257,6.21980902452724,0,46199,fhi:git
county,Nordland,2021-03-28,0,0,31250,14949,13.0021427531257,6.21980902452724,0,46199,fhi:git
county,Nordland,2021-03-29,9,1,31259,14950,13.0058873702386,6.22022509309534,10,46209,fhi:git
county,Nordland,2021-03-30,1537,113,32796,15063,13.6453847594084,6.26724084129064,1650,47859,fhi:git
county,Nordland,2021-03-31,1163,310,33959,15373,14.1292725041087,6.39622209740165,1473,49332,fhi:git
county,Nordland,2021-04-01,227,164,34186,15537,14.2237200690674,6.46445734257006,391,49723,fhi:git
county,Nordland,2021-04-02,99,10,34285,15547,14.2649108573093,6.46861802825106,109,49832,fhi:git
county,Nordland,2021-04-03,0,0,34285,15547,14.2649108573093,6.46861802825106,0,49832,fhi:git
county,Nordland,2021-04-04,0,0,34285,15547,14.2649108573093,6.46861802825106,0,49832,fhi:git
county,Nordland,2021-04-05,0,0,34285,15547,14.2649108573093,6.46861802825106,0,49832,fhi:git
county,Nordland,2021-04-06,468,13,34753,15560,14.4596309471801,6.47402691963636,481,50313,fhi:git
county,Nordland,2021-04-07,3279,79,38032,15639,15.8239197819801,6.50689633651626,3358,53671,fhi:git
county,Nordland,2021-04-08,2141,420,40173,16059,16.7147225862822,6.68164513511827,2561,56232,fhi:git
county,Oslo,2020-12-27,5,0,5,0,0.0007209867713347,0.0,5,5,fhi:git
county,Oslo,2020-12-28,264,0,269,0,0.0387890882978079,0.0,264,269,fhi:git
county,Oslo,2020-12-29,118,0,387,0,0.0558043761013073,0.0,118,387,fhi:git
county,Oslo,2020-12-30,58,0,445,0,0.06416782264879,0.0,58,445,fhi:git
county,Oslo,2020-12-31,5,0,450,0,0.0648888094201248,0.0,5,450,fhi:git
county,Oslo,2021-01-01,6,0,456,0,0.0657539935457264,0.0,6,456,fhi:git
county,Oslo,2021-01-02,0,0,456,0,0.0657539935457264,0.0,0,456,fhi:git
county,Oslo,2021-01-03,0,0,456,0,0.0657539935457264,0.0,0,456,fhi:git
county,Oslo,2021-01-04,0,0,456,0,0.065422303840691,0.0,0,456,fhi:git
county,Oslo,2021-01-05,479,0,935,0,0.134144416866329,0.0,479,935,fhi:git
county,Oslo,2021-01-06,603,0,1538,0,0.220656805497769,0.0,603,1538,fhi:git
county,Oslo,2021-01-07,966,0,2504,0,0.359248791265549,0.0,966,2504,fhi:git
county,Oslo,2021-01-08,450,0,2954,0,0.423810275318862,0.0,450,2954,fhi:git
county,Oslo,2021-01-09,127,0,3081,0,0.442030960818353,0.0,127,3081,fhi:git
county,Oslo,2021-01-10,100,0,3181,0,0.456377957274645,0.0,100,3181,fhi:git
county,Oslo,2021-01-11,78,0,3259,0,0.467568614510552,0.0,78,3259,fhi:git
county,Oslo,2021-01-12,241,0,3500,0,0.502144875970216,0.0,241,3500,fhi:git
county,Oslo,2021-01-13,489,0,3989,0,0.572301688641483,0.0,489,3989,fhi:git
county,Oslo,2021-01-14,1237,0,5226,0,0.749774034805813,0.0,1237,5226,fhi:git
county,Oslo,2021-01-15,1636,0,6862,0,0.984490896830748,0.0,1636,6862,fhi:git
county,Oslo,2021-01-16,643,0,7505,0,1.07674208404471,0.0,643,7505,fhi:git
county,Oslo,2021-01-17,276,5,7781,5,1.11633979426407,0.0007173498228145,281,7786,fhi:git
county,Oslo,2021-01-18,759,231,8540,236,1.22523349736733,0.0338589116368488,990,8776,fhi:git
county,Oslo,2021-01-19,810,70,9350,306,1.34144416866329,0.0439018091562531,880,9656,fhi:git
county,Oslo,2021-01-20,993,99,10343,405,1.48390984347427,0.0581053356479821,1092,10748,fhi:git
county,Oslo,2021-01-21,1021,21,11364,426,1.63039267729301,0.0611182049038034,1042,11790,fhi:git
county,Oslo,2021-01-22,670,6,12034,432,1.72651755355016,0.0619790246911809,676,12466,fhi:git
county,Oslo,2021-01-23,232,0,12266,432,1.75980258532876,0.0619790246911809,232,12698,fhi:git
county,Oslo,2021-01-24,67,0,12333,432,1.76941507295448,0.0619790246911809,67,12765,fhi:git
county,Oslo,2021-01-25,258,0,12591,432,1.80643032381171,0.0619790246911809,258,13023,fhi:git
county,Oslo,2021-01-26,312,404,12903,836,1.85119295275534,0.1199408903746,716,13739,fhi:git
county,Oslo,2021-01-27,1035,528,13938,1364,1.99968436607796,0.195693031663821,1563,15302,fhi:git
county,Oslo,2021-01-28,871,842,14809,2206,2.12464670521226,0.316494741825799,1713,17015,fhi:git
county,Oslo,2021-01-29,428,504,15237,2710,2.18605185004519,0.38880360396551,932,17947,fhi:git
county,Oslo,2021-01-30,94,152,15331,2862,2.19953802671411,0.410611038579073,246,18193,fhi:git
county,Oslo,2021-01-31,61,45,15392,2907,2.20828969455245,0.417067186984405,106,18299,fhi:git
county,Oslo,2021-02-01,53,48,15445,2955,2.21589360267428,0.423953745283425,101,18400,fhi:git
county,Oslo,2021-02-02,1521,151,16966,3106,2.43411141877448,0.445617709932426,1672,20072,fhi:git
county,Oslo,2021-02-03,2457,456,19423,3562,2.78661712170557,0.511040013773117,2913,22985,fhi:git
county,Oslo,2021-02-04,2049,1234,21472,4796,3.08058707909499,0.688081950043758,3283,26268,fhi:git
county,Oslo,2021-02-05,1383,1568,22855,6364,3.27900604008551,0.913042854478415,2951,29219,fhi:git
county,Oslo,2021-02-06,243,631,23098,6995,3.3138692414743,1.00357240211762,874,30093,fhi:git
county,Oslo,2021-02-07,214,270,23312,7265,3.34457181389076,1.0423092925496,484,30577,fhi:git
county,Oslo,2021-02-08,49,443,23361,7708,3.35160184215435,1.10586648685098,492,31069,fhi:git
county,Oslo,2021-02-09,1163,245,24524,7953,3.51845741094102,1.14101662816889,1408,32477,fhi:git
county,Oslo,2021-02-10,1830,814,26354,8767,3.78100744609116,1.25780117932311,2644,35121,fhi:git
county,Oslo,2021-02-11,1583,744,27937,9511,4.00812039999426,1.36454283295792,2327,37448,fhi:git
county,Oslo,2021-02-12,1358,425,29295,9936,4.20295261187071,1.42551756789716,1783,39231,fhi:git
county,Oslo,2021-02-13,273,193,29568,10129,4.24211991219638,1.4532072710578,466,39697,fhi:git
county,Oslo,2021-02-14,103,0,29671,10129,4.25689731854636,1.4532072710578,103,39800,fhi:git
county,Oslo,2021-02-15,260,444,29931,10573,4.29419950933272,1.51690793532374,704,40504,fhi:git
county,Oslo,2021-02-16,723,771,30654,11344,4.39792829371171,1.62752327800175,1494,41998,fhi:git
county,Oslo,2021-02-17,1460,1082,32114,12426,4.60739444197357,1.78275777965883,2542,44540,fhi:git
county,Oslo,2021-02-18,1070,919,33184,13345,4.7609073040559,1.91460667709215,1989,46529,fhi:git
county,Oslo,2021-02-19,1494,971,34678,14316,4.9752514311129,2.05391601268274,2465,48994,fhi:git
county,Oslo,2021-02-20,100,114,34778,14430,4.98959842756919,2.07027158864292,214,49208,fhi:git
county,Oslo,2021-02-21,4,61,34782,14491,4.99017230742744,2.07902325648126,65,49273,fhi:git
county,Oslo,2021-02-22,601,112,35383,14603,5.07639775612975,2.0950918925123,713,49986,fhi:git
county,Oslo,2021-02-23,339,1526,35722,16129,5.12503407411658,2.31402705843532,1865,51851,fhi:git
county,Oslo,2021-02-24,690,2349,36412,18478,5.224028349665,2.65103800519361,3039,54890,fhi:git
county,Oslo,2021-02-25,600,1977,37012,20455,5.31011032840275,2.9346781251345,2577,57467,fhi:git
county,Oslo,2021-02-26,767,1373,37779,21828,5.42015179122251,3.13166238647939,2140,59607,fhi:git
county,Oslo,2021-02-27,259,103,38038,21931,5.4573105120443,3.14643979282937,362,59969,fhi:git
county,Oslo,2021-02-28,101,62,38139,21993,5.47180097846516,3.15533493063227,163,60132,fhi:git
county,Oslo,2021-03-01,1043,39,39182,22032,5.62144015150428,3.16093025925023,1082,61214,fhi:git
county,Oslo,2021-03-02,773,136,39955,22168,5.73234243411142,3.18044217443078,909,62123,fhi:git
county,Oslo,2021-03-03,1353,172,41308,22340,5.92645729616505,3.20511900833561,1525,63648,fhi:git
county,Oslo,2021-03-04,1181,203,42489,22543,6.09589532431386,3.23424341114188,1384,65032,fhi:git
county,Oslo,2021-03-05,1304,68,43793,22611,6.2829801581039,3.24399936873216,1372,66404,fhi:git
county,Oslo,2021-03-06,102,3,43895,22614,6.29761409448932,3.24442977862584,105,66509,fhi:git
county,Oslo,2021-03-07,69,0,43964,22614,6.30751352204416,3.24442977862584,69,66578,fhi:git
county,Oslo,2021-03-08,667,10,44631,22624,6.40320798840763,3.24586447827147,677,67255,fhi:git
county,Oslo,2021-03-09,775,1326,45406,23950,6.51439721094389,3.4361056512819,2101,69356,fhi:git
county,Oslo,2021-03-10,1189,2390,46595,26340,6.6849829988092,3.77899886658728,3579,72935,fhi:git
county,Oslo,2021-03-11,877,2371,47472,28711,6.81080615773088,4.11916615256596,3248,76183,fhi:git
county,Oslo,2021-03-12,278,1635,47750,30346,6.85069080787937,4.35373954462633,1913,78096,fhi:git
county,Oslo,2021-03-13,15,267,47765,30613,6.85284285734781,4.39204602516463,282,78378,fhi:git
county,Oslo,2021-03-14,1,97,47766,30710,6.85298632731238,4.40596261172724,98,78476,fhi:git
county,Oslo,2021-03-15,24,358,47790,31068,6.85642960646189,4.45732485904076,382,78858,fhi:git
county,Oslo,2021-03-16,1007,119,48797,31187,7.00090386077675,4.47439778482375,1126,79984,fhi:git
county,Oslo,2021-03-17,2734,93,51531,31280,7.39315074389177,4.4877404915281,2827,82811,fhi:git
county,Oslo,2021-03-18,2024,112,53555,31392,7.68353395216711,4.50380912755915,2136,84947,fhi:git
county,Oslo,2021-03-19,1995,186,55550,31578,7.96975653147014,4.53049454096785,2181,87128,fhi:git
county,Oslo,2021-03-20,394,18,55944,31596,8.02628369750793,4.53307700032998,412,87540,fhi:git
county,Oslo,2021-03-21,162,14,56106,31610,8.04952583176712,4.53508557983386,176,87716,fhi:git
county,Oslo,2021-03-22,935,11,57041,31621,8.18367024863345,4.53666374944405,946,88662,fhi:git
county,Oslo,2021-03-23,3317,104,60358,31725,8.65956012108865,4.5515846257586,3421,92083,fhi:git
county,Oslo,2021-03-24,5123,213,65481,31938,9.39455674954448,4.5821437282105,5336,97419,fhi:git
county,Oslo,2021-03-25,5128,48,70609,31986,10.1302707278231,4.58903028650952,5176,102595,fhi:git
county,Oslo,2021-03-26,4157,84,74766,32070,10.7266753705112,4.6010817635328,4241,106836,fhi:git
county,Oslo,2021-03-27,559,1,75325,32071,10.8068750807019,4.60122523349737,560,107396,fhi:git
county,Oslo,2021-03-28,150,0,75475,32071,10.8283955753863,4.60122523349737,150,107546,fhi:git
county,Oslo,2021-03-29,2181,9,77656,32080,11.141303568098,4.60251646317843,2190,109736,fhi:git
county,Oslo,2021-03-30,4356,211,82012,32291,11.7662587337341,4.63278862570121,4567,114303,fhi:git
county,Oslo,2021-03-31,4217,707,86229,32998,12.3712715742959,4.73422189064719,4924,119227,fhi:git
county,Oslo,2021-04-01,2800,292,89029,33290,12.7729874750721,4.77611512029957,3092,122319,fhi:git
county,Oslo,2021-04-02,1663,166,90692,33456,13.0115780261402,4.79993113441701,1829,124148,fhi:git
county,Oslo,2021-04-03,229,0,90921,33456,13.0444326480251,4.79993113441701,229,124377,fhi:git
county,Oslo,2021-04-04,374,36,91295,33492,13.0980904147717,4.80509605314128,410,124787,fhi:git
county,Oslo,2021-04-05,1253,53,92548,33545,13.277858280369,4.81269996126311,1306,126093,fhi:git
county,Oslo,2021-04-06,4463,104,97011,33649,13.9181647322133,4.82762083757765,4567,130660,fhi:git
county,Oslo,2021-04-07,6136,160,103147,33809,14.7984964347714,4.85057603190772,6296,136956,fhi:git
county,Oslo,2021-04-08,5849,138,108996,33947,15.6376522574999,4.8703748870174,5987,142943,fhi:git
county,Rogaland,2020-12-27,0,0,0,0,0.0,0.0,0,0,fhi:git
county,Rogaland,2020-12-28,1,0,1,0,0.0002083802188825,0.0,1,1,fhi:git
county,Rogaland,2020-12-29,0,0,1,0,0.0002083802188825,0.0,0,1,fhi:git
county,Rogaland,2020-12-30,0,0,1,0,0.0002083802188825,0.0,0,1,fhi:git
county,Rogaland,2020-12-31,0,0,1,0,0.0002083802188825,0.0,0,1,fhi:git
county,Rogaland,2021-01-01,0,0,1,0,0.0002083802188825,0.0,0,1,fhi:git
county,Rogaland,2021-01-02,0,0,1,0,0.0002083802188825,0.0,0,1,fhi:git
county,Rogaland,2021-01-03,0,0,1,0,0.0002083802188825,0.0,0,1,fhi:git
county,Rogaland,2021-01-04,0,0,1,0,0.0002071916211708,0.0,0,1,fhi:git
county,Rogaland,2021-01-05,548,0,549,0,0.113748200022791,0.0,548,549,fhi:git
county,Rogaland,2021-01-06,641,0,1190,0,0.246558029193299,0.0,641,1190,fhi:git
county,Rogaland,2021-01-07,212,0,1402,0,0.290482652881517,0.0,212,1402,fhi:git
county,Rogaland,2021-01-08,20,0,1422,0,0.294626485304934,0.0,20,1422,fhi:git
county,Rogaland,2021-01-09,1,0,1423,0,0.294833676926105,0.0,1,1423,fhi:git
county,Rogaland,2021-01-10,0,0,1423,0,0.294833676926105,0.0,0,1423,fhi:git
county,Rogaland,2021-01-11,3,0,1426,0,0.295455251789618,0.0,3,1426,fhi:git
county,Rogaland,2021-01-12,117,0,1543,0,0.319696671466606,0.0,117,1543,fhi:git
county,Rogaland,2021-01-13,761,0,2304,0,0.477369495177615,0.0,761,2304,fhi:git
county,Rogaland,2021-01-14,535,0,2839,0,0.588217012504014,0.0,535,2839,fhi:git
county,Rogaland,2021-01-15,291,0,3130,0,0.648509774264729,0.0,291,3130,fhi:git
county,Rogaland,2021-01-16,0,0,3130,0,0.648509774264729,0.0,0,3130,fhi:git
county,Rogaland,2021-01-17,2,0,3132,0,0.648924157507071,0.0,2,3132,fhi:git
county,Rogaland,2021-01-18,71,0,3203,0,0.6636347626102,0.0,71,3203,fhi:git
county,Rogaland,2021-01-19,513,0,3716,0,0.769924064270841,0.0,513,3716,fhi:git
county,Rogaland,2021-01-20,656,0,4372,0,0.905841767758912,0.0,656,4372,fhi:git
county,Rogaland,2021-01-21,431,0,4803,0,0.995141356483544,0.0,431,4803,fhi:git
county,Rogaland,2021-01-22,272,0,5075,0,1.05149747744201,0.0,272,5075,fhi:git
county,Rogaland,2021-01-23,0,0,5075,0,1.05149747744201,0.0,0,5075,fhi:git
county,Rogaland,2021-01-24,0,0,5075,0,1.05149747744201,0.0,0,5075,fhi:git
county,Rogaland,2021-01-25,150,0,5225,0,1.08257622061764,0.0,150,5225,fhi:git
county,Rogaland,2021-01-26,339,381,5564,381,1.15281418019455,0.07894000766609,720,5945,fhi:git
county,Rogaland,2021-01-27,865,603,6429,984,1.33203493250733,0.203876555232106,1468,7413,fhi:git
county,Rogaland,2021-01-28,524,283,6953,1267,1.44060334200085,0.262511784023454,807,8220,fhi:git
county,Rogaland,2021-01-29,410,22,7363,1289,1.52555190668089,0.267069999689213,432,8652,fhi:git
county,Rogaland,2021-01-30,4,1,7367,1290,1.52638067316558,0.267277191310383,5,8657,fhi:git
county,Rogaland,2021-01-31,2,0,7369,1290,1.52679505640792,0.267277191310383,2,8659,fhi:git
county,Rogaland,2021-02-01,13,6,7382,1296,1.52948854748314,0.268520341037408,19,8678,fhi:git
county,Rogaland,2021-02-02,450,77,7832,1373,1.62272477701002,0.284474095867563,527,9205,fhi:git
county,Rogaland,2021-02-03,2431,635,10263,2008,2.12640760807633,0.416040775311046,3066,12271,fhi:git
county,Rogaland,2021-02-04,1887,550,12150,2558,2.5173781972257,0.529996166955008,2437,14708,fhi:git
county,Rogaland,2021-02-05,656,281,12806,2839,2.65329590071378,0.588217012504014,937,15645,fhi:git
county,Rogaland,2021-02-06,0,0,12806,2839,2.65329590071378,0.588217012504014,0,15645,fhi:git
county,Rogaland,2021-02-07,0,1,12806,2840,2.65329590071378,0.588424204125185,1,15646,fhi:git
county,Rogaland,2021-02-08,7,71,12813,2911,2.65474624206197,0.603134809228315,78,15724,fhi:git
county,Rogaland,2021-02-09,588,395,13401,3306,2.77657491531043,0.684975499590797,983,16707,fhi:git
county,Rogaland,2021-02-10,1923,683,15324,3989,3.17500440282195,0.82648737685048,2606,19313,fhi:git
county,Rogaland,2021-02-11,1181,497,16505,4486,3.41969770742471,0.929461612572388,1678,20991,fhi:git
county,Rogaland,2021-02-12,482,268,16987,4754,3.51956406882906,0.984988967046173,750,21741,fhi:git
county,Rogaland,2021-02-13,1,0,16988,4754,3.51977126045023,0.984988967046173,1,21742,fhi:git
county,Rogaland,2021-02-14,0,0,16988,4754,3.51977126045023,0.984988967046173,0,21742,fhi:git
county,Rogaland,2021-02-15,0,147,16988,4901,3.51977126045023,1.01544613535829,147,21889,fhi:git
county,Rogaland,2021-02-16,480,315,17468,5216,3.61922323861223,1.0807114960271,795,22684,fhi:git
county,Rogaland,2021-02-17,1488,783,18956,5999,3.92752437091444,1.24294253540387,2271,24955,fhi:git
county,Rogaland,2021-02-18,1101,472,20057,6471,4.15564234582353,1.3407369805965,1573,26528,fhi:git
county,Rogaland,2021-02-19,442,411,20499,6882,4.24722104238105,1.42589273689772,853,27381,fhi:git
county,Rogaland,2021-02-20,1,2,20500,6884,4.24742823400222,1.42630712014006,3,27384,fhi:git
county,Rogaland,2021-02-21,0,2,20500,6886,4.24742823400222,1.4267215033824,2,27386,fhi:git
county,Rogaland,2021-02-22,252,13,20752,6899,4.29964052253727,1.42941499445762,265,27651,fhi:git
county,Rogaland,2021-02-23,379,407,21131,7306,4.37816614696102,1.51374198427416,786,28437,fhi:git
county,Rogaland,2021-02-24,821,2168,21952,9474,4.54827046794228,1.96293341897254,2989,31426,fhi:git
county,Rogaland,2021-02-25,1229,1812,23181,11286,4.80290897036124,2.3383646365341,3041,34467,fhi:git
county,Rogaland,2021-02-26,999,674,24180,11960,5.00989339991091,2.47801178920324,1673,36140,fhi:git
county,Rogaland,2021-02-27,1,1,24181,11961,5.01010059153208,2.47821898082442,2,36142,fhi:git
county,Rogaland,2021-02-28,4,0,24185,11961,5.01092935801676,2.47821898082442,4,36146,fhi:git
county,Rogaland,2021-03-01,648,2,24833,11963,5.14518952853547,2.47863336406676,650,36796,fhi:git
county,Rogaland,2021-03-02,794,545,25627,12508,5.30969967574511,2.59155279760487,1339,38135,fhi:git
county,Rogaland,2021-03-03,1269,1460,26896,13968,5.57262584301091,2.89405256451429,2729,40864,fhi:git
county,Rogaland,2021-03-04,1089,1478,27985,15446,5.79825751846595,3.20028178060479,2567,43431,fhi:git
county,Rogaland,2021-03-05,590,424,28575,15870,5.92050057495675,3.28813102798123,1014,44445,fhi:git
county,Rogaland,2021-03-06,4,1,28579,15871,5.92132934144143,3.2883382196024,5,44450,fhi:git
county,Rogaland,2021-03-07,0,0,28579,15871,5.92132934144143,3.2883382196024,0,44450,fhi:git
county,Rogaland,2021-03-08,542,0,29121,15871,6.03362720011603,3.2883382196024,542,44992,fhi:git
county,Rogaland,2021-03-09,1567,466,30688,16337,6.35829647049073,3.38488951506801,2033,47025,fhi:git
county,Rogaland,2021-03-10,2133,1079,32821,17416,6.80023619844813,3.60844927431135,3212,50237,fhi:git
county,Rogaland,2021-03-11,1400,1057,34221,18473,7.09030446808731,3.82745081788892,2457,52694,fhi:git
county,Rogaland,2021-03-12,117,545,34338,19018,7.1145458877643,3.94037025142703,662,53356,fhi:git
county,Rogaland,2021-03-13,0,0,34338,19018,7.1145458877643,3.94037025142703,0,53356,fhi:git
county,Rogaland,2021-03-14,0,0,34338,19018,7.1145458877643,3.94037025142703,0,53356,fhi:git
county,Rogaland,2021-03-15,0,1,34338,19019,7.1145458877643,3.9405774430482,1,53357,fhi:git
county,Rogaland,2021-03-16,584,93,34922,19112,7.23554579452807,3.95984626381709,677,54034,fhi:git
county,Rogaland,2021-03-17,2397,95,37319,19207,7.73218411047457,3.97952946782832,2492,56526,fhi:git
county,Rogaland,2021-03-18,1675,83,38994,19290,8.07923007593573,3.9967263723855,1758,58284,fhi:git
county,Rogaland,2021-03-19,273,25,39267,19315,8.13579338851537,4.00190616291477,298,58582,fhi:git
county,Rogaland,2021-03-20,0,0,39267,19315,8.13579338851537,4.00190616291477,0,58582,fhi:git
county,Rogaland,2021-03-21,0,0,39267,19315,8.13579338851537,4.00190616291477,0,58582,fhi:git
county,Rogaland,2021-03-22,12,17,39279,19332,8.13827968796942,4.00542842047468,29,58611,fhi:git
county,Rogaland,2021-03-23,827,48,40106,19380,8.3096271586777,4.01537361829088,875,59486,fhi:git
county,Rogaland,2021-03-24,3405,80,43511,19460,9.01511462876441,4.03194894798454,3485,62971,fhi:git
county,Rogaland,2021-03-25,3235,166,46746,19626,9.68537952325208,4.0663427570989,3401,66372,fhi:git
county,Rogaland,2021-03-26,806,77,47552,19703,9.85237596991578,4.08229651192906,883,67255,fhi:git
county,Rogaland,2021-03-27,0,0,47552,19703,9.85237596991578,4.08229651192906,0,67255,fhi:git
county,Rogaland,2021-03-28,1,2,47553,19705,9.85258316153695,4.0827108951714,3,67258,fhi:git
county,Rogaland,2021-03-29,233,0,47786,19705,9.90085880926975,4.0827108951714,233,67491,fhi:git
county,Rogaland,2021-03-30,4125,356,51911,20061,10.7555242465995,4.15647111230822,4481,71972,fhi:git
county,Rogaland,2021-03-31,2106,612,54017,20673,11.1918698007853,4.28327238446477,2718,74690,fhi:git
county,Rogaland,2021-04-01,569,1,54586,20674,11.3097618332315,4.28347957608594,570,75260,fhi:git
county,Rogaland,2021-04-02,10,21,54596,20695,11.3118337494432,4.28783060013053,31,75291,fhi:git
county,Rogaland,2021-04-03,0,0,54596,20695,11.3118337494432,4.28783060013053,0,75291,fhi:git
county,Rogaland,2021-04-04,0,0,54596,20695,11.3118337494432,4.28783060013053,0,75291,fhi:git
county,Rogaland,2021-04-05,0,0,54596,20695,11.3118337494432,4.28783060013053,0,75291,fhi:git
county,Rogaland,2021-04-06,1363,77,55959,20772,11.594235929099,4.30378435496069,1440,76731,fhi:git
county,Rogaland,2021-04-07,5688,116,61647,20888,12.7727418703188,4.3278185830165,5804,82535,fhi:git
county,Rogaland,2021-04-08,4783,514,66430,21402,13.7637393943789,4.43431507629832,5297,87832,fhi:git
county,Troms og Finnmark,2020-12-27,0,0,0,0,0.0,0.0,0,0,fhi:git
county,Troms og Finnmark,2020-12-28,1,0,1,0,0.0004109966257177,0.0,1,1,fhi:git
county,Troms og Finnmark,2020-12-29,0,0,1,0,0.0004109966257177,0.0,0,1,fhi:git
county,Troms og Finnmark,2020-12-30,0,0,1,0,0.0004109966257177,0.0,0,1,fhi:git
county,Troms og Finnmark,2020-12-31,0,0,1,0,0.0004109966257177,0.0,0,1,fhi:git
county,Troms og Finnmark,2021-01-01,0,0,1,0,0.0004109966257177,0.0,0,1,fhi:git
county,Troms og Finnmark,2021-01-02,0,0,1,0,0.0004109966257177,0.0,0,1,fhi:git
county,Troms og Finnmark,2021-01-03,0,0,1,0,0.0004109966257177,0.0,0,1,fhi:git
county,Troms og Finnmark,2021-01-04,0,0,1,0,0.0004129364738528,0.0,0,1,fhi:git
county,Troms og Finnmark,2021-01-05,53,0,54,0,0.0222985695880546,0.0,53,54,fhi:git
county,Troms og Finnmark,2021-01-06,530,0,584,0,0.241154900730072,0.0,530,584,fhi:git
county,Troms og Finnmark,2021-01-07,188,0,772,0,0.31878695781441,0.0,188,772,fhi:git
county,Troms og Finnmark,2021-01-08,247,0,1019,0,0.420782266856067,0.0,247,1019,fhi:git
county,Troms og Finnmark,2021-01-09,0,0,1019,0,0.420782266856067,0.0,0,1019,fhi:git
county,Troms og Finnmark,2021-01-10,0,0,1019,0,0.420782266856067,0.0,0,1019,fhi:git
county,Troms og Finnmark,2021-01-11,0,0,1019,0,0.420782266856067,0.0,0,1019,fhi:git
county,Troms og Finnmark,2021-01-12,191,0,1210,0,0.499653133361964,0.0,191,1210,fhi:git
county,Troms og Finnmark,2021-01-13,569,0,1779,0,0.734613986984242,0.0,569,1779,fhi:git
county,Troms og Finnmark,2021-01-14,330,0,2109,0,0.870883023355687,0.0,330,2109,fhi:git
county,Troms og Finnmark,2021-01-15,37,0,2146,0,0.886161672888243,0.0,37,2146,fhi:git
county,Troms og Finnmark,2021-01-16,2,0,2148,0,0.886987545835949,0.0,2,2148,fhi:git
county,Troms og Finnmark,2021-01-17,0,0,2148,0,0.886987545835949,0.0,0,2148,fhi:git
county,Troms og Finnmark,2021-01-18,0,1,2148,1,0.886987545835949,0.0004129364738528,1,2149,fhi:git
county,Troms og Finnmark,2021-01-19,251,0,2399,1,0.990634600773017,0.0004129364738528,251,2400,fhi:git
county,Troms og Finnmark,2021-01-20,923,0,3322,1,1.37177496613921,0.0004129364738528,923,3323,fhi:git
county,Troms og Finnmark,2021-01-21,248,0,3570,1,1.47418321165472,0.0004129364738528,248,3571,fhi:git
county,Troms og Finnmark,2021-01-22,82,0,3652,1,1.50804400251065,0.0004129364738528,82,3653,fhi:git
county,Troms og Finnmark,2021-01-23,12,0,3664,1,1.51299924019689,0.0004129364738528,12,3665,fhi:git
county,Troms og Finnmark,2021-01-24,0,0,3664,1,1.51299924019689,0.0004129364738528,0,3665,fhi:git
county,Troms og Finnmark,2021-01-25,6,0,3670,1,1.51547685904001,0.0004129364738528,6,3671,fhi:git
county,Troms og Finnmark,2021-01-26,85,0,3755,1,1.5505764593175,0.0004129364738528,85,3756,fhi:git
county,Troms og Finnmark,2021-01-27,667,357,4422,358,1.82600508737736,0.147831257639325,1024,4780,fhi:git
county,Troms og Finnmark,2021-01-28,235,276,4657,634,1.92304515873278,0.261801724422715,511,5291,fhi:git
county,Troms og Finnmark,2021-01-29,104,243,4761,877,1.96599055201348,0.36214528756896,347,5638,fhi:git
county,Troms og Finnmark,2021-01-30,0,0,4761,877,1.96599055201348,0.36214528756896,0,5638,fhi:git
county,Troms og Finnmark,2021-01-31,0,0,4761,877,1.96599055201348,0.36214528756896,0,5638,fhi:git
county,Troms og Finnmark,2021-02-01,0,1,4761,878,1.96599055201348,0.362558224042813,1,5639,fhi:git
county,Troms og Finnmark,2021-02-02,119,24,4880,902,2.01512999240197,0.372468699415282,143,5782,fhi:git
county,Troms og Finnmark,2021-02-03,1160,562,6040,1464,2.49413630207129,0.604538997720591,1722,7504,fhi:git
county,Troms og Finnmark,2021-02-04,1149,380,7189,1844,2.96860031052823,0.761454857784678,1529,9033,fhi:git
county,Troms og Finnmark,2021-02-05,287,140,7476,1984,3.087113078524,0.819265964124079,427,9460,fhi:git
county,Troms og Finnmark,2021-02-06,1,1,7477,1985,3.08752601499785,0.819678900597932,2,9462,fhi:git
county,Troms og Finnmark,2021-02-07,0,0,7477,1985,3.08752601499785,0.819678900597932,0,9462,fhi:git
county,Troms og Finnmark,2021-02-08,0,0,7477,1985,3.08752601499785,0.819678900597932,0,9462,fhi:git
county,Troms og Finnmark,2021-02-09,71,29,7548,2014,3.11684450464141,0.831654058339665,100,9562,fhi:git
county,Troms og Finnmark,2021-02-10,1408,813,8956,2827,3.69825905982624,1.16737141158204,2221,11783,fhi:git
county,Troms og Finnmark,2021-02-11,995,466,9951,3293,4.10913085130983,1.35979980839748,1461,13244,fhi:git
county,Troms og Finnmark,2021-02-12,293,114,10244,3407,4.23012123814872,1.4068745664167,407,13651,fhi:git
county,Troms og Finnmark,2021-02-13,5,2,10249,3409,4.23218592051799,1.40770043936441,7,13658,fhi:git
county,Troms og Finnmark,2021-02-14,0,0,10249,3409,4.23218592051799,1.40770043936441,0,13658,fhi:git
county,Troms og Finnmark,2021-02-15,0,6,10249,3415,4.23218592051799,1.41017805820753,6,13664,fhi:git
county,Troms og Finnmark,2021-02-16,133,52,10382,3467,4.28710647154042,1.43165075484787,185,13849,fhi:git
county,Troms og Finnmark,2021-02-17,969,582,11351,4049,4.68724191470384,1.67197978263024,1551,15400,fhi:git
county,Troms og Finnmark,2021-02-18,1296,263,12647,4312,5.22240758481715,1.78058207525354,1559,16959,fhi:git
county,Troms og Finnmark,2021-02-19,232,133,12879,4445,5.31820884675102,1.83550262627597,365,17324,fhi:git
county,Troms og Finnmark,2021-02-20,0,0,12879,4445,5.31820884675102,1.83550262627597,0,17324,fhi:git
county,Troms og Finnmark,2021-02-21,0,0,12879,4445,5.31820884675102,1.83550262627597,0,17324,fhi:git
county,Troms og Finnmark,2021-02-22,107,0,12986,4445,5.36239304945327,1.83550262627597,107,17431,fhi:git
county,Troms og Finnmark,2021-02-23,79,78,13065,4523,5.39501503088765,1.8677116712365,157,17588,fhi:git
county,Troms og Finnmark,2021-02-24,430,993,13495,5516,5.57257771464438,2.27775758977239,1423,19011,fhi:git
county,Troms og Finnmark,2021-02-25,567,1054,14062,6570,5.80671269531895,2.71299263321331,1621,20632,fhi:git
county,Troms og Finnmark,2021-02-26,282,405,14344,6975,5.92316078094546,2.88023190512372,687,21319,fhi:git
county,Troms og Finnmark,2021-02-27,0,0,14344,6975,5.92316078094546,2.88023190512372,0,21319,fhi:git
county,Troms og Finnmark,2021-02-28,3,0,14347,6975,5.92439959036702,2.88023190512372,3,21322,fhi:git
county,Troms og Finnmark,2021-03-01,340,0,14687,6975,6.06479799147699,2.88023190512372,340,21662,fhi:git
county,Troms og Finnmark,2021-03-02,554,72,15241,7047,6.29356479799148,2.90996333124112,626,22288,fhi:git
county,Troms og Finnmark,2021-03-03,599,1179,15840,8226,6.54091374582934,3.39681543391365,1778,24066,fhi:git
county,Troms og Finnmark,2021-03-04,879,933,16719,9159,6.90388490634601,3.78208516401837,1812,25878,fhi:git
county,Troms og Finnmark,2021-03-05,704,374,17423,9533,7.19459218393842,3.93652340523934,1078,26956,fhi:git
county,Troms og Finnmark,2021-03-06,0,1,17423,9534,7.19459218393842,3.93693634171319,1,26957,fhi:git
county,Troms og Finnmark,2021-03-07,0,0,17423,9534,7.19459218393842,3.93693634171319,0,26957,fhi:git
county,Troms og Finnmark,2021-03-08,408,0,17831,9534,7.36307026527039,3.93693634171319,408,27365,fhi:git
county,Troms og Finnmark,2021-03-09,611,51,18442,9585,7.61537445079449,3.95799610187969,662,28027,fhi:git
county,Troms og Finnmark,2021-03-10,939,698,19381,10283,8.00312179974233,4.24622576062898,1637,29664,fhi:git
county,Troms og Finnmark,2021-03-11,795,1041,20176,11324,8.33140629645535,4.67609262990982,1836,31500,fhi:git
county,Troms og Finnmark,2021-03-12,68,209,20244,11533,8.35948597667735,4.76239635294506,277,31777,fhi:git
county,Troms og Finnmark,2021-03-13,0,0,20244,11533,8.35948597667735,4.76239635294506,0,31777,fhi:git
county,Troms og Finnmark,2021-03-14,0,0,20244,11533,8.35948597667735,4.76239635294506,0,31777,fhi:git
county,Troms og Finnmark,2021-03-15,2,5,20246,11538,8.36031184962505,4.76446103531433,7,31784,fhi:git
county,Troms og Finnmark,2021-03-16,19,2,20265,11540,8.36815764262826,4.76528690826203,21,31805,fhi:git
county,Troms og Finnmark,2021-03-17,546,45,20811,11585,8.59362095735192,4.78386904958541,591,32396,fhi:git
county,Troms og Finnmark,2021-03-18,1111,122,21922,11707,9.05239337980245,4.83424729939546,1233,33629,fhi:git
county,Troms og Finnmark,2021-03-19,406,33,22328,11740,9.22004558818671,4.84787420303261,439,34068,fhi:git
county,Troms og Finnmark,2021-03-20,0,0,22328,11740,9.22004558818671,4.84787420303261,0,34068,fhi:git
county,Troms og Finnmark,2021-03-21,1,0,22329,11740,9.22045852466057,4.84787420303261,1,34069,fhi:git
county,Troms og Finnmark,2021-03-22,3,0,22332,11740,9.22169733408213,4.84787420303261,3,34072,fhi:git
county,Troms og Finnmark,2021-03-23,429,14,22761,11754,9.398847081365,4.85365531366655,443,34515,fhi:git
county,Troms og Finnmark,2021-03-24,1875,42,24636,11796,10.1731029698391,4.87099864556837,1917,36432,fhi:git
county,Troms og Finnmark,2021-03-25,1975,38,26611,11834,10.9886525056985,4.88669023157477,2013,38445,fhi:git
county,Troms og Finnmark,2021-03-26,554,15,27165,11849,11.217419312213,4.89288427868257,569,39014,fhi:git
county,Troms og Finnmark,2021-03-27,1,0,27166,11849,11.2178322486869,4.89288427868257,1,39015,fhi:git
county,Troms og Finnmark,2021-03-28,0,0,27166,11849,11.2178322486869,4.89288427868257,0,39015,fhi:git
county,Troms og Finnmark,2021-03-29,176,0,27342,11849,11.290509068085,4.89288427868257,176,39191,fhi:git
county,Troms og Finnmark,2021-03-30,1620,149,28962,11998,11.9594661557266,4.95441181328664,1769,40960,fhi:git
county,Troms og Finnmark,2021-03-31,1344,284,30306,12282,12.5144527765849,5.07168577186086,1628,42588,fhi:git
county,Troms og Finnmark,2021-04-01,165,35,30471,12317,12.5825872947706,5.08613854844571,200,42788,fhi:git
county,Troms og Finnmark,2021-04-02,0,14,30471,12331,12.5825872947706,5.09191965907965,14,42802,fhi:git
county,Troms og Finnmark,2021-04-03,0,0,30471,12331,12.5825872947706,5.09191965907965,0,42802,fhi:git
county,Troms og Finnmark,2021-04-04,0,0,30471,12331,12.5825872947706,5.09191965907965,0,42802,fhi:git
county,Troms og Finnmark,2021-04-05,0,0,30471,12331,12.5825872947706,5.09191965907965,0,42802,fhi:git
county,Troms og Finnmark,2021-04-06,719,13,31190,12344,12.8794886194708,5.09728783323974,732,43534,fhi:git
county,Troms og Finnmark,2021-04-07,2561,60,33751,12404,13.937018929008,5.12206402167091,2621,46155,fhi:git
county,Troms og Finnmark,2021-04-08,2346,311,36097,12715,14.9057678966668,5.25048726503915,2657,48812,fhi:git
county,Trøndelag,2020-12-27,0,0,0,0,0.0,0.0,0,0,fhi:git
county,Trøndelag,2020-12-28,0,0,0,0,0.0,0.0,0,0,fhi:git
county,Trøndelag,2020-12-29,0,0,0,0,0.0,0.0,0,0,fhi:git
county,Trøndelag,2020-12-30,0,0,0,0,0.0,0.0,0,0,fhi:git
county,Trøndelag,2020-12-31,0,0,0,0,0.0,0.0,0,0,fhi:git
county,Trøndelag,2021-01-01,0,0,0,0,0.0,0.0,0,0,fhi:git
county,Trøndelag,2021-01-02,0,0,0,0,0.0,0.0,0,0,fhi:git
county,Trøndelag,2021-01-03,0,0,0,0,0.0,0.0,0,0,fhi:git
county,Trøndelag,2021-01-04,3,0,3,0,0.0006367750316264,0.0,3,3,fhi:git
county,Trøndelag,2021-01-05,407,0,410,0,0.0870259209889541,0.0,407,410,fhi:git
county,Trøndelag,2021-01-06,675,0,1085,0,0.230300303104915,0.0,675,1085,fhi:git
county,Trøndelag,2021-01-07,483,0,1568,0,0.332821083196781,0.0,483,1568,fhi:git
county,Trøndelag,2021-01-08,141,0,1709,0,0.362749509683226,0.0,141,1709,fhi:git
county,Trøndelag,2021-01-09,0,0,1709,0,0.362749509683226,0.0,0,1709,fhi:git
county,Trøndelag,2021-01-10,0,0,1709,0,0.362749509683226,0.0,0,1709,fhi:git
county,Trøndelag,2021-01-11,95,0,1804,0,0.382914052351398,0.0,95,1804,fhi:git
county,Trøndelag,2021-01-12,500,0,2304,0,0.489043224289147,0.0,500,2304,fhi:git
county,Trøndelag,2021-01-13,861,0,3165,0,0.67179765836595,0.0,861,3165,fhi:git
county,Trøndelag,2021-01-14,671,0,3836,0,0.81422300710641,0.0,671,3836,fhi:git
county,Trøndelag,2021-01-15,253,0,4089,0,0.86792436810691,0.0,253,4089,fhi:git
county,Trøndelag,2021-01-16,0,0,4089,0,0.86792436810691,0.0,0,4089,fhi:git
county,Trøndelag,2021-01-17,0,0,4089,0,0.86792436810691,0.0,0,4089,fhi:git
county,Trøndelag,2021-01-18,152,0,4241,0,0.900187636375986,0.0,152,4241,fhi:git
county,Trøndelag,2021-01-19,568,0,4809,0,1.02075037569727,0.0,568,4809,fhi:git
county,Trøndelag,2021-01-20,738,0,5547,0,1.17739703347739,0.0,738,5547,fhi:git
county,Trøndelag,2021-01-21,535,0,6082,0,1.29095524745078,0.0,535,6082,fhi:git
county,Trøndelag,2021-01-22,283,0,6365,0,1.35102435876754,0.0,283,6365,fhi:git
county,Trøndelag,2021-01-23,1,0,6366,0,1.35123661711142,0.0,1,6366,fhi:git
county,Trøndelag,2021-01-24,0,0,6366,0,1.35123661711142,0.0,0,6366,fhi:git
county,Trøndelag,2021-01-25,1,0,6367,0,1.35144887545529,0.0,1,6367,fhi:git
county,Trøndelag,2021-01-26,313,184,6680,184,1.41788573708833,0.0390555352730916,497,6864,fhi:git
county,Trøndelag,2021-01-27,1013,604,7693,788,1.6329034394342,0.167259574973892,1617,8481,fhi:git
county,Trøndelag,2021-01-28,727,483,8420,1271,1.78721525543169,0.269780355065758,1210,9691,fhi:git
county,Trøndelag,2021-01-29,423,229,8843,1500,1.87700053489103,0.318387515813247,652,10343,fhi:git
county,Trøndelag,2021-01-30,1,0,8844,1500,1.8772127932349,0.318387515813247,1,10344,fhi:git
county,Trøndelag,2021-01-31,2,1,8846,1501,1.87763730992265,0.318599774157122,3,10347,fhi:git
county,Trøndelag,2021-02-01,14,86,8860,1587,1.88060892673691,0.336853991730415,100,10447,fhi:git
county,Trøndelag,2021-02-02,836,392,9696,1979,2.05805690221683,0.42005926252961,1228,11675,fhi:git
county,Trøndelag,2021-02-03,2124,811,11820,2790,2.50889362460838,0.592200779412639,2935,14610,fhi:git
county,Trøndelag,2021-02-04,2144,607,13964,3397,2.96397551387745,0.721041594145066,2751,17361,fhi:git
county,Trøndelag,2021-02-05,1292,320,15256,3717,3.23821329416459,0.788964264185225,1612,18973,fhi:git
county,Trøndelag,2021-02-06,7,0,15263,3717,3.23969910257172,0.788964264185225,7,18980,fhi:git
county,Trøndelag,2021-02-07,1,0,15264,3717,3.2399113609156,0.788964264185225,1,18981,fhi:git
county,Trøndelag,2021-02-08,3,150,15267,3867,3.24054813594722,0.82080301576655,153,19134,fhi:git
county,Trøndelag,2021-02-09,836,523,16103,4390,3.41799611142714,0.931814129613435,1359,20493,fhi:git
county,Trøndelag,2021-02-10,2232,628,18335,5018,3.89175673495725,1.06511236956725,2860,23353,fhi:git
county,Trøndelag,2021-02-11,2362,586,20697,5604,4.39311094319118,1.18949575907829,2948,26301,fhi:git
county,Trøndelag,2021-02-12,888,352,21585,5956,4.58159635255262,1.26421069612246,1240,27541,fhi:git
county,Trøndelag,2021-02-13,2,0,21587,5956,4.58202086924037,1.26421069612246,2,27543,fhi:git
county,Trøndelag,2021-02-14,0,0,21587,5956,4.58202086924037,1.26421069612246,0,27543,fhi:git
county,Trøndelag,2021-02-15,0,2,21587,5958,4.58202086924037,1.26463521281022,2,27545,fhi:git
county,Trøndelag,2021-02-16,344,210,21931,6168,4.65503773953354,1.30920946502407,554,28099,fhi:git
county,Trøndelag,2021-02-17,2224,922,24155,7090,5.12710029631265,1.50491165807728,3146,31245,fhi:git
county,Trøndelag,2021-02-18,2120,752,26275,7842,5.5770879853287,1.66452993267165,2872,34117,fhi:git
county,Trøndelag,2021-02-19,1262,410,27537,8252,5.84495801529958,1.75155585366061,1672,35789,fhi:git
county,Trøndelag,2021-02-20,1,1,27538,8253,5.84517027364346,1.75176811200448,2,35791,fhi:git
county,Trøndelag,2021-02-21,0,4,27538,8257,5.84517027364346,1.75261714537998,4,35795,fhi:git
county,Trøndelag,2021-02-22,17,2,27555,8259,5.84877866548934,1.75304166206774,19,35814,fhi:git
county,Trøndelag,2021-02-23,334,674,27889,8933,5.91967295234376,1.89610378583982,1008,36822,fhi:git
county,Trøndelag,2021-02-24,1011,2046,28900,10979,6.13426613800189,2.33038435740909,3057,39879,fhi:git
county,Trøndelag,2021-02-25,474,1983,29374,12962,6.23487659299887,2.7512926533142,2457,42336,fhi:git
county,Trøndelag,2021-02-26,617,1154,29991,14116,6.36583999117005,2.99623878214653,1771,44107,fhi:git
county,Trøndelag,2021-02-27,4,1,29995,14117,6.36668902454556,2.9964510404904,5,44112,fhi:git
county,Trøndelag,2021-02-28,1,0,29996,14117,6.36690128288943,2.9964510404904,1,44113,fhi:git
county,Trøndelag,2021-03-01,526,0,30522,14117,6.47854917176794,2.9964510404904,526,44639,fhi:git
county,Trøndelag,2021-03-02,819,785,31341,14902,6.65238875540198,3.16307384043267,1604,46243,fhi:git
county,Trøndelag,2021-03-03,2018,2142,33359,17044,7.08072609334273,3.61773121301398,4160,50403,fhi:git
county,Trøndelag,2021-03-04,1875,2282,35234,19326,7.47871048810929,4.10210475373787,4157,54560,fhi:git
county,Trøndelag,2021-03-05,1048,982,36282,20308,7.70115723249081,4.31054244742361,2030,56590,fhi:git
county,Trøndelag,2021-03-06,2,0,36284,20308,7.70158174917856,4.31054244742361,2,56592,fhi:git
county,Trøndelag,2021-03-07,0,1,36284,20309,7.70158174917856,4.31075470576748,1,56593,fhi:git
county,Trøndelag,2021-03-08,436,0,36720,20309,7.79412638710828,4.31075470576748,436,57029,fhi:git
county,Trøndelag,2021-03-09,1172,301,37892,20610,8.04289316613036,4.37464446727401,1473,58502,fhi:git
county,Trøndelag,2021-03-10,1687,1500,39579,22110,8.40097299224833,4.69303198308726,3187,61689,fhi:git
county,Trøndelag,2021-03-11,823,1197,40402,23307,8.57566160925786,4.94710522070623,2020,63709,fhi:git
county,Trøndelag,2021-03-12,122,500,40524,23807,8.60155712721067,5.05323439264398,622,64331,fhi:git
county,Trøndelag,2021-03-13,0,1,40524,23808,8.60155712721067,5.05344665098785,1,64332,fhi:git
county,Trøndelag,2021-03-14,0,0,40524,23808,8.60155712721067,5.05344665098785,0,64332,fhi:git
county,Trøndelag,2021-03-15,3,6,40527,23814,8.6021939022423,5.0547202010511,9,64341,fhi:git
county,Trøndelag,2021-03-16,607,12,41134,23826,8.73103471697472,5.05726730117761,619,64960,fhi:git
county,Trøndelag,2021-03-17,1979,122,43113,23948,9.15109397950433,5.08316281913042,2101,67061,fhi:git
county,Trøndelag,2021-03-18,1498,123,44611,24071,9.46905697862983,5.10927059542711,1621,68682,fhi:git
county,Trøndelag,2021-03-19,542,88,45153,24159,9.58410100101035,5.12794932968815,630,69312,fhi:git
county,Trøndelag,2021-03-20,0,0,45153,24159,9.58410100101035,5.12794932968815,0,69312,fhi:git
county,Trøndelag,2021-03-21,0,0,45153,24159,9.58410100101035,5.12794932968815,0,69312,fhi:git
county,Trøndelag,2021-03-22,1,0,45154,24159,9.58431325935423,5.12794932968815,1,69313,fhi:git
county,Trøndelag,2021-03-23,1046,216,46200,24375,9.806335487048,5.17379713196526,1262,70575,fhi:git
county,Trøndelag,2021-03-24,3145,554,49345,24929,10.4738879785364,5.29138825447228,3699,74274,fhi:git
county,Trøndelag,2021-03-25,2885,304,52230,25233,11.0862533006172,5.35591479101043,3189,77463,fhi:git
county,Trøndelag,2021-03-26,1981,218,54211,25451,11.5067370798346,5.40218710997529,2199,79662,fhi:git
county,Trøndelag,2021-03-27,0,3,54211,25454,11.5067370798346,5.40282388500692,3,79665,fhi:git
county,Trøndelag,2021-03-28,0,0,54211,25454,11.5067370798346,5.40282388500692,0,79665,fhi:git
county,Trøndelag,2021-03-29,3,0,54214,25454,11.5073738548662,5.40282388500692,3,79668,fhi:git
county,Trøndelag,2021-03-30,1875,535,56089,25989,11.9053582496328,5.51638209898031,2410,82078,fhi:git
county,Trøndelag,2021-03-31,2540,422,58629,26411,12.4444944430766,5.60595512009577,2962,85040,fhi:git
county,Trøndelag,2021-04-01,163,156,58792,26567,12.4790925531283,5.63906742174035,319,85359,fhi:git
county,Trøndelag,2021-04-02,152,94,58944,26661,12.5113558213973,5.65901970606465,246,85605,fhi:git
county,Trøndelag,2021-04-03,0,0,58944,26661,12.5113558213973,5.65901970606465,0,85605,fhi:git
county,Trøndelag,2021-04-04,0,0,58944,26661,12.5113558213973,5.65901970606465,0,85605,fhi:git
county,Trøndelag,2021-04-05,1,0,58945,26661,12.5115680797412,5.65901970606465,1,85606,fhi:git
county,Trøndelag,2021-04-06,2092,41,61037,26702,12.9556125351288,5.66772229816354,2133,87739,fhi:git
county,Trøndelag,2021-04-07,4382,216,65419,26918,13.8857285979912,5.71357010044065,4598,92337,fhi:git
county,Trøndelag,2021-04-08,3838,105,69257,27023,14.7003761217853,5.73585722654758,3943,96280,fhi:git
county,Vestfold og Telemark,2020-12-27,0,0,0,0,0.0,0.0,0,0,fhi:git
county,Vestfold og Telemark,2020-12-28,0,0,0,0,0.0,0.0,0,0,fhi:git
county,Vestfold og Telemark,2020-12-29,0,0,0,0,0.0,0.0,0,0,fhi:git
county,Vestfold og Telemark,2020-12-30,0,0,0,0,0.0,0.0,0,0,fhi:git
county,Vestfold og Telemark,2020-12-31,0,0,0,0,0.0,0.0,0,0,fhi:git
county,Vestfold og Telemark,2021-01-01,0,0,0,0,0.0,0.0,0,0,fhi:git
county,Vestfold og Telemark,2021-01-02,0,0,0,0,0.0,0.0,0,0,fhi:git
county,Vestfold og Telemark,2021-01-03,0,0,0,0,0.0,0.0,0,0,fhi:git
county,Vestfold og Telemark,2021-01-04,1,0,1,0,0.0002370331040433,0.0,1,1,fhi:git
county,Vestfold og Telemark,2021-01-05,218,0,219,0,0.051910249785485,0.0,218,219,fhi:git
county,Vestfold og Telemark,2021-01-06,1026,0,1245,0,0.295106214533922,0.0,1026,1245,fhi:git
county,Vestfold og Telemark,2021-01-07,442,0,1687,0,0.399874846521065,0.0,442,1687,fhi:git
county,Vestfold og Telemark,2021-01-08,63,0,1750,0,0.414807932075794,0.0,63,1750,fhi:git
county,Vestfold og Telemark,2021-01-09,0,0,1750,0,0.414807932075794,0.0,0,1750,fhi:git
county,Vestfold og Telemark,2021-01-10,3,0,1753,0,0.415519031387924,0.0,3,1753,fhi:git
county,Vestfold og Telemark,2021-01-11,3,0,1756,0,0.416230130700054,0.0,3,1756,fhi:git
county,Vestfold og Telemark,2021-01-12,420,0,2176,0,0.515784034398244,0.0,420,2176,fhi:git
county,Vestfold og Telemark,2021-01-13,1164,0,3340,0,0.791690567504658,0.0,1164,3340,fhi:git
county,Vestfold og Telemark,2021-01-14,584,0,3924,0,0.930117900265951,0.0,584,3924,fhi:git
county,Vestfold og Telemark,2021-01-15,157,0,4081,0,0.967332097600751,0.0,157,4081,fhi:git
county,Vestfold og Telemark,2021-01-16,3,0,4084,0,0.968043196912881,0.0,3,4084,fhi:git
county,Vestfold og Telemark,2021-01-17,42,0,4126,0,0.9779985872827,0.0,42,4126,fhi:git
county,Vestfold og Telemark,2021-01-18,7,0,4133,0,0.979657819011003,0.0,7,4133,fhi:git
county,Vestfold og Telemark,2021-01-19,233,0,4366,0,1.03488653225309,0.0,233,4366,fhi:git
county,Vestfold og Telemark,2021-01-20,1606,0,5972,0,1.41556169734665,0.0,1606,5972,fhi:git
county,Vestfold og Telemark,2021-01-21,829,0,6801,0,1.61206214059856,0.0,829,6801,fhi:git
county,Vestfold og Telemark,2021-01-22,181,0,6982,0,1.6549651324304,0.0,181,6982,fhi:git
county,Vestfold og Telemark,2021-01-23,3,0,6985,0,1.65567623174253,0.0,3,6985,fhi:git
county,Vestfold og Telemark,2021-01-24,0,0,6985,0,1.65567623174253,0.0,0,6985,fhi:git
county,Vestfold og Telemark,2021-01-25,44,0,7029,0,1.66610568832043,0.0,44,7029,fhi:git
county,Vestfold og Telemark,2021-01-26,103,179,7132,179,1.69052009803689,0.0424289256237526,282,7311,fhi:git
county,Vestfold og Telemark,2021-01-27,1625,899,8757,1078,2.07569889210727,0.255521686158689,2524,9835,fhi:git
county,Vestfold og Telemark,2021-01-28,655,449,9412,1527,2.23095557525564,0.361949549874135,1104,10939,fhi:git
county,Vestfold og Telemark,2021-01-29,86,91,9498,1618,2.25134042220337,0.383519562342077,177,11116,fhi:git
county,Vestfold og Telemark,2021-01-30,0,0,9498,1618,2.25134042220337,0.383519562342077,0,11116,fhi:git
county,Vestfold og Telemark,2021-01-31,1,2,9499,1620,2.25157745530741,0.383993628550163,3,11119,fhi:git
county,Vestfold og Telemark,2021-02-01,50,1,9549,1621,2.26342911050957,0.384230661654207,51,11170,fhi:git
county,Vestfold og Telemark,2021-02-02,464,327,10013,1948,2.37341247078567,0.461740486676369,791,11961,fhi:git
county,Vestfold og Telemark,2021-02-03,3214,847,13227,2795,3.13523686718087,0.662507525801054,4061,16022,fhi:git
county,Vestfold og Telemark,2021-02-04,1902,709,15129,3504,3.58607383107125,0.830563996567761,2611,18633,fhi:git
county,Vestfold og Telemark,2021-02-05,964,245,16093,3749,3.814573743369,0.888637107058372,1209,19842,fhi:git
county,Vestfold og Telemark,2021-02-06,0,4,16093,3753,3.814573743369,0.889585239474545,4,19846,fhi:git
county,Vestfold og Telemark,2021-02-07,2,1,16095,3754,3.81504780957709,0.889822272578588,3,19849,fhi:git
county,Vestfold og Telemark,2021-02-08,17,46,16112,3800,3.81907737234582,0.900725795364581,63,19912,fhi:git
county,Vestfold og Telemark,2021-02-09,356,208,16468,4008,3.90346115738524,0.950028681005589,564,20476,fhi:git
county,Vestfold og Telemark,2021-02-10,2892,1395,19360,5403,4.5889608942785,1.28068986114601,4287,24763,fhi:git
county,Vestfold og Telemark,2021-02-11,1541,878,20901,6281,4.95422890760924,1.48880492649603,2419,27182,fhi:git
county,Vestfold og Telemark,2021-02-12,602,213,21503,6494,5.09692283624331,1.53929297765726,815,27997,fhi:git
county,Vestfold og Telemark,2021-02-13,2,2,21505,6496,5.0973969024514,1.53976704386535,4,28001,fhi:git
county,Vestfold og Telemark,2021-02-14,0,0,21505,6496,5.0973969024514,1.53976704386535,0,28001,fhi:git
county,Vestfold og Telemark,2021-02-15,4,2,21509,6498,5.09834503486757,1.54024111007343,6,28007,fhi:git
county,Vestfold og Telemark,2021-02-16,579,75,22088,6573,5.23558720210865,1.55801859287668,654,28661,fhi:git
county,Vestfold og Telemark,2021-02-17,3043,1532,25131,8105,5.95687893771244,1.92115330827103,4575,33236,fhi:git
county,Vestfold og Telemark,2021-02-18,1822,629,26953,8734,6.38875325327935,2.07024713071428,2451,35687,fhi:git
county,Vestfold og Telemark,2021-02-19,283,83,27236,8817,6.45583362172361,2.08992087834987,366,36053,fhi:git
county,Vestfold og Telemark,2021-02-20,0,1,27236,8818,6.45583362172361,2.09015791145391,1,36054,fhi:git
county,Vestfold og Telemark,2021-02-21,1,1,27237,8819,6.45607065482765,2.09039494455796,2,36056,fhi:git
county,Vestfold og Telemark,2021-02-22,51,0,27288,8819,6.46815934313386,2.09039494455796,51,36107,fhi:git
county,Vestfold og Telemark,2021-02-23,626,385,27914,9204,6.61654206626498,2.18165268961463,1011,37118,fhi:git
county,Vestfold og Telemark,2021-02-24,669,2870,28583,12074,6.77511721286995,2.86193769821893,3539,40657,fhi:git
county,Vestfold og Telemark,2021-02-25,703,1998,29286,14072,6.9417514850124,3.33552984009747,2701,43358,fhi:git
county,Vestfold og Telemark,2021-02-26,543,845,29829,14917,7.07046046050791,3.53582281301407,1388,44746,fhi:git
county,Vestfold og Telemark,2021-02-27,3,2,29832,14919,7.07117155982004,3.53629687922215,5,44751,fhi:git
county,Vestfold og Telemark,2021-02-28,0,0,29832,14919,7.07117155982004,3.53629687922215,0,44751,fhi:git
county,Vestfold og Telemark,2021-03-01,609,0,30441,14919,7.21552472018242,3.53629687922215,609,45360,fhi:git
county,Vestfold og Telemark,2021-03-02,845,354,31286,15273,7.41581769309902,3.62020659805348,1199,46559,fhi:git
county,Vestfold og Telemark,2021-03-03,1975,2815,33261,18088,7.88395807358456,4.2874547859354,4790,51349,fhi:git
county,Vestfold og Telemark,2021-03-04,1011,1433,34272,19521,8.12359854177234,4.62712322402947,2444,53793,fhi:git
county,Vestfold og Telemark,2021-03-05,1476,585,35748,20106,8.47345940334027,4.76578758989481,2061,55854,fhi:git
county,Vestfold og Telemark,2021-03-06,3,1,35751,20107,8.4741705026524,4.76602462299885,4,55858,fhi:git
county,Vestfold og Telemark,2021-03-07,1,0,35752,20107,8.47440753575644,4.76602462299885,1,55859,fhi:git
county,Vestfold og Telemark,2021-03-08,236,0,35988,20107,8.53034734831067,4.76602462299885,236,56095,fhi:git
county,Vestfold og Telemark,2021-03-09,934,142,36922,20249,8.75173626748712,4.799683323773,1076,57171,fhi:git
county,Vestfold og Telemark,2021-03-10,1593,2261,38515,22510,9.12933000222811,5.33561517201492,3854,61025,fhi:git
county,Vestfold og Telemark,2021-03-11,299,835,38814,23345,9.20020290033706,5.53353781389109,1134,62159,fhi:git
county,Vestfold og Telemark,2021-03-12,35,126,38849,23471,9.20849905897858,5.56340398500055,161,62320,fhi:git
county,Vestfold og Telemark,2021-03-13,1,1,38850,23472,9.20873609208262,5.56364101810459,2,62322,fhi:git
county,Vestfold og Telemark,2021-03-14,0,0,38850,23472,9.20873609208262,5.56364101810459,0,62322,fhi:git
county,Vestfold og Telemark,2021-03-15,2,3,38852,23475,9.20921015829071,5.56435211741672,5,62327,fhi:git
county,Vestfold og Telemark,2021-03-16,402,25,39254,23500,9.30449746611612,5.5702779450178,427,62754,fhi:git
county,Vestfold og Telemark,2021-03-17,3103,166,42357,23666,10.0400111879625,5.60962544028899,3269,66023,fhi:git
county,Vestfold og Telemark,2021-03-18,911,53,43268,23719,10.255948345746,5.62218819480329,964,66987,fhi:git
county,Vestfold og Telemark,2021-03-19,27,32,43295,23751,10.2623482395551,5.62977325413267,59,67046,fhi:git
county,Vestfold og Telemark,2021-03-20,0,0,43295,23751,10.2623482395551,5.62977325413267,0,67046,fhi:git
county,Vestfold og Telemark,2021-03-21,0,0,43295,23751,10.2623482395551,5.62977325413267,0,67046,fhi:git
county,Vestfold og Telemark,2021-03-22,0,1,43295,23752,10.2623482395551,5.63001028723672,1,67047,fhi:git
county,Vestfold og Telemark,2021-03-23,660,58,43955,23810,10.4187900882237,5.64375820727123,718,67765,fhi:git
county,Vestfold og Telemark,2021-03-24,4609,817,48564,24627,11.5112756647593,5.83741425327461,5426,73191,fhi:git
county,Vestfold og Telemark,2021-03-25,2945,270,51509,24897,12.2093381561669,5.90141319136631,3215,76406,fhi:git
county,Vestfold og Telemark,2021-03-26,898,152,52407,25049,12.4221938835978,5.93744222318089,1050,77456,fhi:git
county,Vestfold og Telemark,2021-03-27,0,0,52407,25049,12.4221938835978,5.93744222318089,0,77456,fhi:git
county,Vestfold og Telemark,2021-03-28,0,0,52407,25049,12.4221938835978,5.93744222318089,0,77456,fhi:git
county,Vestfold og Telemark,2021-03-29,184,3,52591,25052,12.4658079747418,5.93815332249302,187,77643,fhi:git
county,Vestfold og Telemark,2021-03-30,3017,80,55608,25132,13.1809368496404,5.95711597081649,3097,80740,fhi:git
county,Vestfold og Telemark,2021-03-31,3392,490,59000,25622,13.9849531385553,6.07326219179771,3882,84622,fhi:git
county,Vestfold og Telemark,2021-04-01,425,17,59425,25639,14.0856922077737,6.07729175456644,442,85064,fhi:git
county,Vestfold og Telemark,2021-04-02,2,3,59427,25642,14.0861662739818,6.07800285387857,5,85069,fhi:git
county,Vestfold og Telemark,2021-04-03,1,0,59428,25642,14.0864033070859,6.07800285387857,1,85070,fhi:git
county,Vestfold og Telemark,2021-04-04,0,0,59428,25642,14.0864033070859,6.07800285387857,0,85070,fhi:git
county,Vestfold og Telemark,2021-04-05,1,1,59429,25643,14.0866403401899,6.07823988698262,2,85072,fhi:git
county,Vestfold og Telemark,2021-04-06,966,40,60395,25683,14.3156143186957,6.08772121114435,1006,86078,fhi:git
county,Vestfold og Telemark,2021-04-07,6277,142,66672,25825,15.8034711127756,6.1213799119185,6419,92497,fhi:git
county,Vestfold og Telemark,2021-04-08,3510,58,70182,25883,16.6354573079676,6.13512783195301,3568,96065,fhi:git
county,Vestland,2020-12-27,0,0,0,0,0.0,0.0,0,0,fhi:git
county,Vestland,2020-12-28,0,0,0,0,0.0,0.0,0,0,fhi:git
county,Vestland,2020-12-29,0,0,0,0,0.0,0.0,0,0,fhi:git
county,Vestland,2020-12-30,0,0,0,0,0.0,0.0,0,0,fhi:git
county,Vestland,2020-12-31,0,0,0,0,0.0,0.0,0,0,fhi:git
county,Vestland,2021-01-01,0,0,0,0,0.0,0.0,0,0,fhi:git
county,Vestland,2021-01-02,0,0,0,0,0.0,0.0,0,0,fhi:git
county,Vestland,2021-01-03,0,0,0,0,0.0,0.0,0,0,fhi:git
county,Vestland,2021-01-04,2,0,2,0,0.0003130767460681,0.0,2,2,fhi:git
county,Vestland,2021-01-05,416,0,418,0,0.0654330399282428,0.0,416,418,fhi:git
county,Vestland,2021-01-06,1256,0,1674,0,0.262045236459039,0.0,1256,1674,fhi:git
county,Vestland,2021-01-07,715,0,2389,0,0.373970173178402,0.0,715,2389,fhi:git
county,Vestland,2021-01-08,139,0,2528,0,0.395729007030138,0.0,139,2528,fhi:git
county,Vestland,2021-01-09,0,0,2528,0,0.395729007030138,0.0,0,2528,fhi:git
county,Vestland,2021-01-10,0,0,2528,0,0.395729007030138,0.0,0,2528,fhi:git
county,Vestland,2021-01-11,65,0,2593,0,0.405904001277353,0.0,65,2593,fhi:git
county,Vestland,2021-01-12,856,0,3449,0,0.53990084859452,0.0,856,3449,fhi:git
county,Vestland,2021-01-13,1127,0,4576,0,0.716319595003921,0.0,1127,4576,fhi:git
county,Vestland,2021-01-14,999,0,5575,0,0.872701429664961,0.0,999,5575,fhi:git
county,Vestland,2021-01-15,425,0,6000,0,0.939230238204442,0.0,425,6000,fhi:git
county,Vestland,2021-01-16,2,0,6002,0,0.93954331495051,0.0,2,6002,fhi:git
county,Vestland,2021-01-17,1,0,6003,0,0.939699853323544,0.0,1,6003,fhi:git
county,Vestland,2021-01-18,62,0,6065,0,0.949405232451657,0.0,62,6065,fhi:git
county,Vestland,2021-01-19,368,0,6433,0,1.0070113537282,0.0,368,6433,fhi:git
county,Vestland,2021-01-20,1235,0,7668,0,1.20033624442528,0.0,1235,7668,fhi:git
county,Vestland,2021-01-21,783,0,8451,0,1.32290579051096,0.0,783,8451,fhi:git
county,Vestland,2021-01-22,312,0,8763,0,1.37174576289759,0.0,312,8763,fhi:git
county,Vestland,2021-01-23,0,0,8763,0,1.37174576289759,0.0,0,8763,fhi:git
county,Vestland,2021-01-24,0,0,8763,0,1.37174576289759,0.0,0,8763,fhi:git
county,Vestland,2021-01-25,2,0,8765,0,1.37205883964366,0.0,2,8765,fhi:git
county,Vestland,2021-01-26,152,174,8917,174,1.39585267234484,0.0272376769079288,326,9091,fhi:git
county,Vestland,2021-01-27,1590,1211,10507,1385,1.64474868546901,0.216805646652192,2801,11892,fhi:git
county,Vestland,2021-01-28,1958,695,12465,2080,1.95125081986973,0.325599815910873,2653,14545,fhi:git
county,Vestland,2021-01-29,481,176,12946,2256,2.02654577729912,0.35315056956487,657,15202,fhi:git
county,Vestland,2021-01-30,3,0,12949,2256,2.02701539241822,0.35315056956487,3,15205,fhi:git
county,Vestland,2021-01-31,1,0,12950,2256,2.02717193079125,0.35315056956487,1,15206,fhi:git
county,Vestland,2021-02-01,13,59,12963,2315,2.0292069296407,0.362386333573881,72,15278,fhi:git
county,Vestland,2021-02-02,720,582,13683,2897,2.14191455822523,0.453491666679712,1302,16580,fhi:git
county,Vestland,2021-02-03,2830,1049,16513,3946,2.58491815391166,0.617700419992455,3879,20459,fhi:git
county,Vestland,2021-02-04,2588,1114,19101,5060,2.99003946332384,0.792084167552413,3702,24161,fhi:git
county,Vestland,2021-02-05,911,487,20012,5547,3.13264592115788,0.868318355220007,1398,25559,fhi:git
county,Vestland,2021-02-06,0,2,20012,5549,3.13264592115788,0.868631431966075,2,25561,fhi:git
county,Vestland,2021-02-07,2,1,20014,5550,3.13295899790395,0.868787970339109,3,25564,fhi:git
county,Vestland,2021-02-08,8,49,20022,5599,3.13421130488822,0.876458350617779,57,25621,fhi:git
county,Vestland,2021-02-09,891,307,20913,5906,3.27368699526158,0.924515631139239,1198,26819,fhi:git
county,Vestland,2021-02-10,2758,971,23671,6877,3.70541982808956,1.07651439135532,3729,30548,fhi:git
county,Vestland,2021-02-11,2703,836,26374,7713,4.12854305040066,1.20738047121181,3539,34087,fhi:git
county,Vestland,2021-02-12,630,458,27004,8171,4.22716222541213,1.27907504606142,1088,35175,fhi:git
county,Vestland,2021-02-13,0,0,27004,8171,4.22716222541213,1.27907504606142,0,35175,fhi:git
county,Vestland,2021-02-14,0,2,27004,8173,4.22716222541213,1.27938812280748,2,35177,fhi:git
county,Vestland,2021-02-15,94,1,27098,8174,4.24187683247733,1.27954466118052,95,35272,fhi:git
county,Vestland,2021-02-16,1087,55,28185,8229,4.41203404396537,1.28815427169739,1142,36414,fhi:git
county,Vestland,2021-02-17,2690,1328,30875,9557,4.83312226742703,1.49603723108664,4018,40432,fhi:git
county,Vestland,2021-02-18,2008,1999,32883,11556,5.14745132047945,1.80895743878176,4007,44439,fhi:git
county,Vestland,2021-02-19,1157,540,34040,12096,5.32856621807987,1.89348816022016,1697,46136,fhi:git
county,Vestland,2021-02-20,3,4,34043,12100,5.32903583319897,1.89411431371229,7,46143,fhi:git
county,Vestland,2021-02-21,0,1,34043,12101,5.32903583319897,1.89427085208533,1,46144,fhi:git
county,Vestland,2021-02-22,48,2,34091,12103,5.33654967510461,1.89458392883139,50,46194,fhi:git
county,Vestland,2021-02-23,542,591,34633,12694,5.42139347328908,1.98709810729453,1133,47327,fhi:git
county,Vestland,2021-02-24,1414,2401,36047,15095,5.64273873275926,2.36294674094934,3815,51142,fhi:git
county,Vestland,2021-02-25,1258,2645,37305,17740,5.83966400603612,2.77699073762447,3903,55045,fhi:git
county,Vestland,2021-02-26,1426,875,38731,18615,6.06288772598271,2.91396181402928,2301,57346,fhi:git
county,Vestland,2021-02-27,1,0,38732,18615,6.06304426435574,2.91396181402928,1,57347,fhi:git
county,Vestland,2021-02-28,0,7,38732,18622,6.06304426435574,2.91505758264052,7,57354,fhi:git
county,Vestland,2021-03-01,440,11,39172,18633,6.13192114849074,2.9167795047439,451,57805,fhi:git
county,Vestland,2021-03-02,1351,757,40523,19390,6.34340449045977,3.03527905313069,2108,59913,fhi:git
county,Vestland,2021-03-03,1741,2045,42264,21435,6.61593779791209,3.35540002598537,3786,63699,fhi:git
county,Vestland,2021-03-04,1795,2848,44059,24283,6.89692417750825,3.80122131238641,4643,68342,fhi:git
county,Vestland,2021-03-05,1245,903,45304,25186,7.09181445193568,3.94257546323618,2148,70490,fhi:git
county,Vestland,2021-03-06,1,6,45305,25192,7.09197099030871,3.94351469347439,7,70497,fhi:git
county,Vestland,2021-03-07,2,0,45307,25192,7.09228406705478,3.94351469347439,2,70499,fhi:git
county,Vestland,2021-03-08,637,14,45944,25206,7.19199901067748,3.94570623069686,651,71150,fhi:git
county,Vestland,2021-03-09,1500,527,47444,25733,7.42680657022859,4.02820195328582,2027,73177,fhi:git
county,Vestland,2021-03-10,2480,1831,49924,27564,7.8150217353531,4.31482371431121,4311,77488,fhi:git
county,Vestland,2021-03-11,1402,1545,51326,29109,8.03448853434687,4.55667550064885,2947,80435,fhi:git
county,Vestland,2021-03-12,179,976,51505,30085,8.06250890311997,4.70945695273011,1155,81590,fhi:git
county,Vestland,2021-03-13,8,10,51513,30095,8.06376121010424,4.71102233646045,18,81608,fhi:git
county,Vestland,2021-03-14,0,0,51513,30095,8.06376121010424,4.71102233646045,0,81608,fhi:git
county,Vestland,2021-03-15,7,8,51520,30103,8.06485697871548,4.71227464344472,15,81623,fhi:git
county,Vestland,2021-03-16,1194,34,52714,30137,8.25176379611816,4.71759694812788,1228,82851,fhi:git
county,Vestland,2021-03-17,2429,222,55143,30359,8.63199550421793,4.75234846694144,2651,85502,fhi:git
county,Vestland,2021-03-18,2313,145,57456,30504,8.99406876104574,4.77504653103138,2458,87960,fhi:git
county,Vestland,2021-03-19,587,115,58043,30619,9.08595678601674,4.7930484439303,702,88662,fhi:git
county,Vestland,2021-03-20,1,2,58044,30621,9.08611332438977,4.79336152067637,3,88665,fhi:git
county,Vestland,2021-03-21,0,0,58044,30621,9.08611332438977,4.79336152067637,0,88665,fhi:git
county,Vestland,2021-03-22,8,13,58052,30634,9.08736563137405,4.79539651952581,21,88686,fhi:git
county,Vestland,2021-03-23,2050,339,60102,30973,9.4082692960939,4.84846302798437,2389,91075,fhi:git
county,Vestland,2021-03-24,4021,514,64123,31487,10.0377100940639,4.92892375172388,4535,95610,fhi:git
county,Vestland,2021-03-25,3132,375,67255,31862,10.5279882784066,4.98762564161166,3507,99117,fhi:git
county,Vestland,2021-03-26,996,188,68251,32050,10.6839004979486,5.01705485574206,1184,100301,fhi:git
county,Vestland,2021-03-27,2,0,68253,32050,10.6842135746946,5.01705485574206,2,100303,fhi:git
county,Vestland,2021-03-28,0,0,68253,32050,10.6842135746946,5.01705485574206,0,100303,fhi:git
county,Vestland,2021-03-29,115,2,68368,32052,10.7022154875936,5.01736793248813,117,100420,fhi:git
county,Vestland,2021-03-30,3567,569,71935,32621,11.2605878642061,5.10643826674452,4136,104556,fhi:git
county,Vestland,2021-03-31,3524,1112,75459,33733,11.8122290907782,5.28050893755841,4636,109192,fhi:git
county,Vestland,2021-04-01,951,232,76410,33965,11.9610970835336,5.31682584010231,1183,110375,fhi:git
county,Vestland,2021-04-02,53,89,76463,34054,11.9693936173044,5.33075775530235,142,110517,fhi:git
county,Vestland,2021-04-03,0,0,76463,34054,11.9693936173044,5.33075775530235,0,110517,fhi:git
county,Vestland,2021-04-04,0,2,76463,34056,11.9693936173044,5.33107083204842,2,110519,fhi:git
county,Vestland,2021-04-05,1,1,76464,34057,11.9695501556774,5.33122737042145,2,110521,fhi:git
county,Vestland,2021-04-06,3077,99,79541,34156,12.4512187295033,5.34672466935182,3176,113697,fhi:git
county,Vestland,2021-04-07,8067,148,87608,34304,13.7140137847691,5.36989234856087,8215,121912,fhi:git
county,Vestland,2021-04-08,5575,280,93183,34584,14.5867152144341,5.41372309301041,5855,127767,fhi:git
county,Viken,2020-12-27,0,0,0,0,0.0,0.0,0,0,fhi:git
county,Viken,2020-12-28,65,0,65,0,0.0052370152236004,0.0,65,65,fhi:git
county,Viken,2020-12-29,689,0,754,0,0.0607493765937647,0.0,689,754,fhi:git
county,Viken,2020-12-30,219,0,973,0,0.0783940894240492,0.0,219,973,fhi:git
county,Viken,2020-12-31,67,0,1040,0,0.0837922435776065,0.0,67,1040,fhi:git
county,Viken,2021-01-01,0,0,1040,0,0.0837922435776065,0.0,0,1040,fhi:git
county,Viken,2021-01-02,0,0,1040,0,0.0837922435776065,0.0,0,1040,fhi:git
county,Viken,2021-01-03,0,0,1040,0,0.0837922435776065,0.0,0,1040,fhi:git
county,Viken,2021-01-04,0,0,1040,0,0.0830416230165828,0.0,0,1040,fhi:git
county,Viken,2021-01-05,526,0,1566,0,0.125041520811508,0.0,526,1566,fhi:git
county,Viken,2021-01-06,1649,0,3215,0,0.256710401921455,0.0,1649,3215,fhi:git
county,Viken,2021-01-07,1922,0,5137,0,0.410177709073256,0.0,1922,5137,fhi:git
county,Viken,2021-01-08,282,0,5419,0,0.43269476454506,0.0,282,5419,fhi:git
county,Viken,2021-01-09,6,0,5425,0,0.433173850831694,0.0,6,5425,fhi:git
county,Viken,2021-01-10,5,0,5430,0,0.433573089403889,0.0,5,5430,fhi:git
county,Viken,2021-01-11,59,0,5489,0,0.438284104555791,0.0,59,5489,fhi:git
county,Viken,2021-01-12,788,0,6277,0,0.50120410353374,0.0,788,6277,fhi:git
county,Viken,2021-01-13,1945,0,8222,0,0.656507908117638,0.0,1945,8222,fhi:git
county,Viken,2021-01-14,1951,0,10173,0,0.81229079898817,0.0,1951,10173,fhi:git
county,Viken,2021-01-15,1051,0,11224,0,0.896210746863582,0.0,1051,11224,fhi:git
county,Viken,2021-01-16,91,0,11315,0,0.903476888877533,0.0,91,11315,fhi:git
county,Viken,2021-01-17,23,0,11338,0,0.90531338630963,0.0,23,11338,fhi:git
county,Viken,2021-01-18,144,51,11482,51,0.916811457188849,0.0040722334363901,195,11533,fhi:git
county,Viken,2021-01-19,649,384,12131,435,0.968632623859775,0.0347337557809745,1033,12566,fhi:git
county,Viken,2021-01-20,1492,342,13623,777,1.0877654138028,0.06204167411912,1834,14400,fhi:git
county,Viken,2021-01-21,1997,100,15620,877,1.24722129953752,0.0700264455630222,2097,16497,fhi:git
county,Viken,2021-01-22,820,1,16440,878,1.31269642537752,0.0701062932774612,821,17318,fhi:git
county,Viken,2021-01-23,98,0,16538,878,1.32052150139254,0.0701062932774612,98,17416,fhi:git
county,Viken,2021-01-24,0,0,16538,878,1.32052150139254,0.0701062932774612,0,17416,fhi:git
county,Viken,2021-01-25,62,0,16600,878,1.32547205968776,0.0701062932774612,62,17478,fhi:git
county,Viken,2021-01-26,563,402,17163,1280,1.37042632291693,0.102205074481948,965,18443,fhi:git
county,Viken,2021-01-27,1942,1218,19105,2498,1.52549058435751,0.199459590668677,3160,21603,fhi:git
county,Viken,2021-01-28,3105,1710,22210,4208,1.77341773769068,0.335999182359404,4815,26418,fhi:git
county,Viken,2021-01-29,1041,427,23251,4635,1.8565392084217,0.370094156424867,1468,27886,fhi:git
county,Viken,2021-01-30,11,18,23262,4653,1.85741753328053,0.371531415284769,29,27915,fhi:git
county,Viken,2021-01-31,10,3,23272,4656,1.85821601042492,0.371770958428086,13,27928,fhi:git
county,Viken,2021-02-01,36,47,23308,4703,1.86109052814472,0.37552380100672,83,28011,fhi:git
county,Viken,2021-02-02,1024,687,24332,5390,1.94285458773028,0.430379180826328,1711,29722,fhi:git
county,Viken,2021-02-03,4777,1723,29109,7113,2.32428711960549,0.567956792804763,6500,36222,fhi:git
county,Viken,2021-02-04,6643,1750,35752,8863,2.85471548662391,0.707690293073051,8393,44615,fhi:git
county,Viken,2021-02-05,3146,1100,38898,9963,3.10591639624907,0.795522778955975,4246,48861,fhi:git
county,Viken,2021-02-06,38,90,38936,10053,3.10895060939776,0.802709073255487,128,48989,fhi:git
county,Viken,2021-02-07,16,20,38952,10073,3.11022817282878,0.804306027544268,36,49025,fhi:git
county,Viken,2021-02-08,15,95,38967,10168,3.11142588854537,0.811891560415975,110,49135,fhi:git
county,Viken,2021-02-09,796,566,39763,10734,3.17498466923883,0.857085366788461,1362,50497,fhi:git
county,Viken,2021-02-10,3447,1325,43210,12059,3.45021974091014,0.962883588420165,4772,55269,fhi:git
county,Viken,2021-02-11,4849,1917,48059,13976,3.83740130822495,1.11595165699977,6766,62035,fhi:git
county,Viken,2021-02-12,2428,979,50487,14955,4.0312715588829,1.19412256943557,3407,65442,fhi:git
county,Viken,2021-02-13,24,97,50511,15052,4.03318790402944,1.20186779773616,121,65563,fhi:git
county,Viken,2021-02-14,6,1,50517,15053,4.03366699031607,1.2019476454506,7,65570,fhi:git
county,Viken,2021-02-15,358,125,50875,15178,4.06225247208524,1.21192860975547,483,66053,fhi:git
county,Viken,2021-02-16,1426,359,52301,15537,4.17611531287528,1.24059393923908,1785,67838,fhi:git
county,Viken,2021-02-17,4430,1813,56731,17350,4.52984068784015,1.38535784551703,6243,74081,fhi:git
county,Viken,2021-02-18,4894,2926,61625,20276,4.92061540230472,1.61899225796561,7820,81901,fhi:git
county,Viken,2021-02-19,3798,1282,65423,21558,5.22387702174413,1.72135702787643,5080,86981,fhi:git
county,Viken,2021-02-20,30,10,65453,21568,5.2262724531773,1.72215550502082,40,87021,fhi:git
county,Viken,2021-02-21,1,9,65454,21577,5.22635230089174,1.72287413445078,10,87031,fhi:git
county,Viken,2021-02-22,703,8,66157,21585,5.28248524414237,1.72351291616629,711,87742,fhi:git
county,Viken,2021-02-23,2125,756,68282,22341,5.45216163732529,1.78387778828219,2881,90623,fhi:git
county,Viken,2021-02-24,2469,4211,70751,26552,5.64930564427524,2.12011651378491,6680,97303,fhi:git
county,Viken,2021-02-25,2543,6272,73294,32824,5.85235838209367,2.62092137874645,8815,106118,fhi:git
county,Viken,2021-02-26,1929,2722,75223,35546,6.00638462324654,2.83826685744947,4651,110769,fhi:git
county,Viken,2021-02-27,165,89,75388,35635,6.01955949612898,2.84537330403455,254,111023,fhi:git
county,Viken,2021-02-28,416,1,75804,35636,6.05277614533562,2.84545315174898,417,111440,fhi:git
county,Viken,2021-03-01,1521,2,77325,35638,6.17422451899737,2.84561284717786,1523,112963,fhi:git
county,Viken,2021-03-02,3018,520,80343,36158,6.41520492117434,2.88713365868615,3538,116501,fhi:git
county,Viken,2021-03-03,4961,2698,85304,38856,6.81132943250633,3.10256279224264,7659,124160,fhi:git
county,Viken,2021-03-04,4400,3261,89704,42117,7.16265937603802,3.36294618902829,7661,131821,fhi:git
county,Viken,2021-03-05,2723,1782,92427,43899,7.38008470245548,3.50523481615862,4505,136326,fhi:git
county,Viken,2021-03-06,210,2,92637,43901,7.39685272248767,3.5053945115875,212,136538,fhi:git
county,Viken,2021-03-07,17,0,92654,43901,7.39821013363314,3.5053945115875,17,136555,fhi:git
county,Viken,2021-03-08,1135,22,93789,43923,7.48883728952143,3.50715116130516,1157,137712,fhi:git
county,Viken,2021-03-09,2896,716,96685,44639,7.72007627053683,3.5643221248435,3612,141324,fhi:git
county,Viken,2021-03-10,5397,3207,102082,47846,8.15101438536423,3.82039374504944,8604,149928,fhi:git
county,Viken,2021-03-11,3419,4763,105501,52609,8.42401372103125,4.2007084089225,8182,158110,fhi:git
county,Viken,2021-03-12,1220,3305,106721,55914,8.52142793264686,4.46460510514347,4525,162635,fhi:git
county,Viken,2021-03-13,7,8,106728,55922,8.52198686664793,4.46524388685898,15,162650,fhi:git
county,Viken,2021-03-14,2,5,106730,55927,8.52214656207681,4.46564312543118,7,162657,fhi:git
county,Viken,2021-03-15,35,48,106765,55975,8.52494123208217,4.46947581572425,83,162740,fhi:git
county,Viken,2021-03-16,774,303,107539,56278,8.58674336305798,4.49366967319927,1077,163817,fhi:git
county,Viken,2021-03-17,3983,413,111522,56691,8.9047768096686,4.52664677926259,4396,168213,fhi:git
county,Viken,2021-03-18,5906,435,117428,57126,9.37635741114546,4.56138053504357,6341,174554,fhi:git
county,Viken,2021-03-19,2030,365,119458,57491,9.53844827145668,4.59052495081381,2395,176949,fhi:git
county,Viken,2021-03-20,6,2,119464,57493,9.53892735774331,4.59068464624269,8,176957,fhi:git
county,Viken,2021-03-21,6,1,119470,57494,9.53940644402995,4.59076449395713,7,176964,fhi:git
county,Viken,2021-03-22,400,24,119870,57518,9.57134552980555,4.59268083910366,424,177388,fhi:git
county,Viken,2021-03-23,2468,81,122338,57599,9.76840968904106,4.59914850397322,2549,179937,fhi:git
county,Viken,2021-03-24,7379,747,129717,58346,10.3576059738866,4.65879474665917,8126,188063,fhi:git
county,Viken,2021-03-25,10201,621,139918,58967,11.1721325088791,4.7083801773258,10822,198885,fhi:git
county,Viken,2021-03-26,5899,314,145817,59281,11.6431541763549,4.73345235965966,6213,205098,fhi:git
county,Viken,2021-03-27,4,1,145821,59282,11.6434735672126,4.7335322073741,5,205103,fhi:git
county,Viken,2021-03-28,5,0,145826,59282,11.6438728057848,4.7335322073741,5,205108,fhi:git
county,Viken,2021-03-29,1315,4,147141,59286,11.7488725502721,4.73385159823185,1319,206427,fhi:git
county,Viken,2021-03-30,6058,1602,153199,60888,12.2325900043437,4.86176763676317,7660,214087,fhi:git
county,Viken,2021-03-31,9882,1811,163081,62699,13.0216451184301,5.00637184761223,11693,225780,fhi:git
county,Viken,2021-04-01,3671,477,166752,63176,13.3147660781358,5.04445920739965,4148,229928,fhi:git
county,Viken,2021-04-02,2258,264,169010,63440,13.4950622173391,5.06553900401155,2522,232450,fhi:git
county,Viken,2021-04-03,4,0,169014,63440,13.4953816081968,5.06553900401155,4,232454,fhi:git
county,Viken,2021-04-04,13,0,169027,63440,13.4964196284846,5.06553900401155,13,232467,fhi:git
county,Viken,2021-04-05,52,1,169079,63441,13.5005717096354,5.06561885172599,53,232520,fhi:git
county,Viken,2021-04-06,3383,2069,172462,65510,13.7706965275826,5.23082377290033,5452,237972,fhi:git
county,Viken,2021-04-07,11102,2503,183564,68013,14.6571658532846,5.4306826021412,13605,251577,fhi:git
county,Viken,2021-04-08,14549,1984,198113,69997,15.8188702506579,5.58910046758822,16533,268110,fhi:git
nation,Norge,2020-12-27,5,0,5,0,9.31518486915891e-05,0.0,5,5,fhi:git
nation,Norge,2020-12-28,604,0,609,0,0.0113458951706356,0.0,604,609,fhi:git
nation,Norge,2020-12-29,1067,0,1676,0,0.0312244996814207,0.0,1067,1676,fhi:git
nation,Norge,2020-12-30,427,0,2103,0,0.0391796675596824,0.0,427,2103,fhi:git
nation,Norge,2020-12-31,72,0,2175,0,0.0405210541808413,0.0,72,2175,fhi:git
nation,Norge,2021-01-01,6,0,2181,0,0.0406328363992712,0.0,6,2181,fhi:git
nation,Norge,2021-01-02,0,0,2181,0,0.0406328363992712,0.0,0,2181,fhi:git
nation,Norge,2021-01-03,3,0,2184,0,0.0406887275084861,0.0,3,2184,fhi:git
nation,Norge,2021-01-04,6,0,2190,0,0.0406204806237525,0.0,6,2190,fhi:git
nation,Norge,2021-01-05,3385,0,5575,0,0.103406018026219,0.0,3385,5575,fhi:git
nation,Norge,2021-01-06,9068,0,14643,0,0.271600775239091,0.0,9068,14643,fhi:git
nation,Norge,2021-01-07,6552,0,21195,0,0.393128350146317,0.0,6552,21195,fhi:git
nation,Norge,2021-01-08,1616,0,22811,0,0.42310218425042,0.0,1616,22811,fhi:git
nation,Norge,2021-01-09,135,0,22946,0,0.425606186480651,0.0,135,22946,fhi:git
nation,Norge,2021-01-10,108,0,23054,0,0.427609388264836,0.0,108,23054,fhi:git
nation,Norge,2021-01-11,356,0,23410,0,0.434212534886779,0.0,356,23410,fhi:git
nation,Norge,2021-01-12,4260,0,27670,0,0.513227716374079,0.0,4260,27670,fhi:git
nation,Norge,2021-01-13,9790,0,37460,0,0.69481424847752,0.0,9790,37460,fhi:git
nation,Norge,2021-01-14,8475,0,45935,0,0.852009944042042,0.0,8475,45935,fhi:git
nation,Norge,2021-01-15,4478,0,50413,0,0.935068625427048,0.0,4478,50413,fhi:git
nation,Norge,2021-01-16,747,0,51160,0,0.948924104434328,0.0,747,51160,fhi:git
nation,Norge,2021-01-17,349,5,51509,5,0.955397413903593,9.27408233419007e-05,354,51514,fhi:git
nation,Norge,2021-01-18,1284,283,52793,288,0.979213257337793,0.0053418714244934,1567,53081,fhi:git
nation,Norge,2021-01-19,4591,772,57384,1060,1.06436788133033,0.019661054548483,5363,58444,fhi:git
nation,Norge,2021-01-20,10062,693,67446,1753,1.25099951422357,0.0325149326636704,10755,69199,fhi:git
nation,Norge,2021-01-21,8441,169,75887,1922,1.40756457218936,0.0356495724926266,8610,77809,fhi:git
nation,Norge,2021-01-22,3317,7,79204,1929,1.46908883439438,0.0357794096453053,3324,81133,fhi:git
nation,Norge,2021-01-23,359,0,79563,1929,1.47574762551033,0.0357794096453053,359,81492,fhi:git
nation,Norge,2021-01-24,67,0,79630,1929,1.47699035254311,0.0357794096453053,67,81559,fhi:git
nation,Norge,2021-01-25,581,0,80211,1929,1.48776683621544,0.0357794096453053,581,82140,fhi:git
nation,Norge,2021-01-26,2279,2142,82490,4071,1.53003810349468,0.0755095783649756,4421,86561,fhi:git
nation,Norge,2021-01-27,11417,7596,93907,11667,1.74180249951357,0.216401437185991,19013,105574,fhi:git
nation,Norge,2021-01-28,10900,6575,104807,18242,1.94397749439892,0.338355619880591,17475,123049,fhi:git
nation,Norge,2021-01-29,3813,2108,108620,20350,2.01470164627945,0.377455151001536,5921,128970,fhi:git
nation,Norge,2021-01-30,148,172,108768,20522,2.01744677465037,0.380645435324497,320,129290,fhi:git
nation,Norge,2021-01-31,103,51,108871,20573,2.01935723561121,0.381591391722585,154,129444,fhi:git
nation,Norge,2021-02-01,198,304,109069,20877,2.02302977221555,0.387230033781772,502,129946,fhi:git
nation,Norge,2021-02-02,6354,3144,115423,24021,2.14088481051844,0.44554546349916,9498,139444,fhi:git
nation,Norge,2021-02-03,25148,8330,140571,32351,2.60733405559887,0.600051675186766,33478,172922,fhi:git
nation,Norge,2021-02-04,25982,8667,166553,41018,3.08925247001272,0.760808618367617,34649,207571,fhi:git
nation,Norge,2021-02-05,10629,4866,177182,45884,3.28640091227293,0.851063987643955,15495,223066,fhi:git
nation,Norge,2021-02-06,809,737,177991,46621,3.30140637748965,0.864733985004551,1546,224612,fhi:git
nation,Norge,2021-02-07,324,296,178315,46917,3.30741598284221,0.870224241746391,620,225232,fhi:git
nation,Norge,2021-02-08,123,922,178438,47839,3.30969740709642,0.887325649570638,1045,226277,fhi:git
nation,Norge,2021-02-09,5545,3242,183983,51081,3.41254698018258,0.947458799425526,8787,235064,fhi:git
nation,Norge,2021-02-10,22999,8666,206982,59747,3.83913621939066,1.10819719444171,31665,266729,fhi:git
nation,Norge,2021-02-11,20945,8581,227927,68328,4.22762752836988,1.26735899546108,29526,296255,fhi:git
nation,Norge,2021-02-12,8052,3613,235979,71941,4.37697735027968,1.33437351440794,11665,307920,fhi:git
nation,Norge,2021-02-13,894,306,236873,72247,4.39355940949321,1.34004925279646,1200,309120,fhi:git
nation,Norge,2021-02-14,110,4,236983,72251,4.39559970760673,1.34012344545513,114,309234,fhi:git
nation,Norge,2021-02-15,805,751,237788,73002,4.41053098016478,1.35405311712109,1556,310790,fhi:git
nation,Norge,2021-02-16,6026,2176,243814,75178,4.52230222045644,1.39441392343948,8202,318992,fhi:git
nation,Norge,2021-02-17,21818,10206,265632,85384,4.92698607719116,1.58371649204497,32024,351016,fhi:git
nation,Norge,2021-02-18,18899,10821,284531,96205,5.27752784125887,1.78442618192151,29720,380736,fhi:git
nation,Norge,2021-02-19,10737,4799,295268,101004,5.47667948530327,1.87343882416507,15536,396272,fhi:git
nation,Norge,2021-02-20,502,173,295770,101177,5.4859906639668,1.8766476566527,675,396947,fhi:git
nation,Norge,2021-02-21,58,103,295828,101280,5.48706645751756,1.87855811761354,161,397108,fhi:git
nation,Norge,2021-02-22,2573,141,298401,101421,5.5347908852093,1.88117340883178,2714,399822,fhi:git
nation,Norge,2021-02-23,5749,5206,304150,106627,5.64142428388782,1.97773515409537,10955,410777,fhi:git
nation,Norge,2021-02-24,11055,22361,315205,128988,5.84647424429676,2.39249066424502,33416,444193,fhi:git
nation,Norge,2021-02-25,11151,25148,326356,154136,6.05330482851387,2.85893990932544,36299,480492,fhi:git
nation,Norge,2021-02-26,8335,9935,334691,164071,6.20790378102482,3.0432159253058,18270,498762,fhi:git
nation,Norge,2021-02-27,440,203,335131,164274,6.21606497347891,3.04698120273348,643,499405,fhi:git
nation,Norge,2021-02-28,538,159,335669,164433,6.2260438860705,3.04993036091575,697,500102,fhi:git
nation,Norge,2021-03-01,5927,63,341596,164496,6.33597885805999,3.05109889528986,5990,506092,fhi:git
nation,Norge,2021-03-02,10534,3824,352130,168320,6.5313652246767,3.12202707698175,14358,520450,fhi:git
nation,Norge,2021-03-03,17658,18072,369788,186392,6.85888871639096,3.45722950886871,35730,556180,fhi:git
nation,Norge,2021-03-04,16260,18479,386048,204871,7.16048187389882,3.79998104377571,34739,590919,fhi:git
nation,Norge,2021-03-05,11889,6539,397937,211410,7.38100100364119,3.92126749254225,18428,609347,fhi:git
nation,Norge,2021-03-06,382,479,398319,211889,7.38808640254451,3.9301520634184,861,610208,fhi:git
nation,Norge,2021-03-07,92,2,398411,211891,7.389792833694,3.93018915974774,94,610302,fhi:git
nation,Norge,2021-03-08,4920,46,403331,211937,7.48104980386243,3.93104237532248,4966,615268,fhi:git
nation,Norge,2021-03-09,12450,4272,415781,216209,7.71197445398377,4.0102801347858,16722,631990,fhi:git
nation,Norge,2021-03-10,21017,17207,436798,233416,8.10180123081911,4.32943840423462,38224,670214,fhi:git
nation,Norge,2021-03-11,11958,16573,448756,249989,8.3236001839236,4.63683713728369,28531,698745,fhi:git
nation,Norge,2021-03-12,2317,8306,451073,258295,8.36657628146024,4.79089819301925,10623,709368,fhi:git
nation,Norge,2021-03-13,34,305,451107,258600,8.36720691905896,4.79655538324311,339,709707,fhi:git
nation,Norge,2021-03-14,3,109,451110,258709,8.36726256355297,4.79857713319196,112,709819,fhi:git
nation,Norge,2021-03-15,99,437,451209,259146,8.36909883185514,4.80668268115204,536,710355,fhi:git
nation,Norge,2021-03-16,5648,627,456857,259773,8.47385886590215,4.81831238039912,6275,716630,fhi:git
nation,Norge,2021-03-17,23028,1556,479885,261329,8.90098600188561,4.84717332462312,24584,741214,fhi:git
nation,Norge,2021-03-18,20988,1408,500873,262737,9.29027488194557,4.8732891404762,22396,763610,fhi:git
nation,Norge,2021-03-19,6753,970,507626,263707,9.41553063795114,4.89128086020452,7723,771333,fhi:git
nation,Norge,2021-03-20,458,22,508084,263729,9.42402569736926,4.89168891982723,480,771813,fhi:git
nation,Norge,2021-03-21,187,68,508271,263797,9.42749420416225,4.89295019502468,255,772068,fhi:git
nation,Norge,2021-03-22,1504,85,509775,263882,9.45539064382349,4.89452678902149,1589,773657,fhi:git
nation,Norge,2021-03-23,13093,953,522868,264835,9.69824176382659,4.91220318995046,14046,787703,fhi:git
nation,Norge,2021-03-24,39062,3661,561930,268496,10.4227701721029,4.9801080208014,42723,830426,fhi:git
nation,Norge,2021-03-25,38653,2331,600583,270827,11.1397123810298,5.02334379264339,40984,871410,fhi:git
nation,Norge,2021-03-26,17319,1143,617902,271970,11.4609480449214,5.04454434485935,18462,889872,fhi:git
nation,Norge,2021-03-27,593,6,618495,271976,11.4719471065698,5.04465563384736,599,890471,fhi:git
nation,Norge,2021-03-28,329,3,618824,271979,11.4780494527457,5.04471127834136,332,890803,fhi:git
nation,Norge,2021-03-29,4728,26,623552,272005,11.5657451752978,5.04519353062274,4754,895557,fhi:git
nation,Norge,2021-03-30,31959,4007,655511,276012,12.1585259699345,5.11951602644894,35966,931523,fhi:git
nation,Norge,2021-03-31,36329,6919,691840,282931,12.8323622441721,5.24785077778946,43248,974771,fhi:git
nation,Norge,2021-04-01,9399,1470,701239,284401,13.0066964438902,5.27511657985198,10869,985640,fhi:git
nation,Norge,2021-04-02,4268,682,705507,285083,13.0858600106949,5.28776642815582,4950,990590,fhi:git
nation,Norge,2021-04-03,260,6,705767,285089,13.0906825335087,5.28787771714383,266,990856,fhi:git
nation,Norge,2021-04-04,388,43,706155,285132,13.0978792214,5.28867528822457,431,991287,fhi:git
nation,Norge,2021-04-05,1308,56,707463,285188,13.1221402207862,5.289713985446,1364,992651,fhi:git
nation,Norge,2021-04-06,18485,2531,725948,287719,13.4650030446812,5.33665939022167,21016,1013667,fhi:git
nation,Norge,2021-04-07,57834,3616,783782,291335,14.5377176001123,5.40372955366253,61450,1075117,fhi:git
nation,Norge,2021-04-08,52188,4023,835970,295358,15.5057092178258,5.47834882012342,56211,1131328,fhi:git
