granularity_geo,location_name,date,new_dose_1,new_dose_2,total_dose_1,total_dose_2,total_pr100_dose_1,total_pr100_dose_2,new_doses,total_doses,source
county,Agder,2020-12-27,0,0,0,0,0.0,0.0,0,0,fhi:git
county,Agder,2020-12-28,0,0,0,0,0.0,0.0,0,0,fhi:git
county,Agder,2020-12-29,0,0,0,0,0.0,0.0,0,0,fhi:git
county,Agder,2020-12-30,0,0,0,0,0.0,0.0,0,0,fhi:git
county,Agder,2020-12-31,0,0,0,0,0.0,0.0,0,0,fhi:git
county,Agder,2021-01-01,0,0,0,0,0.0,0.0,0,0,fhi:git
county,Agder,2021-01-02,0,0,0,0,0.0,0.0,0,0,fhi:git
county,Agder,2021-01-03,3,0,3,0,0.0009764639635974,0.0,3,3,fhi:git
county,Agder,2021-01-04,0,0,3,0,0.0009713673290312,0.0,0,3,fhi:git
county,Agder,2021-01-05,79,0,82,0,0.026550706993521,0.0,79,82,fhi:git
county,Agder,2021-01-06,791,0,873,0,0.282667892748095,0.0,791,873,fhi:git
county,Agder,2021-01-07,230,0,1103,0,0.357139387973825,0.0,230,1103,fhi:git
county,Agder,2021-01-08,49,0,1152,0,0.373005054348002,0.0,49,1152,fhi:git
county,Agder,2021-01-09,0,0,1152,0,0.373005054348002,0.0,0,1152,fhi:git
county,Agder,2021-01-10,0,0,1152,0,0.373005054348002,0.0,0,1152,fhi:git
county,Agder,2021-01-11,1,0,1153,0,0.373328843457679,0.0,1,1153,fhi:git
county,Agder,2021-01-12,226,0,1379,0,0.4465051822447,0.0,226,1379,fhi:git
county,Agder,2021-01-13,850,0,2229,0,0.721725925470223,0.0,850,2229,fhi:git
county,Agder,2021-01-14,514,0,2743,0,0.888153527844245,0.0,514,2743,fhi:git
county,Agder,2021-01-15,119,0,2862,0,0.926684431895818,0.0,119,2862,fhi:git
county,Agder,2021-01-16,1,0,2863,0,0.927008221005495,0.0,1,2863,fhi:git
county,Agder,2021-01-17,2,0,2865,0,0.927655799224849,0.0,2,2865,fhi:git
county,Agder,2021-01-18,15,0,2880,0,0.932512635870005,0.0,15,2880,fhi:git
county,Agder,2021-01-19,346,0,3226,0,1.04454366781828,0.0,346,3226,fhi:git
county,Agder,2021-01-20,460,0,3686,0,1.19348665826974,0.0,460,3686,fhi:git
county,Agder,2021-01-21,337,0,4023,0,1.30260358823091,0.0,337,4023,fhi:git
county,Agder,2021-01-22,67,0,4090,0,1.32429745857928,0.0,67,4090,fhi:git
county,Agder,2021-01-23,2,0,4092,0,1.32494503679863,0.0,2,4092,fhi:git
county,Agder,2021-01-24,0,0,4092,0,1.32494503679863,0.0,0,4092,fhi:git
county,Agder,2021-01-25,3,0,4095,0,1.32591640412766,0.0,3,4095,fhi:git
county,Agder,2021-01-26,63,66,4158,66,1.34631511803732,0.0213700812386876,129,4224,fhi:git
county,Agder,2021-01-27,567,681,4725,747,1.52990354322423,0.241870464928783,1248,5472,fhi:git
county,Agder,2021-01-28,952,248,5677,995,1.83815077563681,0.3221701641287,1200,6672,fhi:git
county,Agder,2021-01-29,204,61,5881,1056,1.90420375401094,0.341921299819002,265,6937,fhi:git
county,Agder,2021-01-30,32,0,5913,1056,1.9145650055206,0.341921299819002,32,6969,fhi:git
county,Agder,2021-01-31,24,0,5937,1056,1.92233594415285,0.341921299819002,24,6993,fhi:git
county,Agder,2021-02-01,1,2,5938,1058,1.92265973326253,0.342568878038356,3,6996,fhi:git
county,Agder,2021-02-02,203,170,6141,1228,1.98838892252698,0.397613026683461,373,7369,fhi:git
county,Agder,2021-02-03,1333,593,7474,1821,2.41999980572653,0.589619968721972,1926,9295,fhi:git
county,Agder,2021-02-04,1710,500,9184,2321,2.97367918327435,0.751514523560515,2210,11505,fhi:git
county,Agder,2021-02-05,620,135,9804,2456,3.17442843127414,0.795226053366921,755,12260,fhi:git
county,Agder,2021-02-06,512,2,10316,2458,3.34020845542881,0.795873631586275,514,12774,fhi:git
county,Agder,2021-02-07,87,2,10403,2460,3.36837810797072,0.796521209805629,89,12863,fhi:git
county,Agder,2021-02-08,13,2,10416,2462,3.37258736639652,0.797168788024984,15,12878,fhi:git
county,Agder,2021-02-09,189,254,10605,2716,3.43378350812549,0.879411221882963,443,13321,fhi:git
county,Agder,2021-02-10,1151,371,11756,3087,3.80646477336381,0.999536981573162,1522,14843,fhi:git
county,Agder,2021-02-11,1011,410,12767,3497,4.13381556324735,1.13229051654077,1421,16264,fhi:git
county,Agder,2021-02-12,358,69,13125,3566,4.24973206451174,1.15463196510849,427,16691,fhi:git
county,Agder,2021-02-13,510,3,13635,3569,4.41486451044706,1.15560333243752,513,17204,fhi:git
county,Agder,2021-02-14,0,0,13635,3569,4.41486451044706,1.15560333243752,0,17204,fhi:git
county,Agder,2021-02-15,1,1,13636,3570,4.41518829955673,1.15592712154719,2,17206,fhi:git
county,Agder,2021-02-16,141,117,13777,3687,4.4608425640212,1.19381044737941,258,17464,fhi:git
county,Agder,2021-02-17,1219,435,14996,4122,4.85554148871757,1.33465871008895,1654,19118,fhi:git
county,Agder,2021-02-18,1090,820,16086,4942,5.20847161826559,1.60016578002415,1910,21028,fhi:git
county,Agder,2021-02-19,721,343,16807,5285,5.44192356634277,1.7112254446434,1064,22092,fhi:git
county,Agder,2021-02-20,355,37,17162,5322,5.55686870027814,1.72320564170145,392,22484,fhi:git
county,Agder,2021-02-21,52,23,17214,5345,5.57370573398134,1.73065279122402,75,22559,fhi:git
county,Agder,2021-02-22,223,1,17437,5346,5.64591070543933,1.7309765803337,224,22783,fhi:git
county,Agder,2021-02-23,294,201,17731,5547,5.7411047036844,1.79605819137879,495,23278,fhi:git
county,Agder,2021-02-24,976,1111,18707,6658,6.05712287472923,2.15578789223003,2087,25365,fhi:git
county,Agder,2021-02-25,717,1568,19424,8226,6.2892796663677,2.6634892162037,2285,27650,fhi:git
county,Agder,2021-02-26,399,466,19823,8692,6.41847152112886,2.81437494131322,865,28515,fhi:git
county,Agder,2021-02-27,0,1,19823,8693,6.41847152112886,2.8146987304229,1,28516,fhi:git
county,Agder,2021-02-28,10,82,19833,8775,6.42170941222563,2.84124943741642,92,28608,fhi:git
county,Agder,2021-03-01,263,0,20096,8775,6.5068659480707,2.84124943741642,263,28871,fhi:git
county,Agder,2021-03-02,578,192,20674,8967,6.69401605346406,2.90341694647442,770,29641,fhi:git
county,Agder,2021-03-03,635,878,21309,9845,6.89962213810901,3.1877037847709,1513,31154,fhi:git
county,Agder,2021-03-04,795,1070,22104,10915,7.15703448030229,3.53415813212538,1865,33019,fhi:git
county,Agder,2021-03-05,961,383,23065,11298,7.46819581470197,3.65816936113171,1344,34363,fhi:git
county,Agder,2021-03-06,36,405,23101,11703,7.47985222265034,3.78930395055093,441,34804,fhi:git
county,Agder,2021-03-07,3,1,23104,11704,7.48082358997937,3.7896277396606,4,34808,fhi:git
county,Agder,2021-03-08,226,0,23330,11704,7.5539999287664,3.7896277396606,226,35034,fhi:git
county,Agder,2021-03-09,723,141,24053,11845,7.78809945506293,3.83528200412507,864,35898,fhi:git
county,Agder,2021-03-10,1035,784,25088,12629,8.12322118357871,4.08913266611191,1819,37717,fhi:git
county,Agder,2021-03-11,647,813,25735,13442,8.33271273753979,4.35237321227938,1460,39177,fhi:git
county,Agder,2021-03-12,98,326,25833,13768,8.36444407028814,4.45792846203411,424,39601,fhi:git
county,Agder,2021-03-13,0,0,25833,13768,8.36444407028814,4.45792846203411,0,39601,fhi:git
county,Agder,2021-03-14,0,0,25833,13768,8.36444407028814,4.45792846203411,0,39601,fhi:git
county,Agder,2021-03-15,0,3,25833,13771,8.36444407028814,4.45889982936314,3,39604,fhi:git
county,Agder,2021-03-16,240,14,26073,13785,8.44215345661064,4.46343287689862,254,39858,fhi:git
county,Agder,2021-03-17,1608,48,27681,13833,8.96280634497139,4.47897475416312,1656,41514,fhi:git
county,Agder,2021-03-18,1247,92,28928,13925,9.36657136473872,4.50876335225341,1339,42853,fhi:git
county,Agder,2021-03-19,265,41,29193,13966,9.45237547880315,4.52203870575017,306,43159,fhi:git
county,Agder,2021-03-20,0,0,29193,13966,9.45237547880315,4.52203870575017,0,43159,fhi:git
county,Agder,2021-03-21,17,53,29210,14019,9.45787989366766,4.53919952856306,70,43229,fhi:git
county,Agder,2021-03-22,9,1,29219,14020,9.46079399565475,4.53952331767273,10,43239,fhi:git
county,Agder,2021-03-23,314,14,29533,14034,9.56246377609336,4.54405636520821,328,43567,fhi:git
county,Agder,2021-03-24,2267,75,31800,14109,10.2964936877313,4.56834054843399,2342,45909,fhi:git
county,Agder,2021-03-25,2037,53,33837,14162,10.9560521041435,4.58550137124688,2090,47999,fhi:git
county,Agder,2021-03-26,776,12,34613,14174,11.2073124532529,4.58938684056301,788,48787,fhi:git
county,Agder,2021-03-27,0,0,34613,14174,11.2073124532529,4.58938684056301,0,48787,fhi:git
county,Agder,2021-03-28,173,1,34786,14175,11.2633279692271,4.58971062967268,174,48961,fhi:git
county,Agder,2021-03-29,107,0,34893,14175,11.2979734039625,4.58971062967268,107,49068,fhi:git
county,Agder,2021-03-30,687,71,35580,14246,11.5204165223107,4.61269965645975,758,49826,fhi:git
county,Agder,2021-03-31,3370,402,38950,14648,12.6115858219225,4.74286287854994,3772,53598,fhi:git
county,Agder,2021-04-01,237,49,39187,14697,12.6883238409159,4.75872854492412,286,53884,fhi:git
county,Agder,2021-04-02,1,0,39188,14697,12.6886476300256,4.75872854492412,1,53885,fhi:git
county,Agder,2021-04-03,12,0,39200,14697,12.6925330993417,4.75872854492412,12,53897,fhi:git
county,Agder,2021-04-04,1,5,39201,14702,12.6928568884514,4.76034749047251,6,53903,fhi:git
county,Agder,2021-04-05,0,0,39201,14702,12.6928568884514,4.76034749047251,0,53903,fhi:git
county,Agder,2021-04-06,609,1,39810,14703,12.8900444562448,4.76067127958218,610,54513,fhi:git
county,Agder,2021-04-07,2885,55,42695,14758,13.8241760376632,4.77847968061442,2940,57453,fhi:git
county,Innlandet,2020-12-27,0,0,0,0,0.0,0.0,0,0,fhi:git
county,Innlandet,2020-12-28,272,0,272,0,0.0732393607711674,0.0,272,272,fhi:git
county,Innlandet,2020-12-29,260,0,532,0,0.143247573273019,0.0,260,532,fhi:git
county,Innlandet,2020-12-30,149,0,681,0,0.183367664283695,0.0,149,681,fhi:git
county,Innlandet,2020-12-31,0,0,681,0,0.183367664283695,0.0,0,681,fhi:git
county,Innlandet,2021-01-01,0,0,681,0,0.183367664283695,0.0,0,681,fhi:git
county,Innlandet,2021-01-02,0,0,681,0,0.183367664283695,0.0,0,681,fhi:git
county,Innlandet,2021-01-03,0,0,681,0,0.183367664283695,0.0,0,681,fhi:git
county,Innlandet,2021-01-04,0,0,681,0,0.183754583745949,0.0,0,681,fhi:git
county,Innlandet,2021-01-05,271,0,952,0,0.256878654517098,0.0,271,952,fhi:git
county,Innlandet,2021-01-06,703,0,1655,0,0.446569509690963,0.0,703,1655,fhi:git
county,Innlandet,2021-01-07,696,0,2351,0,0.634371551228673,0.0,696,2351,fhi:git
county,Innlandet,2021-01-08,75,0,2426,0,0.654608840187478,0.0,75,2426,fhi:git
county,Innlandet,2021-01-09,0,0,2426,0,0.654608840187478,0.0,0,2426,fhi:git
county,Innlandet,2021-01-10,0,0,2426,0,0.654608840187478,0.0,0,2426,fhi:git
county,Innlandet,2021-01-11,50,0,2476,0,0.668100366160015,0.0,50,2476,fhi:git
county,Innlandet,2021-01-12,403,0,2879,0,0.77684206549866,0.0,403,2879,fhi:git
county,Innlandet,2021-01-13,993,0,3872,0,1.04478377131324,0.0,993,3872,fhi:git
county,Innlandet,2021-01-14,958,0,4830,0,1.30328140894704,0.0,958,4830,fhi:git
county,Innlandet,2021-01-15,280,0,5110,0,1.37883395439325,0.0,280,5110,fhi:git
county,Innlandet,2021-01-16,4,0,5114,0,1.37991327647105,0.0,4,5114,fhi:git
county,Innlandet,2021-01-17,0,0,5114,0,1.37991327647105,0.0,0,5114,fhi:git
county,Innlandet,2021-01-18,62,0,5176,0,1.39664276867699,0.0,62,5176,fhi:git
county,Innlandet,2021-01-19,331,318,5507,318,1.48595667061519,0.0858061051853331,649,5825,fhi:git
county,Innlandet,2021-01-20,662,252,6169,570,1.66458447449157,0.153803396086918,914,6739,fhi:git
county,Innlandet,2021-01-21,834,48,7003,618,1.88962312771348,0.166755261020553,882,7621,fhi:git
county,Innlandet,2021-01-22,239,0,7242,618,1.95411262186221,0.166755261020553,239,7860,fhi:git
county,Innlandet,2021-01-23,6,0,7248,618,1.95573160497891,0.166755261020553,6,7866,fhi:git
county,Innlandet,2021-01-24,0,0,7248,618,1.95573160497891,0.166755261020553,0,7866,fhi:git
county,Innlandet,2021-01-25,1,0,7249,618,1.95600143549836,0.166755261020553,1,7867,fhi:git
county,Innlandet,2021-01-26,152,131,7401,749,1.99701567445487,0.202103059068599,283,8150,fhi:git
county,Innlandet,2021-01-27,935,604,8336,1353,2.24930721014131,0.365080692816842,1539,9689,fhi:git
county,Innlandet,2021-01-28,903,708,9239,2061,2.49296416920532,0.556120700587961,1611,11300,fhi:git
county,Innlandet,2021-01-29,319,132,9558,2193,2.57904010491011,0.591738329155457,451,11751,fhi:git
county,Innlandet,2021-01-30,2,0,9560,2193,2.57957976594901,0.591738329155457,2,11753,fhi:git
county,Innlandet,2021-01-31,1,0,9561,2193,2.57984959646846,0.591738329155457,1,11754,fhi:git
county,Innlandet,2021-02-01,9,49,9570,2242,2.58227807114351,0.604960024608543,58,11812,fhi:git
county,Innlandet,2021-02-02,611,341,10181,2583,2.74714451852791,0.696972231741243,952,12764,fhi:git
county,Innlandet,2021-02-03,2310,872,12491,3455,3.37045301845911,0.932264444702282,3182,15946,fhi:git
county,Innlandet,2021-02-04,2656,998,15147,4453,4.08712287812025,1.20155530311411,3654,19600,fhi:git
county,Innlandet,2021-02-05,815,271,15962,4724,4.3070347514726,1.27467937388526,1086,20686,fhi:git
county,Innlandet,2021-02-06,7,4,15969,4728,4.30892356510875,1.27575869596307,11,20697,fhi:git
county,Innlandet,2021-02-07,0,0,15969,4728,4.30892356510875,1.27575869596307,0,20697,fhi:git
county,Innlandet,2021-02-08,2,62,15971,4790,4.30946322614766,1.29248818816901,64,20761,fhi:git
county,Innlandet,2021-02-09,257,269,16228,5059,4.3788096696465,1.36507259790126,526,21287,fhi:git
county,Innlandet,2021-02-10,2056,589,18284,5648,4.9335812176372,1.52400277385774,2645,23932,fhi:git
county,Innlandet,2021-02-11,2236,848,20520,6496,5.53692225912904,1.75281905435196,3084,27016,fhi:git
county,Innlandet,2021-02-12,430,283,20950,6779,5.65294938249286,1.82918109135652,713,27729,fhi:git
county,Innlandet,2021-02-13,0,5,20950,6784,5.65294938249286,1.83053024395377,5,27734,fhi:git
county,Innlandet,2021-02-14,1,1,20951,6785,5.65321921301231,1.83080007447322,2,27736,fhi:git
county,Innlandet,2021-02-15,86,14,21037,6799,5.67642463768507,1.83457770174553,100,27836,fhi:git
county,Innlandet,2021-02-16,530,92,21567,6891,5.81943481299396,1.859402109535,622,28458,fhi:git
county,Innlandet,2021-02-17,1572,783,23139,7674,6.24360838957051,2.07067940626493,2355,30813,fhi:git
county,Innlandet,2021-02-18,1466,903,24605,8577,6.63917993108529,2.31433636532894,2369,33182,fhi:git
county,Innlandet,2021-02-19,540,296,25145,8873,6.78488841158868,2.39420619908635,836,34018,fhi:git
county,Innlandet,2021-02-20,0,3,25145,8876,6.78488841158868,2.39501569064471,3,34021,fhi:git
county,Innlandet,2021-02-21,0,1,25145,8877,6.78488841158868,2.39528552116416,1,34022,fhi:git
county,Innlandet,2021-02-22,284,3,25429,8880,6.86152027911269,2.39609501272251,287,34309,fhi:git
county,Innlandet,2021-02-23,320,307,25749,9187,6.94786604533692,2.47893298219388,627,34936,fhi:git
county,Innlandet,2021-02-24,852,2319,26601,11506,7.17776164790895,3.10466995680013,3171,38107,fhi:git
county,Innlandet,2021-02-25,1750,2453,28351,13959,7.64996505694773,3.76656422101278,4203,42310,fhi:git
county,Innlandet,2021-02-26,677,814,29028,14773,7.83264031861588,3.98620626384568,1491,43801,fhi:git
county,Innlandet,2021-02-27,3,1,29031,14774,7.83344981017423,3.98647609436513,4,43805,fhi:git
county,Innlandet,2021-02-28,3,6,29034,14780,7.83425930173258,3.98809507748183,9,43814,fhi:git
county,Innlandet,2021-03-01,189,7,29223,14787,7.88525726990877,3.98998389111799,196,44010,fhi:git
county,Innlandet,2021-03-02,530,159,29753,14946,8.02826744521766,4.03288694371066,689,44699,fhi:git
county,Innlandet,2021-03-03,1598,1971,31351,16917,8.45945661529993,4.56472289754805,3569,48268,fhi:git
county,Innlandet,2021-03-04,1521,2285,32872,19202,8.86986883538449,5.18128563449298,3806,52074,fhi:git
county,Innlandet,2021-03-05,547,421,33419,19623,9.01746612952405,5.29488428318173,968,53042,fhi:git
county,Innlandet,2021-03-06,7,3,33426,19626,9.0193549431602,5.29569377474009,10,53052,fhi:git
county,Innlandet,2021-03-07,0,0,33426,19626,9.0193549431602,5.29569377474009,0,53052,fhi:git
county,Innlandet,2021-03-08,112,0,33538,19626,9.04957596133868,5.29569377474009,112,53164,fhi:git
county,Innlandet,2021-03-09,936,311,34474,19937,9.30213732754457,5.37961106628926,1247,54411,fhi:git
county,Innlandet,2021-03-10,2027,1306,36501,21243,9.84908379047121,5.73200972469192,3333,57744,fhi:git
county,Innlandet,2021-03-11,1014,968,37515,22211,10.1226919371942,5.99320566752023,1982,59726,fhi:git
county,Innlandet,2021-03-12,43,180,37558,22391,10.1342946495306,6.04177516102136,223,59949,fhi:git
county,Innlandet,2021-03-13,0,0,37558,22391,10.1342946495306,6.04177516102136,0,59949,fhi:git
county,Innlandet,2021-03-14,0,7,37558,22398,10.1342946495306,6.04366397465752,7,59956,fhi:git
county,Innlandet,2021-03-15,25,3,37583,22401,10.1410404125169,6.04447346621587,28,59984,fhi:git
county,Innlandet,2021-03-16,364,9,37947,22410,10.239258721597,6.04690194089093,373,60357,fhi:git
county,Innlandet,2021-03-17,1803,153,39750,22563,10.7257631481666,6.08818601036689,1956,62313,fhi:git
county,Innlandet,2021-03-18,1650,104,41400,22667,11.1709835052603,6.11624838438977,1754,64067,fhi:git
county,Innlandet,2021-03-19,190,20,41590,22687,11.222251303956,6.12164499477878,210,64277,fhi:git
county,Innlandet,2021-03-20,0,0,41590,22687,11.222251303956,6.12164499477878,0,64277,fhi:git
county,Innlandet,2021-03-21,1,0,41591,22687,11.2225211344754,6.12164499477878,1,64278,fhi:git
county,Innlandet,2021-03-22,98,9,41689,22696,11.2489645253816,6.12407346945384,107,64385,fhi:git
county,Innlandet,2021-03-23,809,51,42498,22747,11.4672574156173,6.13783482594582,860,65245,fhi:git
county,Innlandet,2021-03-24,3237,521,45735,23268,12.3406988070793,6.27841652657966,3758,69003,fhi:git
county,Innlandet,2021-03-25,3198,321,48933,23589,13.2036168082827,6.36503212332334,3519,72522,fhi:git
county,Innlandet,2021-03-26,671,52,49604,23641,13.3846730868342,6.37906331033478,723,73245,fhi:git
county,Innlandet,2021-03-27,0,0,49604,23641,13.3846730868342,6.37906331033478,0,73245,fhi:git
county,Innlandet,2021-03-28,0,0,49604,23641,13.3846730868342,6.37906331033478,0,73245,fhi:git
county,Innlandet,2021-03-29,397,2,50001,23643,13.4917958030561,6.37960297137368,399,73644,fhi:git
county,Innlandet,2021-03-30,2795,227,52796,23870,14.2459721049209,6.440854499289,3022,76666,fhi:git
county,Innlandet,2021-03-31,2843,560,55639,24430,15.0131002717193,6.59195959018141,3403,80069,fhi:git
county,Innlandet,2021-04-01,88,18,55727,24448,15.036845357431,6.59681653953152,106,80175,fhi:git
county,Innlandet,2021-04-02,6,1,55733,24449,15.0384643405477,6.59708637005097,7,80182,fhi:git
county,Innlandet,2021-04-03,0,6,55733,24455,15.0384643405477,6.59870535316767,6,80188,fhi:git
county,Innlandet,2021-04-04,0,0,55733,24455,15.0384643405477,6.59870535316767,0,80188,fhi:git
county,Innlandet,2021-04-05,0,0,55733,24455,15.0384643405477,6.59870535316767,0,80188,fhi:git
county,Innlandet,2021-04-06,508,31,56241,24486,15.1755382444287,6.60707009927065,539,80727,fhi:git
county,Innlandet,2021-04-07,4183,91,60424,24577,16.3042393072911,6.63162467654067,4274,85001,fhi:git
county,Møre og Romsdal,2020-12-27,0,0,0,0,0.0,0.0,0,0,fhi:git
county,Møre og Romsdal,2020-12-28,1,0,1,0,0.0003770198840286,0.0,1,1,fhi:git
county,Møre og Romsdal,2020-12-29,0,0,1,0,0.0003770198840286,0.0,0,1,fhi:git
county,Møre og Romsdal,2020-12-30,0,0,1,0,0.0003770198840286,0.0,0,1,fhi:git
county,Møre og Romsdal,2020-12-31,0,0,1,0,0.0003770198840286,0.0,0,1,fhi:git
county,Møre og Romsdal,2021-01-01,0,0,1,0,0.0003770198840286,0.0,0,1,fhi:git
county,Møre og Romsdal,2021-01-02,0,0,1,0,0.0003770198840286,0.0,0,1,fhi:git
county,Møre og Romsdal,2021-01-03,0,0,1,0,0.0003770198840286,0.0,0,1,fhi:git
county,Møre og Romsdal,2021-01-04,0,0,1,0,0.0003765854246377,0.0,0,1,fhi:git
county,Møre og Romsdal,2021-01-05,186,0,187,0,0.0704214744072545,0.0,186,187,fhi:git
county,Møre og Romsdal,2021-01-06,496,0,683,0,0.257207845027566,0.0,496,683,fhi:git
county,Møre og Romsdal,2021-01-07,457,0,1140,0,0.429307384087006,0.0,457,1140,fhi:git
county,Møre og Romsdal,2021-01-08,36,0,1176,0,0.442864459373964,0.0,36,1176,fhi:git
county,Møre og Romsdal,2021-01-09,1,0,1177,0,0.443241044798602,0.0,1,1177,fhi:git
county,Møre og Romsdal,2021-01-10,0,0,1177,0,0.443241044798602,0.0,0,1177,fhi:git
county,Møre og Romsdal,2021-01-11,1,0,1178,0,0.44361763022324,0.0,1,1178,fhi:git
county,Møre og Romsdal,2021-01-12,225,0,1403,0,0.528349350766728,0.0,225,1403,fhi:git
county,Møre og Romsdal,2021-01-13,387,0,1790,0,0.674087910101528,0.0,387,1790,fhi:git
county,Møre og Romsdal,2021-01-14,409,0,2199,0,0.828111348778357,0.0,409,2199,fhi:git
county,Møre og Romsdal,2021-01-15,150,0,2349,0,0.884599162474016,0.0,150,2349,fhi:git
county,Møre og Romsdal,2021-01-16,1,0,2350,0,0.884975747898653,0.0,1,2350,fhi:git
county,Møre og Romsdal,2021-01-17,2,0,2352,0,0.885728918747929,0.0,2,2352,fhi:git
county,Møre og Romsdal,2021-01-18,11,0,2363,0,0.889871358418944,0.0,11,2363,fhi:git
county,Møre og Romsdal,2021-01-19,203,0,2566,0,0.966318199620402,0.0,203,2566,fhi:git
county,Møre og Romsdal,2021-01-20,500,0,3066,0,1.15461091193926,0.0,500,3066,fhi:git
county,Møre og Romsdal,2021-01-21,800,0,3866,0,1.45587925164944,0.0,800,3866,fhi:git
county,Møre og Romsdal,2021-01-22,212,0,4078,0,1.53571536167264,0.0,212,4078,fhi:git
county,Møre og Romsdal,2021-01-23,0,0,4078,0,1.53571536167264,0.0,0,4078,fhi:git
county,Møre og Romsdal,2021-01-24,0,0,4078,0,1.53571536167264,0.0,0,4078,fhi:git
county,Møre og Romsdal,2021-01-25,3,0,4081,0,1.53684511794656,0.0,3,4081,fhi:git
county,Møre og Romsdal,2021-01-26,78,129,4159,129,1.5662187810683,0.0485795197782665,207,4288,fhi:git
county,Møre og Romsdal,2021-01-27,542,358,4701,487,1.77032808122194,0.183397101798572,900,5188,fhi:git
county,Møre og Romsdal,2021-01-28,492,509,5193,996,1.9556081101437,0.375079082939174,1001,6189,fhi:git
county,Møre og Romsdal,2021-01-29,99,78,5292,1074,1.99289006718284,0.404452746060916,177,6366,fhi:git
county,Møre og Romsdal,2021-01-30,0,1,5292,1075,1.99289006718284,0.404829331485554,1,6367,fhi:git
county,Møre og Romsdal,2021-01-31,0,0,5292,1075,1.99289006718284,0.404829331485554,0,6367,fhi:git
county,Møre og Romsdal,2021-02-01,0,0,5292,1075,1.99289006718284,0.404829331485554,0,6367,fhi:git
county,Møre og Romsdal,2021-02-02,291,193,5583,1268,2.10247642575242,0.477510318440635,484,6851,fhi:git
county,Møre og Romsdal,2021-02-03,1063,312,6646,1580,2.50278673214232,0.595004970927605,1375,8226,fhi:git
county,Møre og Romsdal,2021-02-04,1546,462,8192,2042,3.08498779863224,0.768987437110234,2008,10234,fhi:git
county,Møre og Romsdal,2021-02-05,219,154,8411,2196,3.1674600066279,0.826981592504444,373,10607,fhi:git
county,Møre og Romsdal,2021-02-06,1,2,8412,2198,3.16783659205254,0.827734763353719,3,10610,fhi:git
county,Møre og Romsdal,2021-02-07,0,1,8412,2199,3.16783659205254,0.828111348778357,1,10611,fhi:git
county,Møre og Romsdal,2021-02-08,1,2,8413,2201,3.16821317747718,0.828864519627632,3,10614,fhi:git
county,Møre og Romsdal,2021-02-09,327,183,8740,2384,3.29135661133372,0.897779652336336,510,11124,fhi:git
county,Møre og Romsdal,2021-02-10,1258,435,9998,2819,3.76510107552797,1.06159431205375,1693,12817,fhi:git
county,Møre og Romsdal,2021-02-11,1254,804,11252,3623,4.23733919802368,1.36436899346248,2058,14875,fhi:git
county,Møre og Romsdal,2021-02-12,295,207,11547,3830,4.34843189829181,1.44232217636249,502,15377,fhi:git
county,Møre og Romsdal,2021-02-13,24,0,11571,3830,4.35746994848311,1.44232217636249,24,15401,fhi:git
county,Møre og Romsdal,2021-02-14,0,0,11571,3830,4.35746994848311,1.44232217636249,0,15401,fhi:git
county,Møre og Romsdal,2021-02-15,1,8,11572,3838,4.35784653390775,1.44533485975959,9,15410,fhi:git
county,Møre og Romsdal,2021-02-16,354,58,11926,3896,4.49115777422951,1.46717681438858,412,15822,fhi:git
county,Møre og Romsdal,2021-02-17,1204,423,13130,4319,4.94456662549333,1.62647244901033,1627,17449,fhi:git
county,Møre og Romsdal,2021-02-18,1165,522,14295,4841,5.38328864519628,1.82305004067123,1687,19136,fhi:git
county,Møre og Romsdal,2021-02-19,499,94,14794,4935,5.5712047720905,1.85844907058717,593,19729,fhi:git
county,Møre og Romsdal,2021-02-20,11,0,14805,4935,5.57534721176152,1.85844907058717,11,19740,fhi:git
county,Møre og Romsdal,2021-02-21,0,0,14805,4935,5.57534721176152,1.85844907058717,0,19740,fhi:git
county,Møre og Romsdal,2021-02-22,15,0,14820,4935,5.58099599313108,1.85844907058717,15,19755,fhi:git
county,Møre og Romsdal,2021-02-23,393,223,15213,5158,5.72899406501371,1.94242762028138,616,20371,fhi:git
county,Møre og Romsdal,2021-02-24,730,876,15943,6034,6.00390142499925,2.27231645226403,1606,21977,fhi:git
county,Møre og Romsdal,2021-02-25,704,1476,16647,7510,6.26901756394421,2.82815653902931,2180,24157,fhi:git
county,Møre og Romsdal,2021-02-26,260,203,16907,7713,6.36692977435001,2.90460338023077,463,24620,fhi:git
county,Møre og Romsdal,2021-02-27,2,1,16909,7714,6.36768294519929,2.90497996565541,3,24623,fhi:git
county,Møre og Romsdal,2021-02-28,0,0,16909,7714,6.36768294519929,2.90497996565541,0,24623,fhi:git
county,Møre og Romsdal,2021-03-01,101,1,17010,7715,6.4057180730877,2.90535655108005,102,24725,fhi:git
county,Møre og Romsdal,2021-03-02,741,252,17751,7967,6.68476787274425,3.00025607808875,993,25718,fhi:git
county,Møre og Romsdal,2021-03-03,870,1116,18621,9083,7.01239719217907,3.42052541198446,1986,27704,fhi:git
county,Møre og Romsdal,2021-03-04,988,1308,19609,10391,7.38446359172115,3.9130991474106,2296,30000,fhi:git
county,Møre og Romsdal,2021-03-05,813,274,20422,10665,7.69062754195162,4.01628355376134,1087,31087,fhi:git
county,Møre og Romsdal,2021-03-06,3,6,20425,10671,7.69175729822553,4.01854306630916,9,31096,fhi:git
county,Møre og Romsdal,2021-03-07,0,0,20425,10671,7.69175729822553,4.01854306630916,0,31096,fhi:git
county,Møre og Romsdal,2021-03-08,157,0,20582,10671,7.75088120989365,4.01854306630916,157,31253,fhi:git
county,Møre og Romsdal,2021-03-09,670,238,21252,10909,8.00319344440093,4.10817039737294,908,32161,fhi:git
county,Møre og Romsdal,2021-03-10,1287,946,22539,11855,8.48785888590968,4.46442020908023,2233,34394,fhi:git
county,Møre og Romsdal,2021-03-11,540,973,23079,12828,8.69121501521405,4.83083782725273,1513,35907,fhi:git
county,Møre og Romsdal,2021-03-12,66,249,23145,13077,8.71606965324014,4.92460759798753,315,36222,fhi:git
county,Møre og Romsdal,2021-03-13,0,16,23145,13093,8.71606965324014,4.93063296478173,16,36238,fhi:git
county,Møre og Romsdal,2021-03-14,0,0,23145,13093,8.71606965324014,4.93063296478173,0,36238,fhi:git
county,Møre og Romsdal,2021-03-15,0,1,23145,13094,8.71606965324014,4.93100955020637,1,36239,fhi:git
county,Møre og Romsdal,2021-03-16,334,10,23479,13104,8.84184918506914,4.93477540445275,344,36583,fhi:git
county,Møre og Romsdal,2021-03-17,1536,129,25015,13233,9.42028439731269,4.98335492423101,1665,38248,fhi:git
county,Møre og Romsdal,2021-03-18,1485,60,26500,13293,9.97951375289971,5.00595004970928,1545,39793,fhi:git
county,Møre og Romsdal,2021-03-19,205,37,26705,13330,10.0567137649504,5.01988371042087,242,40035,fhi:git
county,Møre og Romsdal,2021-03-20,18,0,26723,13330,10.0634923025939,5.01988371042087,18,40053,fhi:git
county,Møre og Romsdal,2021-03-21,0,0,26723,13330,10.0634923025939,5.01988371042087,0,40053,fhi:git
county,Møre og Romsdal,2021-03-22,1,7,26724,13337,10.0638688880186,5.02251980839334,8,40061,fhi:git
county,Møre og Romsdal,2021-03-23,598,19,27322,13356,10.2890669719519,5.02967493146145,617,40678,fhi:git
county,Møre og Romsdal,2021-03-24,1808,48,29130,13404,10.9699334196969,5.04775103184406,1856,42534,fhi:git
county,Møre og Romsdal,2021-03-25,2316,70,31446,13474,11.8421052631579,5.07411201156871,2386,44920,fhi:git
county,Møre og Romsdal,2021-03-26,225,19,31671,13493,11.9268369837014,5.08126713463682,244,45164,fhi:git
county,Møre og Romsdal,2021-03-27,25,1,31696,13494,11.9362516193173,5.08164372006146,26,45190,fhi:git
county,Møre og Romsdal,2021-03-28,0,0,31696,13494,11.9362516193173,5.08164372006146,0,45190,fhi:git
county,Møre og Romsdal,2021-03-29,7,5,31703,13499,11.9388877172898,5.08352664718465,12,45202,fhi:git
county,Møre og Romsdal,2021-03-30,2223,94,33926,13593,12.7760371162595,5.11892567710059,2317,47519,fhi:git
county,Møre og Romsdal,2021-03-31,1937,208,35863,13801,13.5054830837827,5.19725544542524,2145,49664,fhi:git
county,Møre og Romsdal,2021-04-01,99,26,35962,13827,13.5427650408219,5.20704666646582,125,49789,fhi:git
county,Møre og Romsdal,2021-04-02,19,1,35981,13828,13.54992016389,5.20742325189046,20,49809,fhi:git
county,Møre og Romsdal,2021-04-03,14,0,35995,13828,13.5551923598349,5.20742325189046,14,49823,fhi:git
county,Møre og Romsdal,2021-04-04,0,0,35995,13828,13.5551923598349,5.20742325189046,0,49823,fhi:git
county,Møre og Romsdal,2021-04-05,0,0,35995,13828,13.5551923598349,5.20742325189046,0,49823,fhi:git
county,Møre og Romsdal,2021-04-06,821,42,36816,13870,13.8643689934625,5.22323983972524,863,50686,fhi:git
county,Møre og Romsdal,2021-04-07,2309,34,39125,13904,14.733904738951,5.23604374416293,2343,53029,fhi:git
county,Nordland,2020-12-27,0,0,0,0,0.0,0.0,0,0,fhi:git
county,Nordland,2020-12-28,0,0,0,0,0.0,0.0,0,0,fhi:git
county,Nordland,2020-12-29,0,0,0,0,0.0,0.0,0,0,fhi:git
county,Nordland,2020-12-30,1,0,1,0,0.0004145335461272,0.0,1,1,fhi:git
county,Nordland,2020-12-31,0,0,1,0,0.0004145335461272,0.0,0,1,fhi:git
county,Nordland,2021-01-01,0,0,1,0,0.0004145335461272,0.0,0,1,fhi:git
county,Nordland,2021-01-02,0,0,1,0,0.0004145335461272,0.0,0,1,fhi:git
county,Nordland,2021-01-03,0,0,1,0,0.0004145335461272,0.0,0,1,fhi:git
county,Nordland,2021-01-04,0,0,1,0,0.0004160685681,0.0,0,1,fhi:git
county,Nordland,2021-01-05,200,0,201,0,0.0836297821881046,0.0,200,201,fhi:git
county,Nordland,2021-01-06,686,0,887,0,0.36905281990472,0.0,686,887,fhi:git
county,Nordland,2021-01-07,238,0,1125,0,0.468077139112526,0.0,238,1125,fhi:git
county,Nordland,2021-01-08,114,0,1239,0,0.515508955875928,0.0,114,1239,fhi:git
county,Nordland,2021-01-09,0,0,1239,0,0.515508955875928,0.0,0,1239,fhi:git
county,Nordland,2021-01-10,0,0,1239,0,0.515508955875928,0.0,0,1239,fhi:git
county,Nordland,2021-01-11,0,0,1239,0,0.515508955875928,0.0,0,1239,fhi:git
county,Nordland,2021-01-12,292,0,1531,0,0.637000977761135,0.0,292,1531,fhi:git
county,Nordland,2021-01-13,626,0,2157,0,0.897459901391749,0.0,626,2157,fhi:git
county,Nordland,2021-01-14,271,0,2428,0,1.01021448334686,0.0,271,2428,fhi:git
county,Nordland,2021-01-15,69,0,2497,0,1.03892321454576,0.0,69,2497,fhi:git
county,Nordland,2021-01-16,0,0,2497,0,1.03892321454576,0.0,0,2497,fhi:git
county,Nordland,2021-01-17,1,0,2498,0,1.03933928311386,0.0,1,2498,fhi:git
county,Nordland,2021-01-18,0,0,2498,0,1.03933928311386,0.0,0,2498,fhi:git
county,Nordland,2021-01-19,313,0,2811,0,1.16956874492916,0.0,313,2811,fhi:git
county,Nordland,2021-01-20,786,0,3597,0,1.49659863945578,0.0,786,3597,fhi:git
county,Nordland,2021-01-21,617,0,4214,0,1.7533129459735,0.0,617,4214,fhi:git
county,Nordland,2021-01-22,173,0,4387,0,1.8252928082548,0.0,173,4387,fhi:git
county,Nordland,2021-01-23,4,0,4391,0,1.8269570825272,0.0,4,4391,fhi:git
county,Nordland,2021-01-24,0,0,4391,0,1.8269570825272,0.0,0,4391,fhi:git
county,Nordland,2021-01-25,51,0,4442,0,1.8481765795003,0.0,51,4442,fhi:git
county,Nordland,2021-01-26,119,90,4561,90,1.8976887391042,0.0374461711290021,209,4651,fhi:git
county,Nordland,2021-01-27,626,528,5187,618,2.15814766273482,0.257130375085814,1154,5805,fhi:git
county,Nordland,2021-01-28,471,365,5658,983,2.35411595830993,0.408995402442323,836,6641,fhi:git
county,Nordland,2021-01-29,212,144,5870,1127,2.44232249474713,0.468909276248726,356,6997,fhi:git
county,Nordland,2021-01-30,1,0,5871,1127,2.44273856331523,0.468909276248726,1,6998,fhi:git
county,Nordland,2021-01-31,0,0,5871,1127,2.44273856331523,0.468909276248726,0,6998,fhi:git
county,Nordland,2021-02-01,9,4,5880,1131,2.44648318042813,0.470573550521126,13,7011,fhi:git
county,Nordland,2021-02-02,111,200,5991,1331,2.49266679148724,0.553787264141131,311,7322,fhi:git
county,Nordland,2021-02-03,1419,455,7410,1786,3.08306808962117,0.743098462626641,1874,9196,fhi:git
county,Nordland,2021-02-04,1670,347,9080,2133,3.77790259834821,0.887474255757349,2017,11213,fhi:git
county,Nordland,2021-02-05,329,154,9409,2287,3.91478915725312,0.951548815244752,483,11696,fhi:git
county,Nordland,2021-02-06,0,0,9409,2287,3.91478915725312,0.951548815244752,0,11696,fhi:git
county,Nordland,2021-02-07,1,0,9410,2287,3.91520522582122,0.951548815244752,1,11697,fhi:git
county,Nordland,2021-02-08,7,1,9417,2288,3.91811770579792,0.951964883812852,8,11705,fhi:git
county,Nordland,2021-02-09,70,262,9487,2550,3.94724250556492,1.06097484865506,332,12037,fhi:git
county,Nordland,2021-02-10,2031,633,11518,3183,4.79227776737606,1.32434625226237,2664,14701,fhi:git
county,Nordland,2021-02-11,1222,585,12740,3768,5.30071355759429,1.56774636460089,1807,16508,fhi:git
county,Nordland,2021-02-12,287,238,13027,4006,5.420125236639,1.66677068380869,525,17033,fhi:git
county,Nordland,2021-02-13,53,3,13080,4009,5.4421768707483,1.66801888951299,56,17089,fhi:git
county,Nordland,2021-02-14,0,0,13080,4009,5.4421768707483,1.66801888951299,0,17089,fhi:git
county,Nordland,2021-02-15,0,1,13080,4010,5.4421768707483,1.66843495808109,1,17090,fhi:git
county,Nordland,2021-02-16,223,71,13303,4081,5.5349601614346,1.69797582641619,294,17384,fhi:git
county,Nordland,2021-02-17,1491,515,14794,4596,6.15531839647174,1.91225113898771,2006,19390,fhi:git
county,Nordland,2021-02-18,849,607,15643,5203,6.50856061078866,2.16480475982442,1456,20846,fhi:git
county,Nordland,2021-02-19,306,231,15949,5434,6.63587759262727,2.26091659905552,537,21383,fhi:git
county,Nordland,2021-02-20,1,1,15950,5435,6.63629366119537,2.26133266762362,2,21385,fhi:git
county,Nordland,2021-02-21,0,0,15950,5435,6.63629366119537,2.26133266762362,0,21385,fhi:git
county,Nordland,2021-02-22,270,0,16220,5435,6.74863217458237,2.26133266762362,270,21655,fhi:git
county,Nordland,2021-02-23,308,56,16528,5491,6.87678129355718,2.28463250743723,364,22019,fhi:git
county,Nordland,2021-02-24,974,1008,17502,6499,7.2820320788866,2.70402962408205,1982,24001,fhi:git
county,Nordland,2021-02-25,591,1848,18093,8347,7.52792860263371,3.47292433793089,2439,26440,fhi:git
county,Nordland,2021-02-26,423,397,18516,8744,7.70392560694002,3.6381035594666,820,27260,fhi:git
county,Nordland,2021-02-27,1,4,18517,8748,7.70434167550812,3.639767833739,5,27265,fhi:git
county,Nordland,2021-02-28,0,1,18517,8749,7.70434167550812,3.6401839023071,1,27266,fhi:git
county,Nordland,2021-03-01,240,0,18757,8749,7.80419813185213,3.6401839023071,240,27506,fhi:git
county,Nordland,2021-03-02,517,50,19274,8799,8.01930558155984,3.6609873307121,567,28073,fhi:git
county,Nordland,2021-03-03,621,1585,19895,10384,8.27768416234996,4.32045601115064,2206,30279,fhi:git
county,Nordland,2021-03-04,718,1366,20613,11750,8.57642139424577,4.88880567517527,2084,32363,fhi:git
county,Nordland,2021-03-05,440,340,21053,12090,8.75949156420978,5.03026898832928,780,33143,fhi:git
county,Nordland,2021-03-06,13,51,21066,12141,8.76490045559508,5.05148848530238,64,33207,fhi:git
county,Nordland,2021-03-07,0,0,21066,12141,8.76490045559508,5.05148848530238,0,33207,fhi:git
county,Nordland,2021-03-08,360,0,21426,12141,8.91468514011109,5.05148848530238,360,33567,fhi:git
county,Nordland,2021-03-09,652,51,22078,12192,9.18596184651231,5.07270798227548,703,34270,fhi:git
county,Nordland,2021-03-10,1209,1187,23287,13379,9.68898874534523,5.56658137261021,2396,36666,fhi:git
county,Nordland,2021-03-11,730,989,24017,14368,9.99271880005825,5.97807318646113,1719,38385,fhi:git
county,Nordland,2021-03-12,70,251,24087,14619,10.0218435998253,6.08250639705423,321,38706,fhi:git
county,Nordland,2021-03-13,3,2,24090,14621,10.0230918055296,6.08333853419043,5,38711,fhi:git
county,Nordland,2021-03-14,0,0,24090,14621,10.0230918055296,6.08333853419043,0,38711,fhi:git
county,Nordland,2021-03-15,0,1,24090,14622,10.0230918055296,6.08375460275854,1,38712,fhi:git
county,Nordland,2021-03-16,118,5,24208,14627,10.0721878965654,6.08583494559904,123,38835,fhi:git
county,Nordland,2021-03-17,902,64,25110,14691,10.4474817449916,6.11246333395744,966,39801,fhi:git
county,Nordland,2021-03-18,1162,73,26272,14764,10.9309534211238,6.14283633942874,1235,41036,fhi:git
county,Nordland,2021-03-19,226,28,26498,14792,11.0249849175144,6.15448625933554,254,41290,fhi:git
county,Nordland,2021-03-20,39,0,26537,14792,11.0412115916703,6.15448625933554,39,41329,fhi:git
county,Nordland,2021-03-21,0,0,26537,14792,11.0412115916703,6.15448625933554,0,41329,fhi:git
county,Nordland,2021-03-22,36,1,26573,14793,11.0561900601219,6.15490232790364,37,41366,fhi:git
county,Nordland,2021-03-23,560,8,27133,14801,11.2891884582579,6.15823087644844,568,41934,fhi:git
county,Nordland,2021-03-24,2162,48,29295,14849,12.1887287024902,6.17820216771724,2210,44144,fhi:git
county,Nordland,2021-03-25,1588,62,30883,14911,12.849445588633,6.20399841893944,1650,45794,fhi:git
county,Nordland,2021-03-26,342,12,31225,14923,12.9917410389232,6.20899124175664,354,46148,fhi:git
county,Nordland,2021-03-27,0,0,31225,14923,12.9917410389232,6.20899124175664,0,46148,fhi:git
county,Nordland,2021-03-28,0,0,31225,14923,12.9917410389232,6.20899124175664,0,46148,fhi:git
county,Nordland,2021-03-29,9,1,31234,14924,12.9954856560361,6.20940731032474,10,46158,fhi:git
county,Nordland,2021-03-30,1537,113,32771,15037,13.6349830452059,6.25642305852004,1650,47808,fhi:git
county,Nordland,2021-03-31,1147,310,33918,15347,14.1122136928166,6.38540431463105,1457,49265,fhi:git
county,Nordland,2021-04-01,227,164,34145,15511,14.2066612577753,6.45363955979946,391,49656,fhi:git
county,Nordland,2021-04-02,99,10,34244,15521,14.2478520460172,6.45780024548046,109,49765,fhi:git
county,Nordland,2021-04-03,0,0,34244,15521,14.2478520460172,6.45780024548046,0,49765,fhi:git
county,Nordland,2021-04-04,0,0,34244,15521,14.2478520460172,6.45780024548046,0,49765,fhi:git
county,Nordland,2021-04-05,0,0,34244,15521,14.2478520460172,6.45780024548046,0,49765,fhi:git
county,Nordland,2021-04-06,402,13,34646,15534,14.4151116103934,6.46320913686576,415,50180,fhi:git
county,Nordland,2021-04-07,3265,79,37911,15613,15.77357548524,6.49607855374566,3344,53524,fhi:git
county,Oslo,2020-12-27,5,0,5,0,0.0007209867713347,0.0,5,5,fhi:git
county,Oslo,2020-12-28,264,0,269,0,0.0387890882978079,0.0,264,269,fhi:git
county,Oslo,2020-12-29,118,0,387,0,0.0558043761013073,0.0,118,387,fhi:git
county,Oslo,2020-12-30,58,0,445,0,0.06416782264879,0.0,58,445,fhi:git
county,Oslo,2020-12-31,5,0,450,0,0.0648888094201248,0.0,5,450,fhi:git
county,Oslo,2021-01-01,6,0,456,0,0.0657539935457264,0.0,6,456,fhi:git
county,Oslo,2021-01-02,0,0,456,0,0.0657539935457264,0.0,0,456,fhi:git
county,Oslo,2021-01-03,0,0,456,0,0.0657539935457264,0.0,0,456,fhi:git
county,Oslo,2021-01-04,0,0,456,0,0.065422303840691,0.0,0,456,fhi:git
county,Oslo,2021-01-05,479,0,935,0,0.134144416866329,0.0,479,935,fhi:git
county,Oslo,2021-01-06,603,0,1538,0,0.220656805497769,0.0,603,1538,fhi:git
county,Oslo,2021-01-07,966,0,2504,0,0.359248791265549,0.0,966,2504,fhi:git
county,Oslo,2021-01-08,450,0,2954,0,0.423810275318862,0.0,450,2954,fhi:git
county,Oslo,2021-01-09,127,0,3081,0,0.442030960818353,0.0,127,3081,fhi:git
county,Oslo,2021-01-10,100,0,3181,0,0.456377957274645,0.0,100,3181,fhi:git
county,Oslo,2021-01-11,78,0,3259,0,0.467568614510552,0.0,78,3259,fhi:git
county,Oslo,2021-01-12,241,0,3500,0,0.502144875970216,0.0,241,3500,fhi:git
county,Oslo,2021-01-13,489,0,3989,0,0.572301688641483,0.0,489,3989,fhi:git
county,Oslo,2021-01-14,1237,0,5226,0,0.749774034805813,0.0,1237,5226,fhi:git
county,Oslo,2021-01-15,1636,0,6862,0,0.984490896830748,0.0,1636,6862,fhi:git
county,Oslo,2021-01-16,643,0,7505,0,1.07674208404471,0.0,643,7505,fhi:git
county,Oslo,2021-01-17,276,5,7781,5,1.11633979426407,0.0007173498228145,281,7786,fhi:git
county,Oslo,2021-01-18,759,231,8540,236,1.22523349736733,0.0338589116368488,990,8776,fhi:git
county,Oslo,2021-01-19,810,70,9350,306,1.34144416866329,0.0439018091562531,880,9656,fhi:git
county,Oslo,2021-01-20,993,99,10343,405,1.48390984347427,0.0581053356479821,1092,10748,fhi:git
county,Oslo,2021-01-21,1021,21,11364,426,1.63039267729301,0.0611182049038034,1042,11790,fhi:git
county,Oslo,2021-01-22,670,6,12034,432,1.72651755355016,0.0619790246911809,676,12466,fhi:git
county,Oslo,2021-01-23,232,0,12266,432,1.75980258532876,0.0619790246911809,232,12698,fhi:git
county,Oslo,2021-01-24,67,0,12333,432,1.76941507295448,0.0619790246911809,67,12765,fhi:git
county,Oslo,2021-01-25,258,0,12591,432,1.80643032381171,0.0619790246911809,258,13023,fhi:git
county,Oslo,2021-01-26,312,404,12903,836,1.85119295275534,0.1199408903746,716,13739,fhi:git
county,Oslo,2021-01-27,1035,528,13938,1364,1.99968436607796,0.195693031663821,1563,15302,fhi:git
county,Oslo,2021-01-28,871,842,14809,2206,2.12464670521226,0.316494741825799,1713,17015,fhi:git
county,Oslo,2021-01-29,428,504,15237,2710,2.18605185004519,0.38880360396551,932,17947,fhi:git
county,Oslo,2021-01-30,94,152,15331,2862,2.19953802671411,0.410611038579073,246,18193,fhi:git
county,Oslo,2021-01-31,61,45,15392,2907,2.20828969455245,0.417067186984405,106,18299,fhi:git
county,Oslo,2021-02-01,53,48,15445,2955,2.21589360267428,0.423953745283425,101,18400,fhi:git
county,Oslo,2021-02-02,1521,151,16966,3106,2.43411141877448,0.445617709932426,1672,20072,fhi:git
county,Oslo,2021-02-03,2457,456,19423,3562,2.78661712170557,0.511040013773117,2913,22985,fhi:git
county,Oslo,2021-02-04,2049,1234,21472,4796,3.08058707909499,0.688081950043758,3283,26268,fhi:git
county,Oslo,2021-02-05,1383,1568,22855,6364,3.27900604008551,0.913042854478415,2951,29219,fhi:git
county,Oslo,2021-02-06,243,631,23098,6995,3.3138692414743,1.00357240211762,874,30093,fhi:git
county,Oslo,2021-02-07,214,270,23312,7265,3.34457181389076,1.0423092925496,484,30577,fhi:git
county,Oslo,2021-02-08,49,443,23361,7708,3.35160184215435,1.10586648685098,492,31069,fhi:git
county,Oslo,2021-02-09,1163,245,24524,7953,3.51845741094102,1.14101662816889,1408,32477,fhi:git
county,Oslo,2021-02-10,1830,814,26354,8767,3.78100744609116,1.25780117932311,2644,35121,fhi:git
county,Oslo,2021-02-11,1583,744,27937,9511,4.00812039999426,1.36454283295792,2327,37448,fhi:git
county,Oslo,2021-02-12,1358,425,29295,9936,4.20295261187071,1.42551756789716,1783,39231,fhi:git
county,Oslo,2021-02-13,273,193,29568,10129,4.24211991219638,1.4532072710578,466,39697,fhi:git
county,Oslo,2021-02-14,103,0,29671,10129,4.25689731854636,1.4532072710578,103,39800,fhi:git
county,Oslo,2021-02-15,260,444,29931,10573,4.29419950933272,1.51690793532374,704,40504,fhi:git
county,Oslo,2021-02-16,723,771,30654,11344,4.39792829371171,1.62752327800175,1494,41998,fhi:git
county,Oslo,2021-02-17,1460,1082,32114,12426,4.60739444197357,1.78275777965883,2542,44540,fhi:git
county,Oslo,2021-02-18,1070,919,33184,13345,4.7609073040559,1.91460667709215,1989,46529,fhi:git
county,Oslo,2021-02-19,1494,971,34678,14316,4.9752514311129,2.05391601268274,2465,48994,fhi:git
county,Oslo,2021-02-20,100,114,34778,14430,4.98959842756919,2.07027158864292,214,49208,fhi:git
county,Oslo,2021-02-21,4,61,34782,14491,4.99017230742744,2.07902325648126,65,49273,fhi:git
county,Oslo,2021-02-22,601,112,35383,14603,5.07639775612975,2.0950918925123,713,49986,fhi:git
county,Oslo,2021-02-23,339,1526,35722,16129,5.12503407411658,2.31402705843532,1865,51851,fhi:git
county,Oslo,2021-02-24,690,2349,36412,18478,5.224028349665,2.65103800519361,3039,54890,fhi:git
county,Oslo,2021-02-25,600,1977,37012,20455,5.31011032840275,2.9346781251345,2577,57467,fhi:git
county,Oslo,2021-02-26,767,1373,37779,21828,5.42015179122251,3.13166238647939,2140,59607,fhi:git
county,Oslo,2021-02-27,259,103,38038,21931,5.4573105120443,3.14643979282937,362,59969,fhi:git
county,Oslo,2021-02-28,101,62,38139,21993,5.47180097846516,3.15533493063227,163,60132,fhi:git
county,Oslo,2021-03-01,1043,39,39182,22032,5.62144015150428,3.16093025925023,1082,61214,fhi:git
county,Oslo,2021-03-02,773,136,39955,22168,5.73234243411142,3.18044217443078,909,62123,fhi:git
county,Oslo,2021-03-03,1353,172,41308,22340,5.92645729616505,3.20511900833561,1525,63648,fhi:git
county,Oslo,2021-03-04,1181,203,42489,22543,6.09589532431386,3.23424341114188,1384,65032,fhi:git
county,Oslo,2021-03-05,1304,68,43793,22611,6.2829801581039,3.24399936873216,1372,66404,fhi:git
county,Oslo,2021-03-06,102,3,43895,22614,6.29761409448932,3.24442977862584,105,66509,fhi:git
county,Oslo,2021-03-07,69,0,43964,22614,6.30751352204416,3.24442977862584,69,66578,fhi:git
county,Oslo,2021-03-08,667,10,44631,22624,6.40320798840763,3.24586447827147,677,67255,fhi:git
county,Oslo,2021-03-09,775,1326,45406,23950,6.51439721094389,3.4361056512819,2101,69356,fhi:git
county,Oslo,2021-03-10,1189,2390,46595,26340,6.6849829988092,3.77899886658728,3579,72935,fhi:git
county,Oslo,2021-03-11,877,2371,47472,28711,6.81080615773088,4.11916615256596,3248,76183,fhi:git
county,Oslo,2021-03-12,278,1635,47750,30346,6.85069080787937,4.35373954462633,1913,78096,fhi:git
county,Oslo,2021-03-13,15,267,47765,30613,6.85284285734781,4.39204602516463,282,78378,fhi:git
county,Oslo,2021-03-14,1,97,47766,30710,6.85298632731238,4.40596261172724,98,78476,fhi:git
county,Oslo,2021-03-15,24,358,47790,31068,6.85642960646189,4.45732485904076,382,78858,fhi:git
county,Oslo,2021-03-16,1007,119,48797,31187,7.00090386077675,4.47439778482375,1126,79984,fhi:git
county,Oslo,2021-03-17,2733,93,51530,31280,7.3930072739272,4.4877404915281,2826,82810,fhi:git
county,Oslo,2021-03-18,2024,112,53554,31392,7.68339048220255,4.50380912755915,2136,84946,fhi:git
county,Oslo,2021-03-19,1995,186,55549,31578,7.96961306150557,4.53049454096785,2181,87127,fhi:git
county,Oslo,2021-03-20,394,18,55943,31596,8.02614022754336,4.53307700032998,412,87539,fhi:git
county,Oslo,2021-03-21,162,14,56105,31610,8.04938236180256,4.53508557983386,176,87715,fhi:git
county,Oslo,2021-03-22,935,11,57040,31621,8.18352677866889,4.53666374944405,946,88661,fhi:git
county,Oslo,2021-03-23,3317,104,60357,31725,8.65941665112409,4.5515846257586,3421,92082,fhi:git
county,Oslo,2021-03-24,5123,213,65480,31938,9.39441327957992,4.5821437282105,5336,97418,fhi:git
county,Oslo,2021-03-25,5128,48,70608,31986,10.1301272578586,4.58903028650952,5176,102594,fhi:git
county,Oslo,2021-03-26,4157,84,74765,32070,10.7265319005466,4.6010817635328,4241,106835,fhi:git
county,Oslo,2021-03-27,534,1,75299,32071,10.8031448616232,4.60122523349737,535,107370,fhi:git
county,Oslo,2021-03-28,150,0,75449,32071,10.8246653563077,4.60122523349737,150,107520,fhi:git
county,Oslo,2021-03-29,2181,9,77630,32080,11.1375733490194,4.60251646317843,2190,109710,fhi:git
county,Oslo,2021-03-30,4356,211,81986,32291,11.7625285146555,4.63278862570121,4567,114277,fhi:git
county,Oslo,2021-03-31,4216,707,86202,32998,12.3673978852527,4.73422189064719,4923,119200,fhi:git
county,Oslo,2021-04-01,2797,285,88999,33283,12.7686833761352,4.77511083054763,3082,122282,fhi:git
county,Oslo,2021-04-02,1663,166,90662,33449,13.0072739272033,4.79892684466507,1829,124111,fhi:git
county,Oslo,2021-04-03,229,0,90891,33449,13.0401285490882,4.79892684466507,229,124340,fhi:git
county,Oslo,2021-04-04,374,36,91265,33485,13.0937863158348,4.80409176338934,410,124750,fhi:git
county,Oslo,2021-04-05,1252,53,92517,33538,13.2734107114676,4.81169567151117,1305,126055,fhi:git
county,Oslo,2021-04-06,4466,104,96983,33642,13.9141475732055,4.82661654782571,4570,130625,fhi:git
county,Oslo,2021-04-07,6005,157,102988,33799,14.7756847104059,4.84914133226209,6162,136787,fhi:git
county,Rogaland,2020-12-27,0,0,0,0,0.0,0.0,0,0,fhi:git
county,Rogaland,2020-12-28,1,0,1,0,0.0002083802188825,0.0,1,1,fhi:git
county,Rogaland,2020-12-29,0,0,1,0,0.0002083802188825,0.0,0,1,fhi:git
county,Rogaland,2020-12-30,0,0,1,0,0.0002083802188825,0.0,0,1,fhi:git
county,Rogaland,2020-12-31,0,0,1,0,0.0002083802188825,0.0,0,1,fhi:git
county,Rogaland,2021-01-01,0,0,1,0,0.0002083802188825,0.0,0,1,fhi:git
county,Rogaland,2021-01-02,0,0,1,0,0.0002083802188825,0.0,0,1,fhi:git
county,Rogaland,2021-01-03,0,0,1,0,0.0002083802188825,0.0,0,1,fhi:git
county,Rogaland,2021-01-04,0,0,1,0,0.0002071916211708,0.0,0,1,fhi:git
county,Rogaland,2021-01-05,548,0,549,0,0.113748200022791,0.0,548,549,fhi:git
county,Rogaland,2021-01-06,641,0,1190,0,0.246558029193299,0.0,641,1190,fhi:git
county,Rogaland,2021-01-07,212,0,1402,0,0.290482652881517,0.0,212,1402,fhi:git
county,Rogaland,2021-01-08,20,0,1422,0,0.294626485304934,0.0,20,1422,fhi:git
county,Rogaland,2021-01-09,1,0,1423,0,0.294833676926105,0.0,1,1423,fhi:git
county,Rogaland,2021-01-10,0,0,1423,0,0.294833676926105,0.0,0,1423,fhi:git
county,Rogaland,2021-01-11,3,0,1426,0,0.295455251789618,0.0,3,1426,fhi:git
county,Rogaland,2021-01-12,117,0,1543,0,0.319696671466606,0.0,117,1543,fhi:git
county,Rogaland,2021-01-13,761,0,2304,0,0.477369495177615,0.0,761,2304,fhi:git
county,Rogaland,2021-01-14,535,0,2839,0,0.588217012504014,0.0,535,2839,fhi:git
county,Rogaland,2021-01-15,291,0,3130,0,0.648509774264729,0.0,291,3130,fhi:git
county,Rogaland,2021-01-16,0,0,3130,0,0.648509774264729,0.0,0,3130,fhi:git
county,Rogaland,2021-01-17,2,0,3132,0,0.648924157507071,0.0,2,3132,fhi:git
county,Rogaland,2021-01-18,71,0,3203,0,0.6636347626102,0.0,71,3203,fhi:git
county,Rogaland,2021-01-19,512,0,3715,0,0.76971687264967,0.0,512,3715,fhi:git
county,Rogaland,2021-01-20,656,0,4371,0,0.905634576137741,0.0,656,4371,fhi:git
county,Rogaland,2021-01-21,431,0,4802,0,0.994934164862373,0.0,431,4802,fhi:git
county,Rogaland,2021-01-22,272,0,5074,0,1.05129028582084,0.0,272,5074,fhi:git
county,Rogaland,2021-01-23,0,0,5074,0,1.05129028582084,0.0,0,5074,fhi:git
county,Rogaland,2021-01-24,0,0,5074,0,1.05129028582084,0.0,0,5074,fhi:git
county,Rogaland,2021-01-25,150,0,5224,0,1.08236902899647,0.0,150,5224,fhi:git
county,Rogaland,2021-01-26,338,381,5562,381,1.15239979695221,0.07894000766609,719,5943,fhi:git
county,Rogaland,2021-01-27,865,603,6427,984,1.33162054926499,0.203876555232106,1468,7411,fhi:git
county,Rogaland,2021-01-28,524,283,6951,1267,1.44018895875851,0.262511784023454,807,8218,fhi:git
county,Rogaland,2021-01-29,410,22,7361,1289,1.52513752343855,0.267069999689213,432,8650,fhi:git
county,Rogaland,2021-01-30,4,1,7365,1290,1.52596628992324,0.267277191310383,5,8655,fhi:git
county,Rogaland,2021-01-31,2,0,7367,1290,1.52638067316558,0.267277191310383,2,8657,fhi:git
county,Rogaland,2021-02-01,13,6,7380,1296,1.5290741642408,0.268520341037408,19,8676,fhi:git
county,Rogaland,2021-02-02,450,77,7830,1373,1.62231039376768,0.284474095867563,527,9203,fhi:git
county,Rogaland,2021-02-03,2431,635,10261,2008,2.12599322483399,0.416040775311046,3066,12269,fhi:git
county,Rogaland,2021-02-04,1887,550,12148,2558,2.51696381398336,0.529996166955008,2437,14706,fhi:git
county,Rogaland,2021-02-05,656,281,12804,2839,2.65288151747143,0.588217012504014,937,15643,fhi:git
county,Rogaland,2021-02-06,0,0,12804,2839,2.65288151747143,0.588217012504014,0,15643,fhi:git
county,Rogaland,2021-02-07,0,1,12804,2840,2.65288151747143,0.588424204125185,1,15644,fhi:git
county,Rogaland,2021-02-08,7,71,12811,2911,2.65433185881963,0.603134809228315,78,15722,fhi:git
county,Rogaland,2021-02-09,588,394,13399,3305,2.77616053206808,0.684768307969626,982,16704,fhi:git
county,Rogaland,2021-02-10,1923,683,15322,3988,3.17459001957961,0.826280185229309,2606,19310,fhi:git
county,Rogaland,2021-02-11,1181,497,16503,4485,3.41928332418237,0.929254420951217,1678,20988,fhi:git
county,Rogaland,2021-02-12,482,268,16985,4753,3.51914968558672,0.984781775425002,750,21738,fhi:git
county,Rogaland,2021-02-13,1,0,16986,4753,3.51935687720789,0.984781775425002,1,21739,fhi:git
county,Rogaland,2021-02-14,0,0,16986,4753,3.51935687720789,0.984781775425002,0,21739,fhi:git
county,Rogaland,2021-02-15,0,147,16986,4900,3.51935687720789,1.01523894373712,147,21886,fhi:git
county,Rogaland,2021-02-16,481,314,17467,5214,3.61901604699106,1.08029711278476,795,22681,fhi:git
county,Rogaland,2021-02-17,1488,783,18955,5997,3.92731717929327,1.24252815216153,2271,24952,fhi:git
county,Rogaland,2021-02-18,1101,472,20056,6469,4.15543515420236,1.34032259735416,1573,26525,fhi:git
county,Rogaland,2021-02-19,442,411,20498,6880,4.24701385075988,1.42547835365538,853,27378,fhi:git
county,Rogaland,2021-02-20,1,2,20499,6882,4.24722104238105,1.42589273689772,3,27381,fhi:git
county,Rogaland,2021-02-21,0,2,20499,6884,4.24722104238105,1.42630712014006,2,27383,fhi:git
county,Rogaland,2021-02-22,252,13,20751,6897,4.2994333309161,1.42900061121528,265,27648,fhi:git
county,Rogaland,2021-02-23,379,407,21130,7304,4.37795895533985,1.51332760103181,786,28434,fhi:git
county,Rogaland,2021-02-24,821,2168,21951,9472,4.54806327632111,1.9625190357302,2989,31423,fhi:git
county,Rogaland,2021-02-25,1229,1812,23180,11284,4.80270177874007,2.33795025329176,3041,34464,fhi:git
county,Rogaland,2021-02-26,999,674,24179,11958,5.00968620828974,2.4775974059609,1673,36137,fhi:git
county,Rogaland,2021-02-27,1,1,24180,11959,5.00989339991091,2.47780459758207,2,36139,fhi:git
county,Rogaland,2021-02-28,4,0,24184,11959,5.01072216639559,2.47780459758207,4,36143,fhi:git
county,Rogaland,2021-03-01,648,2,24832,11961,5.1449823369143,2.47821898082442,650,36793,fhi:git
county,Rogaland,2021-03-02,794,545,25626,12506,5.30949248412394,2.59113841436252,1339,38132,fhi:git
county,Rogaland,2021-03-03,1269,1460,26895,13966,5.57241865138974,2.89363818127195,2729,40861,fhi:git
county,Rogaland,2021-03-04,1089,1478,27984,15444,5.79805032684478,3.19986739736245,2567,43428,fhi:git
county,Rogaland,2021-03-05,590,424,28574,15868,5.92029338333558,3.28771664473889,1014,44442,fhi:git
county,Rogaland,2021-03-06,4,1,28578,15869,5.92112214982026,3.28792383636006,5,44447,fhi:git
county,Rogaland,2021-03-07,0,0,28578,15869,5.92112214982026,3.28792383636006,0,44447,fhi:git
county,Rogaland,2021-03-08,542,0,29120,15869,6.03342000849486,3.28792383636006,542,44989,fhi:git
county,Rogaland,2021-03-09,1567,466,30687,16335,6.35808927886956,3.38447513182567,2033,47022,fhi:git
county,Rogaland,2021-03-10,2133,1079,32820,17414,6.80002900682696,3.60803489106901,3212,50234,fhi:git
county,Rogaland,2021-03-11,1399,1057,34219,18471,7.08989008484497,3.82703643464658,2456,52690,fhi:git
county,Rogaland,2021-03-12,117,545,34336,19016,7.11413150452196,3.93995586818469,662,53352,fhi:git
county,Rogaland,2021-03-13,0,0,34336,19016,7.11413150452196,3.93995586818469,0,53352,fhi:git
county,Rogaland,2021-03-14,0,0,34336,19016,7.11413150452196,3.93995586818469,0,53352,fhi:git
county,Rogaland,2021-03-15,0,1,34336,19017,7.11413150452196,3.94016305980586,1,53353,fhi:git
county,Rogaland,2021-03-16,584,93,34920,19110,7.23513141128573,3.95943188057475,677,54030,fhi:git
county,Rogaland,2021-03-17,2397,95,37317,19205,7.73176972723223,3.97911508458598,2492,56522,fhi:git
county,Rogaland,2021-03-18,1675,83,38992,19288,8.07881569269339,3.99631198914316,1758,58280,fhi:git
county,Rogaland,2021-03-19,273,25,39265,19313,8.13537900527303,4.00149177967243,298,58578,fhi:git
county,Rogaland,2021-03-20,0,0,39265,19313,8.13537900527303,4.00149177967243,0,58578,fhi:git
county,Rogaland,2021-03-21,0,0,39265,19313,8.13537900527303,4.00149177967243,0,58578,fhi:git
county,Rogaland,2021-03-22,12,17,39277,19330,8.13786530472708,4.00501403723233,29,58607,fhi:git
county,Rogaland,2021-03-23,827,48,40104,19378,8.30921277543536,4.01495923504853,875,59482,fhi:git
county,Rogaland,2021-03-24,3405,80,43509,19458,9.01470024552207,4.0315345647422,3485,62967,fhi:git
county,Rogaland,2021-03-25,3235,166,46744,19624,9.68496514000974,4.06592837385656,3401,66368,fhi:git
county,Rogaland,2021-03-26,806,77,47550,19701,9.85196158667344,4.08188212868672,883,67251,fhi:git
county,Rogaland,2021-03-27,0,0,47550,19701,9.85196158667344,4.08188212868672,0,67251,fhi:git
county,Rogaland,2021-03-28,1,2,47551,19703,9.8521687782946,4.08229651192906,3,67254,fhi:git
county,Rogaland,2021-03-29,233,0,47784,19703,9.90044442602741,4.08229651192906,233,67487,fhi:git
county,Rogaland,2021-03-30,4124,356,51908,20059,10.754902671736,4.15605672906588,4480,71967,fhi:git
county,Rogaland,2021-03-31,2105,612,54013,20671,11.1910410343006,4.28285800122243,2717,74684,fhi:git
county,Rogaland,2021-04-01,569,0,54582,20671,11.3089330667468,4.28285800122243,569,75253,fhi:git
county,Rogaland,2021-04-02,10,21,54592,20692,11.3110049829585,4.28720902526702,31,75284,fhi:git
county,Rogaland,2021-04-03,0,0,54592,20692,11.3110049829585,4.28720902526702,0,75284,fhi:git
county,Rogaland,2021-04-04,0,0,54592,20692,11.3110049829585,4.28720902526702,0,75284,fhi:git
county,Rogaland,2021-04-05,0,0,54592,20692,11.3110049829585,4.28720902526702,0,75284,fhi:git
county,Rogaland,2021-04-06,1360,77,55952,20769,11.5927855877508,4.30316278009717,1437,76721,fhi:git
county,Rogaland,2021-04-07,5158,108,61110,20877,12.66147996975,4.32553947518362,5266,81987,fhi:git
county,Troms og Finnmark,2020-12-27,0,0,0,0,0.0,0.0,0,0,fhi:git
county,Troms og Finnmark,2020-12-28,1,0,1,0,0.0004109966257177,0.0,1,1,fhi:git
county,Troms og Finnmark,2020-12-29,0,0,1,0,0.0004109966257177,0.0,0,1,fhi:git
county,Troms og Finnmark,2020-12-30,0,0,1,0,0.0004109966257177,0.0,0,1,fhi:git
county,Troms og Finnmark,2020-12-31,0,0,1,0,0.0004109966257177,0.0,0,1,fhi:git
county,Troms og Finnmark,2021-01-01,0,0,1,0,0.0004109966257177,0.0,0,1,fhi:git
county,Troms og Finnmark,2021-01-02,0,0,1,0,0.0004109966257177,0.0,0,1,fhi:git
county,Troms og Finnmark,2021-01-03,0,0,1,0,0.0004109966257177,0.0,0,1,fhi:git
county,Troms og Finnmark,2021-01-04,0,0,1,0,0.0004129364738528,0.0,0,1,fhi:git
county,Troms og Finnmark,2021-01-05,53,0,54,0,0.0222985695880546,0.0,53,54,fhi:git
county,Troms og Finnmark,2021-01-06,530,0,584,0,0.241154900730072,0.0,530,584,fhi:git
county,Troms og Finnmark,2021-01-07,188,0,772,0,0.31878695781441,0.0,188,772,fhi:git
county,Troms og Finnmark,2021-01-08,247,0,1019,0,0.420782266856067,0.0,247,1019,fhi:git
county,Troms og Finnmark,2021-01-09,0,0,1019,0,0.420782266856067,0.0,0,1019,fhi:git
county,Troms og Finnmark,2021-01-10,0,0,1019,0,0.420782266856067,0.0,0,1019,fhi:git
county,Troms og Finnmark,2021-01-11,0,0,1019,0,0.420782266856067,0.0,0,1019,fhi:git
county,Troms og Finnmark,2021-01-12,191,0,1210,0,0.499653133361964,0.0,191,1210,fhi:git
county,Troms og Finnmark,2021-01-13,569,0,1779,0,0.734613986984242,0.0,569,1779,fhi:git
county,Troms og Finnmark,2021-01-14,330,0,2109,0,0.870883023355687,0.0,330,2109,fhi:git
county,Troms og Finnmark,2021-01-15,37,0,2146,0,0.886161672888243,0.0,37,2146,fhi:git
county,Troms og Finnmark,2021-01-16,2,0,2148,0,0.886987545835949,0.0,2,2148,fhi:git
county,Troms og Finnmark,2021-01-17,0,0,2148,0,0.886987545835949,0.0,0,2148,fhi:git
county,Troms og Finnmark,2021-01-18,0,1,2148,1,0.886987545835949,0.0004129364738528,1,2149,fhi:git
county,Troms og Finnmark,2021-01-19,251,0,2399,1,0.990634600773017,0.0004129364738528,251,2400,fhi:git
county,Troms og Finnmark,2021-01-20,923,0,3322,1,1.37177496613921,0.0004129364738528,923,3323,fhi:git
county,Troms og Finnmark,2021-01-21,248,0,3570,1,1.47418321165472,0.0004129364738528,248,3571,fhi:git
county,Troms og Finnmark,2021-01-22,82,0,3652,1,1.50804400251065,0.0004129364738528,82,3653,fhi:git
county,Troms og Finnmark,2021-01-23,12,0,3664,1,1.51299924019689,0.0004129364738528,12,3665,fhi:git
county,Troms og Finnmark,2021-01-24,0,0,3664,1,1.51299924019689,0.0004129364738528,0,3665,fhi:git
county,Troms og Finnmark,2021-01-25,6,0,3670,1,1.51547685904001,0.0004129364738528,6,3671,fhi:git
county,Troms og Finnmark,2021-01-26,85,0,3755,1,1.5505764593175,0.0004129364738528,85,3756,fhi:git
county,Troms og Finnmark,2021-01-27,667,357,4422,358,1.82600508737736,0.147831257639325,1024,4780,fhi:git
county,Troms og Finnmark,2021-01-28,235,276,4657,634,1.92304515873278,0.261801724422715,511,5291,fhi:git
county,Troms og Finnmark,2021-01-29,104,243,4761,877,1.96599055201348,0.36214528756896,347,5638,fhi:git
county,Troms og Finnmark,2021-01-30,0,0,4761,877,1.96599055201348,0.36214528756896,0,5638,fhi:git
county,Troms og Finnmark,2021-01-31,0,0,4761,877,1.96599055201348,0.36214528756896,0,5638,fhi:git
county,Troms og Finnmark,2021-02-01,0,1,4761,878,1.96599055201348,0.362558224042813,1,5639,fhi:git
county,Troms og Finnmark,2021-02-02,119,24,4880,902,2.01512999240197,0.372468699415282,143,5782,fhi:git
county,Troms og Finnmark,2021-02-03,1160,562,6040,1464,2.49413630207129,0.604538997720591,1722,7504,fhi:git
county,Troms og Finnmark,2021-02-04,1149,380,7189,1844,2.96860031052823,0.761454857784678,1529,9033,fhi:git
county,Troms og Finnmark,2021-02-05,287,140,7476,1984,3.087113078524,0.819265964124079,427,9460,fhi:git
county,Troms og Finnmark,2021-02-06,1,1,7477,1985,3.08752601499785,0.819678900597932,2,9462,fhi:git
county,Troms og Finnmark,2021-02-07,0,0,7477,1985,3.08752601499785,0.819678900597932,0,9462,fhi:git
county,Troms og Finnmark,2021-02-08,0,0,7477,1985,3.08752601499785,0.819678900597932,0,9462,fhi:git
county,Troms og Finnmark,2021-02-09,71,29,7548,2014,3.11684450464141,0.831654058339665,100,9562,fhi:git
county,Troms og Finnmark,2021-02-10,1408,813,8956,2827,3.69825905982624,1.16737141158204,2221,11783,fhi:git
county,Troms og Finnmark,2021-02-11,995,466,9951,3293,4.10913085130983,1.35979980839748,1461,13244,fhi:git
county,Troms og Finnmark,2021-02-12,293,114,10244,3407,4.23012123814872,1.4068745664167,407,13651,fhi:git
county,Troms og Finnmark,2021-02-13,5,2,10249,3409,4.23218592051799,1.40770043936441,7,13658,fhi:git
county,Troms og Finnmark,2021-02-14,0,0,10249,3409,4.23218592051799,1.40770043936441,0,13658,fhi:git
county,Troms og Finnmark,2021-02-15,0,6,10249,3415,4.23218592051799,1.41017805820753,6,13664,fhi:git
county,Troms og Finnmark,2021-02-16,133,52,10382,3467,4.28710647154042,1.43165075484787,185,13849,fhi:git
county,Troms og Finnmark,2021-02-17,969,582,11351,4049,4.68724191470384,1.67197978263024,1551,15400,fhi:git
county,Troms og Finnmark,2021-02-18,1296,263,12647,4312,5.22240758481715,1.78058207525354,1559,16959,fhi:git
county,Troms og Finnmark,2021-02-19,232,133,12879,4445,5.31820884675102,1.83550262627597,365,17324,fhi:git
county,Troms og Finnmark,2021-02-20,0,0,12879,4445,5.31820884675102,1.83550262627597,0,17324,fhi:git
county,Troms og Finnmark,2021-02-21,0,0,12879,4445,5.31820884675102,1.83550262627597,0,17324,fhi:git
county,Troms og Finnmark,2021-02-22,107,0,12986,4445,5.36239304945327,1.83550262627597,107,17431,fhi:git
county,Troms og Finnmark,2021-02-23,79,78,13065,4523,5.39501503088765,1.8677116712365,157,17588,fhi:git
county,Troms og Finnmark,2021-02-24,430,993,13495,5516,5.57257771464438,2.27775758977239,1423,19011,fhi:git
county,Troms og Finnmark,2021-02-25,567,1054,14062,6570,5.80671269531895,2.71299263321331,1621,20632,fhi:git
county,Troms og Finnmark,2021-02-26,282,405,14344,6975,5.92316078094546,2.88023190512372,687,21319,fhi:git
county,Troms og Finnmark,2021-02-27,0,0,14344,6975,5.92316078094546,2.88023190512372,0,21319,fhi:git
county,Troms og Finnmark,2021-02-28,3,0,14347,6975,5.92439959036702,2.88023190512372,3,21322,fhi:git
county,Troms og Finnmark,2021-03-01,340,0,14687,6975,6.06479799147699,2.88023190512372,340,21662,fhi:git
county,Troms og Finnmark,2021-03-02,554,72,15241,7047,6.29356479799148,2.90996333124112,626,22288,fhi:git
county,Troms og Finnmark,2021-03-03,598,1179,15839,8226,6.54050080935549,3.39681543391365,1777,24065,fhi:git
county,Troms og Finnmark,2021-03-04,879,933,16718,9159,6.90347196987216,3.78208516401837,1812,25877,fhi:git
county,Troms og Finnmark,2021-03-05,704,374,17422,9533,7.19417924746457,3.93652340523934,1078,26955,fhi:git
county,Troms og Finnmark,2021-03-06,0,1,17422,9534,7.19417924746457,3.93693634171319,1,26956,fhi:git
county,Troms og Finnmark,2021-03-07,0,0,17422,9534,7.19417924746457,3.93693634171319,0,26956,fhi:git
county,Troms og Finnmark,2021-03-08,408,0,17830,9534,7.36265732879654,3.93693634171319,408,27364,fhi:git
county,Troms og Finnmark,2021-03-09,611,51,18441,9585,7.61496151432064,3.95799610187969,662,28026,fhi:git
county,Troms og Finnmark,2021-03-10,939,698,19380,10283,8.00270886326848,4.24622576062898,1637,29663,fhi:git
county,Troms og Finnmark,2021-03-11,795,1041,20175,11324,8.3309933599815,4.67609262990982,1836,31499,fhi:git
county,Troms og Finnmark,2021-03-12,68,209,20243,11533,8.35907304020349,4.76239635294506,277,31776,fhi:git
county,Troms og Finnmark,2021-03-13,0,0,20243,11533,8.35907304020349,4.76239635294506,0,31776,fhi:git
county,Troms og Finnmark,2021-03-14,0,0,20243,11533,8.35907304020349,4.76239635294506,0,31776,fhi:git
county,Troms og Finnmark,2021-03-15,2,5,20245,11538,8.3598989131512,4.76446103531433,7,31783,fhi:git
county,Troms og Finnmark,2021-03-16,19,2,20264,11540,8.3677447061544,4.76528690826203,21,31804,fhi:git
county,Troms og Finnmark,2021-03-17,546,45,20810,11585,8.59320802087807,4.78386904958541,591,32395,fhi:git
county,Troms og Finnmark,2021-03-18,1111,122,21921,11707,9.0519804433286,4.83424729939546,1233,33628,fhi:git
county,Troms og Finnmark,2021-03-19,406,33,22327,11740,9.21963265171286,4.84787420303261,439,34067,fhi:git
county,Troms og Finnmark,2021-03-20,0,0,22327,11740,9.21963265171286,4.84787420303261,0,34067,fhi:git
county,Troms og Finnmark,2021-03-21,1,0,22328,11740,9.22004558818671,4.84787420303261,1,34068,fhi:git
county,Troms og Finnmark,2021-03-22,3,0,22331,11740,9.22128439760827,4.84787420303261,3,34071,fhi:git
county,Troms og Finnmark,2021-03-23,429,14,22760,11754,9.39843414489115,4.85365531366655,443,34514,fhi:git
county,Troms og Finnmark,2021-03-24,1875,42,24635,11796,10.1726900333653,4.87099864556837,1917,36431,fhi:git
county,Troms og Finnmark,2021-03-25,1975,38,26610,11834,10.9882395692247,4.88669023157477,2013,38444,fhi:git
county,Troms og Finnmark,2021-03-26,554,15,27164,11849,11.2170063757392,4.89288427868257,569,39013,fhi:git
county,Troms og Finnmark,2021-03-27,1,0,27165,11849,11.217419312213,4.89288427868257,1,39014,fhi:git
county,Troms og Finnmark,2021-03-28,0,0,27165,11849,11.217419312213,4.89288427868257,0,39014,fhi:git
county,Troms og Finnmark,2021-03-29,176,0,27341,11849,11.2900961316111,4.89288427868257,176,39190,fhi:git
county,Troms og Finnmark,2021-03-30,1569,148,28910,11997,11.9379934590863,4.95399887681279,1717,40907,fhi:git
county,Troms og Finnmark,2021-03-31,1344,284,30254,12281,12.4929800799445,5.071272835387,1628,42535,fhi:git
county,Troms og Finnmark,2021-04-01,165,35,30419,12316,12.5611145981302,5.08572561197186,200,42735,fhi:git
county,Troms og Finnmark,2021-04-02,0,0,30419,12316,12.5611145981302,5.08572561197186,0,42735,fhi:git
county,Troms og Finnmark,2021-04-03,0,0,30419,12316,12.5611145981302,5.08572561197186,0,42735,fhi:git
county,Troms og Finnmark,2021-04-04,0,0,30419,12316,12.5611145981302,5.08572561197186,0,42735,fhi:git
county,Troms og Finnmark,2021-04-05,0,0,30419,12316,12.5611145981302,5.08572561197186,0,42735,fhi:git
county,Troms og Finnmark,2021-04-06,719,13,31138,12329,12.8580159228304,5.09109378613194,732,43467,fhi:git
county,Troms og Finnmark,2021-04-07,2506,60,33644,12389,13.8928347263057,5.11586997456311,2566,46033,fhi:git
county,Trøndelag,2020-12-27,0,0,0,0,0.0,0.0,0,0,fhi:git
county,Trøndelag,2020-12-28,0,0,0,0,0.0,0.0,0,0,fhi:git
county,Trøndelag,2020-12-29,0,0,0,0,0.0,0.0,0,0,fhi:git
county,Trøndelag,2020-12-30,0,0,0,0,0.0,0.0,0,0,fhi:git
county,Trøndelag,2020-12-31,0,0,0,0,0.0,0.0,0,0,fhi:git
county,Trøndelag,2021-01-01,0,0,0,0,0.0,0.0,0,0,fhi:git
county,Trøndelag,2021-01-02,0,0,0,0,0.0,0.0,0,0,fhi:git
county,Trøndelag,2021-01-03,0,0,0,0,0.0,0.0,0,0,fhi:git
county,Trøndelag,2021-01-04,3,0,3,0,0.0006367750316264,0.0,3,3,fhi:git
county,Trøndelag,2021-01-05,407,0,410,0,0.0870259209889541,0.0,407,410,fhi:git
county,Trøndelag,2021-01-06,675,0,1085,0,0.230300303104915,0.0,675,1085,fhi:git
county,Trøndelag,2021-01-07,483,0,1568,0,0.332821083196781,0.0,483,1568,fhi:git
county,Trøndelag,2021-01-08,141,0,1709,0,0.362749509683226,0.0,141,1709,fhi:git
county,Trøndelag,2021-01-09,0,0,1709,0,0.362749509683226,0.0,0,1709,fhi:git
county,Trøndelag,2021-01-10,0,0,1709,0,0.362749509683226,0.0,0,1709,fhi:git
county,Trøndelag,2021-01-11,95,0,1804,0,0.382914052351398,0.0,95,1804,fhi:git
county,Trøndelag,2021-01-12,500,0,2304,0,0.489043224289147,0.0,500,2304,fhi:git
county,Trøndelag,2021-01-13,861,0,3165,0,0.67179765836595,0.0,861,3165,fhi:git
county,Trøndelag,2021-01-14,671,0,3836,0,0.81422300710641,0.0,671,3836,fhi:git
county,Trøndelag,2021-01-15,253,0,4089,0,0.86792436810691,0.0,253,4089,fhi:git
county,Trøndelag,2021-01-16,0,0,4089,0,0.86792436810691,0.0,0,4089,fhi:git
county,Trøndelag,2021-01-17,0,0,4089,0,0.86792436810691,0.0,0,4089,fhi:git
county,Trøndelag,2021-01-18,152,0,4241,0,0.900187636375986,0.0,152,4241,fhi:git
county,Trøndelag,2021-01-19,568,0,4809,0,1.02075037569727,0.0,568,4809,fhi:git
county,Trøndelag,2021-01-20,738,0,5547,0,1.17739703347739,0.0,738,5547,fhi:git
county,Trøndelag,2021-01-21,535,0,6082,0,1.29095524745078,0.0,535,6082,fhi:git
county,Trøndelag,2021-01-22,283,0,6365,0,1.35102435876754,0.0,283,6365,fhi:git
county,Trøndelag,2021-01-23,1,0,6366,0,1.35123661711142,0.0,1,6366,fhi:git
county,Trøndelag,2021-01-24,0,0,6366,0,1.35123661711142,0.0,0,6366,fhi:git
county,Trøndelag,2021-01-25,1,0,6367,0,1.35144887545529,0.0,1,6367,fhi:git
county,Trøndelag,2021-01-26,313,184,6680,184,1.41788573708833,0.0390555352730916,497,6864,fhi:git
county,Trøndelag,2021-01-27,1013,604,7693,788,1.6329034394342,0.167259574973892,1617,8481,fhi:git
county,Trøndelag,2021-01-28,727,483,8420,1271,1.78721525543169,0.269780355065758,1210,9691,fhi:git
county,Trøndelag,2021-01-29,423,229,8843,1500,1.87700053489103,0.318387515813247,652,10343,fhi:git
county,Trøndelag,2021-01-30,1,0,8844,1500,1.8772127932349,0.318387515813247,1,10344,fhi:git
county,Trøndelag,2021-01-31,2,1,8846,1501,1.87763730992265,0.318599774157122,3,10347,fhi:git
county,Trøndelag,2021-02-01,14,86,8860,1587,1.88060892673691,0.336853991730415,100,10447,fhi:git
county,Trøndelag,2021-02-02,836,392,9696,1979,2.05805690221683,0.42005926252961,1228,11675,fhi:git
county,Trøndelag,2021-02-03,2124,811,11820,2790,2.50889362460838,0.592200779412639,2935,14610,fhi:git
county,Trøndelag,2021-02-04,2144,607,13964,3397,2.96397551387745,0.721041594145066,2751,17361,fhi:git
county,Trøndelag,2021-02-05,1292,320,15256,3717,3.23821329416459,0.788964264185225,1612,18973,fhi:git
county,Trøndelag,2021-02-06,7,0,15263,3717,3.23969910257172,0.788964264185225,7,18980,fhi:git
county,Trøndelag,2021-02-07,1,0,15264,3717,3.2399113609156,0.788964264185225,1,18981,fhi:git
county,Trøndelag,2021-02-08,3,150,15267,3867,3.24054813594722,0.82080301576655,153,19134,fhi:git
county,Trøndelag,2021-02-09,836,523,16103,4390,3.41799611142714,0.931814129613435,1359,20493,fhi:git
county,Trøndelag,2021-02-10,2232,628,18335,5018,3.89175673495725,1.06511236956725,2860,23353,fhi:git
county,Trøndelag,2021-02-11,2362,586,20697,5604,4.39311094319118,1.18949575907829,2948,26301,fhi:git
county,Trøndelag,2021-02-12,888,352,21585,5956,4.58159635255262,1.26421069612246,1240,27541,fhi:git
county,Trøndelag,2021-02-13,2,0,21587,5956,4.58202086924037,1.26421069612246,2,27543,fhi:git
county,Trøndelag,2021-02-14,0,0,21587,5956,4.58202086924037,1.26421069612246,0,27543,fhi:git
county,Trøndelag,2021-02-15,0,2,21587,5958,4.58202086924037,1.26463521281022,2,27545,fhi:git
county,Trøndelag,2021-02-16,344,210,21931,6168,4.65503773953354,1.30920946502407,554,28099,fhi:git
county,Trøndelag,2021-02-17,2224,922,24155,7090,5.12710029631265,1.50491165807728,3146,31245,fhi:git
county,Trøndelag,2021-02-18,2120,752,26275,7842,5.5770879853287,1.66452993267165,2872,34117,fhi:git
county,Trøndelag,2021-02-19,1262,410,27537,8252,5.84495801529958,1.75155585366061,1672,35789,fhi:git
county,Trøndelag,2021-02-20,1,1,27538,8253,5.84517027364346,1.75176811200448,2,35791,fhi:git
county,Trøndelag,2021-02-21,0,4,27538,8257,5.84517027364346,1.75261714537998,4,35795,fhi:git
county,Trøndelag,2021-02-22,17,2,27555,8259,5.84877866548934,1.75304166206774,19,35814,fhi:git
county,Trøndelag,2021-02-23,334,674,27889,8933,5.91967295234376,1.89610378583982,1008,36822,fhi:git
county,Trøndelag,2021-02-24,1011,2046,28900,10979,6.13426613800189,2.33038435740909,3057,39879,fhi:git
county,Trøndelag,2021-02-25,474,1983,29374,12962,6.23487659299887,2.7512926533142,2457,42336,fhi:git
county,Trøndelag,2021-02-26,612,1154,29986,14116,6.36477869945068,2.99623878214653,1766,44102,fhi:git
county,Trøndelag,2021-02-27,4,1,29990,14117,6.36562773282618,2.9964510404904,5,44107,fhi:git
county,Trøndelag,2021-02-28,1,0,29991,14117,6.36583999117005,2.9964510404904,1,44108,fhi:git
county,Trøndelag,2021-03-01,526,0,30517,14117,6.47748788004857,2.9964510404904,526,44634,fhi:git
county,Trøndelag,2021-03-02,819,785,31336,14902,6.6513274636826,3.16307384043267,1604,46238,fhi:git
county,Trøndelag,2021-03-03,2017,2142,33353,17044,7.07945254327948,3.61773121301398,4159,50397,fhi:git
county,Trøndelag,2021-03-04,1875,2282,35228,19326,7.47743693804604,4.10210475373787,4157,54554,fhi:git
county,Trøndelag,2021-03-05,1048,982,36276,20308,7.69988368242756,4.31054244742361,2030,56584,fhi:git
county,Trøndelag,2021-03-06,2,0,36278,20308,7.70030819911531,4.31054244742361,2,56586,fhi:git
county,Trøndelag,2021-03-07,0,1,36278,20309,7.70030819911531,4.31075470576748,1,56587,fhi:git
county,Trøndelag,2021-03-08,436,0,36714,20309,7.79285283704502,4.31075470576748,436,57023,fhi:git
county,Trøndelag,2021-03-09,1172,301,37886,20610,8.04161961606711,4.37464446727401,1473,58496,fhi:git
county,Trøndelag,2021-03-10,1684,1500,39570,22110,8.39906266715344,4.69303198308726,3184,61680,fhi:git
county,Trøndelag,2021-03-11,823,1197,40393,23307,8.57375128416298,4.94710522070623,2020,63700,fhi:git
county,Trøndelag,2021-03-12,122,500,40515,23807,8.59964680211579,5.05323439264398,622,64322,fhi:git
county,Trøndelag,2021-03-13,0,1,40515,23808,8.59964680211579,5.05344665098785,1,64323,fhi:git
county,Trøndelag,2021-03-14,0,0,40515,23808,8.59964680211579,5.05344665098785,0,64323,fhi:git
county,Trøndelag,2021-03-15,3,6,40518,23814,8.60028357714742,5.0547202010511,9,64332,fhi:git
county,Trøndelag,2021-03-16,607,12,41125,23826,8.72912439187985,5.05726730117761,619,64951,fhi:git
county,Trøndelag,2021-03-17,1978,122,43103,23948,9.14897139606558,5.08316281913042,2100,67051,fhi:git
county,Trøndelag,2021-03-18,1498,123,44601,24071,9.46693439519107,5.10927059542711,1621,68672,fhi:git
county,Trøndelag,2021-03-19,542,88,45143,24159,9.58197841757159,5.12794932968815,630,69302,fhi:git
county,Trøndelag,2021-03-20,0,0,45143,24159,9.58197841757159,5.12794932968815,0,69302,fhi:git
county,Trøndelag,2021-03-21,0,0,45143,24159,9.58197841757159,5.12794932968815,0,69302,fhi:git
county,Trøndelag,2021-03-22,1,0,45144,24159,9.58219067591547,5.12794932968815,1,69303,fhi:git
county,Trøndelag,2021-03-23,1046,216,46190,24375,9.80421290360924,5.17379713196526,1262,70565,fhi:git
county,Trøndelag,2021-03-24,3146,553,49336,24928,10.4719776534416,5.29117599612841,3699,74264,fhi:git
county,Trøndelag,2021-03-25,2885,304,52221,25232,11.0843429755224,5.35570253266656,3189,77453,fhi:git
county,Trøndelag,2021-03-26,1980,218,54201,25450,11.5046144963959,5.40197485163142,2198,79651,fhi:git
county,Trøndelag,2021-03-27,0,3,54201,25453,11.5046144963959,5.40261162666304,3,79654,fhi:git
county,Trøndelag,2021-03-28,0,0,54201,25453,11.5046144963959,5.40261162666304,0,79654,fhi:git
county,Trøndelag,2021-03-29,3,0,54204,25453,11.5052512714275,5.40261162666304,3,79657,fhi:git
county,Trøndelag,2021-03-30,1875,535,56079,25988,11.903235666194,5.51616984063644,2410,82067,fhi:git
county,Trøndelag,2021-03-31,2535,422,58614,26410,12.4413105679184,5.6057428617519,2957,85024,fhi:git
county,Trøndelag,2021-04-01,163,156,58777,26566,12.4759086779701,5.63885516339647,319,85343,fhi:git
county,Trøndelag,2021-04-02,152,94,58929,26660,12.5081719462392,5.65880744772077,246,85589,fhi:git
county,Trøndelag,2021-04-03,0,0,58929,26660,12.5081719462392,5.65880744772077,0,85589,fhi:git
county,Trøndelag,2021-04-04,0,0,58929,26660,12.5081719462392,5.65880744772077,0,85589,fhi:git
county,Trøndelag,2021-04-05,1,0,58930,26660,12.5083842045831,5.65880744772077,1,85590,fhi:git
county,Trøndelag,2021-04-06,2091,41,61021,26701,12.9522164016267,5.66751003981967,2132,87722,fhi:git
county,Trøndelag,2021-04-07,3348,209,64369,26910,13.6628573369219,5.71187203368964,3557,91279,fhi:git
county,Vestfold og Telemark,2020-12-27,0,0,0,0,0.0,0.0,0,0,fhi:git
county,Vestfold og Telemark,2020-12-28,0,0,0,0,0.0,0.0,0,0,fhi:git
county,Vestfold og Telemark,2020-12-29,0,0,0,0,0.0,0.0,0,0,fhi:git
county,Vestfold og Telemark,2020-12-30,0,0,0,0,0.0,0.0,0,0,fhi:git
county,Vestfold og Telemark,2020-12-31,0,0,0,0,0.0,0.0,0,0,fhi:git
county,Vestfold og Telemark,2021-01-01,0,0,0,0,0.0,0.0,0,0,fhi:git
county,Vestfold og Telemark,2021-01-02,0,0,0,0,0.0,0.0,0,0,fhi:git
county,Vestfold og Telemark,2021-01-03,0,0,0,0,0.0,0.0,0,0,fhi:git
county,Vestfold og Telemark,2021-01-04,1,0,1,0,0.0002370331040433,0.0,1,1,fhi:git
county,Vestfold og Telemark,2021-01-05,218,0,219,0,0.051910249785485,0.0,218,219,fhi:git
county,Vestfold og Telemark,2021-01-06,1026,0,1245,0,0.295106214533922,0.0,1026,1245,fhi:git
county,Vestfold og Telemark,2021-01-07,442,0,1687,0,0.399874846521065,0.0,442,1687,fhi:git
county,Vestfold og Telemark,2021-01-08,63,0,1750,0,0.414807932075794,0.0,63,1750,fhi:git
county,Vestfold og Telemark,2021-01-09,0,0,1750,0,0.414807932075794,0.0,0,1750,fhi:git
county,Vestfold og Telemark,2021-01-10,3,0,1753,0,0.415519031387924,0.0,3,1753,fhi:git
county,Vestfold og Telemark,2021-01-11,3,0,1756,0,0.416230130700054,0.0,3,1756,fhi:git
county,Vestfold og Telemark,2021-01-12,420,0,2176,0,0.515784034398244,0.0,420,2176,fhi:git
county,Vestfold og Telemark,2021-01-13,1164,0,3340,0,0.791690567504658,0.0,1164,3340,fhi:git
county,Vestfold og Telemark,2021-01-14,584,0,3924,0,0.930117900265951,0.0,584,3924,fhi:git
county,Vestfold og Telemark,2021-01-15,157,0,4081,0,0.967332097600751,0.0,157,4081,fhi:git
county,Vestfold og Telemark,2021-01-16,3,0,4084,0,0.968043196912881,0.0,3,4084,fhi:git
county,Vestfold og Telemark,2021-01-17,42,0,4126,0,0.9779985872827,0.0,42,4126,fhi:git
county,Vestfold og Telemark,2021-01-18,7,0,4133,0,0.979657819011003,0.0,7,4133,fhi:git
county,Vestfold og Telemark,2021-01-19,233,0,4366,0,1.03488653225309,0.0,233,4366,fhi:git
county,Vestfold og Telemark,2021-01-20,1606,0,5972,0,1.41556169734665,0.0,1606,5972,fhi:git
county,Vestfold og Telemark,2021-01-21,829,0,6801,0,1.61206214059856,0.0,829,6801,fhi:git
county,Vestfold og Telemark,2021-01-22,181,0,6982,0,1.6549651324304,0.0,181,6982,fhi:git
county,Vestfold og Telemark,2021-01-23,3,0,6985,0,1.65567623174253,0.0,3,6985,fhi:git
county,Vestfold og Telemark,2021-01-24,0,0,6985,0,1.65567623174253,0.0,0,6985,fhi:git
county,Vestfold og Telemark,2021-01-25,44,0,7029,0,1.66610568832043,0.0,44,7029,fhi:git
county,Vestfold og Telemark,2021-01-26,103,179,7132,179,1.69052009803689,0.0424289256237526,282,7311,fhi:git
county,Vestfold og Telemark,2021-01-27,1625,899,8757,1078,2.07569889210727,0.255521686158689,2524,9835,fhi:git
county,Vestfold og Telemark,2021-01-28,655,449,9412,1527,2.23095557525564,0.361949549874135,1104,10939,fhi:git
county,Vestfold og Telemark,2021-01-29,86,91,9498,1618,2.25134042220337,0.383519562342077,177,11116,fhi:git
county,Vestfold og Telemark,2021-01-30,0,0,9498,1618,2.25134042220337,0.383519562342077,0,11116,fhi:git
county,Vestfold og Telemark,2021-01-31,1,2,9499,1620,2.25157745530741,0.383993628550163,3,11119,fhi:git
county,Vestfold og Telemark,2021-02-01,50,1,9549,1621,2.26342911050957,0.384230661654207,51,11170,fhi:git
county,Vestfold og Telemark,2021-02-02,464,327,10013,1948,2.37341247078567,0.461740486676369,791,11961,fhi:git
county,Vestfold og Telemark,2021-02-03,3214,847,13227,2795,3.13523686718087,0.662507525801054,4061,16022,fhi:git
county,Vestfold og Telemark,2021-02-04,1902,709,15129,3504,3.58607383107125,0.830563996567761,2611,18633,fhi:git
county,Vestfold og Telemark,2021-02-05,964,245,16093,3749,3.814573743369,0.888637107058372,1209,19842,fhi:git
county,Vestfold og Telemark,2021-02-06,0,4,16093,3753,3.814573743369,0.889585239474545,4,19846,fhi:git
county,Vestfold og Telemark,2021-02-07,2,1,16095,3754,3.81504780957709,0.889822272578588,3,19849,fhi:git
county,Vestfold og Telemark,2021-02-08,17,46,16112,3800,3.81907737234582,0.900725795364581,63,19912,fhi:git
county,Vestfold og Telemark,2021-02-09,356,208,16468,4008,3.90346115738524,0.950028681005589,564,20476,fhi:git
county,Vestfold og Telemark,2021-02-10,2891,1395,19359,5403,4.58872386117445,1.28068986114601,4286,24762,fhi:git
county,Vestfold og Telemark,2021-02-11,1540,878,20899,6281,4.95375484140115,1.48880492649603,2418,27180,fhi:git
county,Vestfold og Telemark,2021-02-12,602,213,21501,6494,5.09644877003522,1.53929297765726,815,27995,fhi:git
county,Vestfold og Telemark,2021-02-13,2,2,21503,6496,5.09692283624331,1.53976704386535,4,27999,fhi:git
county,Vestfold og Telemark,2021-02-14,0,0,21503,6496,5.09692283624331,1.53976704386535,0,27999,fhi:git
county,Vestfold og Telemark,2021-02-15,4,2,21507,6498,5.09787096865948,1.54024111007343,6,28005,fhi:git
county,Vestfold og Telemark,2021-02-16,579,75,22086,6573,5.23511313590056,1.55801859287668,654,28659,fhi:git
county,Vestfold og Telemark,2021-02-17,3043,1532,25129,8105,5.95640487150435,1.92115330827103,4575,33234,fhi:git
county,Vestfold og Telemark,2021-02-18,1822,629,26951,8734,6.38827918707127,2.07024713071428,2451,35685,fhi:git
county,Vestfold og Telemark,2021-02-19,283,83,27234,8817,6.45535955551552,2.08992087834987,366,36051,fhi:git
county,Vestfold og Telemark,2021-02-20,0,1,27234,8818,6.45535955551552,2.09015791145391,1,36052,fhi:git
county,Vestfold og Telemark,2021-02-21,1,1,27235,8819,6.45559658861957,2.09039494455796,2,36054,fhi:git
county,Vestfold og Telemark,2021-02-22,51,0,27286,8819,6.46768527692578,2.09039494455796,51,36105,fhi:git
county,Vestfold og Telemark,2021-02-23,626,385,27912,9204,6.61606800005689,2.18165268961463,1011,37116,fhi:git
county,Vestfold og Telemark,2021-02-24,669,2869,28581,12073,6.77464314666186,2.86170066511489,3538,40654,fhi:git
county,Vestfold og Telemark,2021-02-25,703,1998,29284,14071,6.94127741880431,3.33529280699343,2701,43355,fhi:git
county,Vestfold og Telemark,2021-02-26,543,845,29827,14916,7.06998639429983,3.53558577991002,1388,44743,fhi:git
county,Vestfold og Telemark,2021-02-27,3,2,29830,14918,7.07069749361196,3.53605984611811,5,44748,fhi:git
county,Vestfold og Telemark,2021-02-28,0,0,29830,14918,7.07069749361196,3.53605984611811,0,44748,fhi:git
county,Vestfold og Telemark,2021-03-01,609,0,30439,14918,7.21505065397433,3.53605984611811,609,45357,fhi:git
county,Vestfold og Telemark,2021-03-02,845,354,31284,15272,7.41534362689093,3.61996956494944,1199,46556,fhi:git
county,Vestfold og Telemark,2021-03-03,1975,2814,33259,18086,7.88348400737647,4.28698071972732,4789,51345,fhi:git
county,Vestfold og Telemark,2021-03-04,1011,1432,34270,19518,8.12312447556426,4.62641212471734,2443,53788,fhi:git
county,Vestfold og Telemark,2021-03-05,1476,585,35746,20103,8.47298533713219,4.76507649058268,2061,55849,fhi:git
county,Vestfold og Telemark,2021-03-06,2,1,35748,20104,8.47345940334027,4.76531352368672,3,55852,fhi:git
county,Vestfold og Telemark,2021-03-07,1,0,35749,20104,8.47369643644431,4.76531352368672,1,55853,fhi:git
county,Vestfold og Telemark,2021-03-08,236,0,35985,20104,8.52963624899853,4.76531352368672,236,56089,fhi:git
county,Vestfold og Telemark,2021-03-09,934,142,36919,20246,8.75102516817499,4.79897222446087,1076,57165,fhi:git
county,Vestfold og Telemark,2021-03-10,1593,2261,38512,22507,9.12861890291598,5.33490407270279,3854,61019,fhi:git
county,Vestfold og Telemark,2021-03-11,298,835,38810,23342,9.19925476792089,5.53282671457896,1133,62152,fhi:git
county,Vestfold og Telemark,2021-03-12,35,126,38845,23468,9.2075509265624,5.56269288568842,161,62313,fhi:git
county,Vestfold og Telemark,2021-03-13,1,1,38846,23469,9.20778795966645,5.56292991879246,2,62315,fhi:git
county,Vestfold og Telemark,2021-03-14,0,0,38846,23469,9.20778795966645,5.56292991879246,0,62315,fhi:git
county,Vestfold og Telemark,2021-03-15,2,3,38848,23472,9.20826202587453,5.56364101810459,5,62320,fhi:git
county,Vestfold og Telemark,2021-03-16,402,25,39250,23497,9.30354933369994,5.56956684570567,427,62747,fhi:git
county,Vestfold og Telemark,2021-03-17,3103,166,42353,23663,10.0390630555463,5.60891434097686,3269,66016,fhi:git
county,Vestfold og Telemark,2021-03-18,911,53,43264,23716,10.2550002133298,5.62147709549116,964,66980,fhi:git
county,Vestfold og Telemark,2021-03-19,27,32,43291,23748,10.261400107139,5.62906215482054,59,67039,fhi:git
county,Vestfold og Telemark,2021-03-20,0,0,43291,23748,10.261400107139,5.62906215482054,0,67039,fhi:git
county,Vestfold og Telemark,2021-03-21,0,0,43291,23748,10.261400107139,5.62906215482054,0,67039,fhi:git
county,Vestfold og Telemark,2021-03-22,0,1,43291,23749,10.261400107139,5.62929918792459,1,67040,fhi:git
county,Vestfold og Telemark,2021-03-23,660,58,43951,23807,10.4178419558075,5.6430471079591,718,67758,fhi:git
county,Vestfold og Telemark,2021-03-24,4610,816,48561,24623,11.5105645654472,5.83646612085844,5426,73184,fhi:git
county,Vestfold og Telemark,2021-03-25,2945,270,51506,24893,12.2086270568548,5.90046505895013,3215,76399,fhi:git
county,Vestfold og Telemark,2021-03-26,897,152,52403,25045,12.4212457511816,5.93649409076472,1049,77448,fhi:git
county,Vestfold og Telemark,2021-03-27,0,0,52403,25045,12.4212457511816,5.93649409076472,0,77448,fhi:git
county,Vestfold og Telemark,2021-03-28,0,0,52403,25045,12.4212457511816,5.93649409076472,0,77448,fhi:git
county,Vestfold og Telemark,2021-03-29,184,3,52587,25048,12.4648598423256,5.93720519007685,187,77635,fhi:git
county,Vestfold og Telemark,2021-03-30,3011,80,55598,25128,13.1785665186,5.95616783840031,3091,80726,fhi:git
county,Vestfold og Telemark,2021-03-31,3391,489,58989,25617,13.9823457744109,6.07207702627749,3880,84606,fhi:git
county,Vestfold og Telemark,2021-04-01,425,17,59414,25634,14.0830848436293,6.07610658904623,442,85048,fhi:git
county,Vestfold og Telemark,2021-04-02,2,3,59416,25637,14.0835589098373,6.07681768835836,5,85053,fhi:git
county,Vestfold og Telemark,2021-04-03,1,0,59417,25637,14.0837959429414,6.07681768835836,1,85054,fhi:git
county,Vestfold og Telemark,2021-04-04,0,0,59417,25637,14.0837959429414,6.07681768835836,0,85054,fhi:git
county,Vestfold og Telemark,2021-04-05,1,1,59418,25638,14.0840329760454,6.0770547214624,2,85056,fhi:git
county,Vestfold og Telemark,2021-04-06,941,40,60359,25678,14.3070811269502,6.08653604562413,981,86037,fhi:git
county,Vestfold og Telemark,2021-04-07,5954,137,66313,25815,15.7183762284241,6.11900958087807,6091,92128,fhi:git
county,Vestland,2020-12-27,0,0,0,0,0.0,0.0,0,0,fhi:git
county,Vestland,2020-12-28,0,0,0,0,0.0,0.0,0,0,fhi:git
county,Vestland,2020-12-29,0,0,0,0,0.0,0.0,0,0,fhi:git
county,Vestland,2020-12-30,0,0,0,0,0.0,0.0,0,0,fhi:git
county,Vestland,2020-12-31,0,0,0,0,0.0,0.0,0,0,fhi:git
county,Vestland,2021-01-01,0,0,0,0,0.0,0.0,0,0,fhi:git
county,Vestland,2021-01-02,0,0,0,0,0.0,0.0,0,0,fhi:git
county,Vestland,2021-01-03,0,0,0,0,0.0,0.0,0,0,fhi:git
county,Vestland,2021-01-04,2,0,2,0,0.0003130767460681,0.0,2,2,fhi:git
county,Vestland,2021-01-05,416,0,418,0,0.0654330399282428,0.0,416,418,fhi:git
county,Vestland,2021-01-06,1256,0,1674,0,0.262045236459039,0.0,1256,1674,fhi:git
county,Vestland,2021-01-07,715,0,2389,0,0.373970173178402,0.0,715,2389,fhi:git
county,Vestland,2021-01-08,139,0,2528,0,0.395729007030138,0.0,139,2528,fhi:git
county,Vestland,2021-01-09,0,0,2528,0,0.395729007030138,0.0,0,2528,fhi:git
county,Vestland,2021-01-10,0,0,2528,0,0.395729007030138,0.0,0,2528,fhi:git
county,Vestland,2021-01-11,65,0,2593,0,0.405904001277353,0.0,65,2593,fhi:git
county,Vestland,2021-01-12,856,0,3449,0,0.53990084859452,0.0,856,3449,fhi:git
county,Vestland,2021-01-13,1127,0,4576,0,0.716319595003921,0.0,1127,4576,fhi:git
county,Vestland,2021-01-14,999,0,5575,0,0.872701429664961,0.0,999,5575,fhi:git
county,Vestland,2021-01-15,425,0,6000,0,0.939230238204442,0.0,425,6000,fhi:git
county,Vestland,2021-01-16,2,0,6002,0,0.93954331495051,0.0,2,6002,fhi:git
county,Vestland,2021-01-17,1,0,6003,0,0.939699853323544,0.0,1,6003,fhi:git
county,Vestland,2021-01-18,62,0,6065,0,0.949405232451657,0.0,62,6065,fhi:git
county,Vestland,2021-01-19,368,0,6433,0,1.0070113537282,0.0,368,6433,fhi:git
county,Vestland,2021-01-20,1235,0,7668,0,1.20033624442528,0.0,1235,7668,fhi:git
county,Vestland,2021-01-21,783,0,8451,0,1.32290579051096,0.0,783,8451,fhi:git
county,Vestland,2021-01-22,312,0,8763,0,1.37174576289759,0.0,312,8763,fhi:git
county,Vestland,2021-01-23,0,0,8763,0,1.37174576289759,0.0,0,8763,fhi:git
county,Vestland,2021-01-24,0,0,8763,0,1.37174576289759,0.0,0,8763,fhi:git
county,Vestland,2021-01-25,2,0,8765,0,1.37205883964366,0.0,2,8765,fhi:git
county,Vestland,2021-01-26,152,174,8917,174,1.39585267234484,0.0272376769079288,326,9091,fhi:git
county,Vestland,2021-01-27,1590,1211,10507,1385,1.64474868546901,0.216805646652192,2801,11892,fhi:git
county,Vestland,2021-01-28,1958,695,12465,2080,1.95125081986973,0.325599815910873,2653,14545,fhi:git
county,Vestland,2021-01-29,481,176,12946,2256,2.02654577729912,0.35315056956487,657,15202,fhi:git
county,Vestland,2021-01-30,3,0,12949,2256,2.02701539241822,0.35315056956487,3,15205,fhi:git
county,Vestland,2021-01-31,1,0,12950,2256,2.02717193079125,0.35315056956487,1,15206,fhi:git
county,Vestland,2021-02-01,13,59,12963,2315,2.0292069296407,0.362386333573881,72,15278,fhi:git
county,Vestland,2021-02-02,720,582,13683,2897,2.14191455822523,0.453491666679712,1302,16580,fhi:git
county,Vestland,2021-02-03,2830,1049,16513,3946,2.58491815391166,0.617700419992455,3879,20459,fhi:git
county,Vestland,2021-02-04,2588,1114,19101,5060,2.99003946332384,0.792084167552413,3702,24161,fhi:git
county,Vestland,2021-02-05,911,487,20012,5547,3.13264592115788,0.868318355220007,1398,25559,fhi:git
county,Vestland,2021-02-06,0,2,20012,5549,3.13264592115788,0.868631431966075,2,25561,fhi:git
county,Vestland,2021-02-07,2,1,20014,5550,3.13295899790395,0.868787970339109,3,25564,fhi:git
county,Vestland,2021-02-08,8,49,20022,5599,3.13421130488822,0.876458350617779,57,25621,fhi:git
county,Vestland,2021-02-09,891,307,20913,5906,3.27368699526158,0.924515631139239,1198,26819,fhi:git
county,Vestland,2021-02-10,2758,971,23671,6877,3.70541982808956,1.07651439135532,3729,30548,fhi:git
county,Vestland,2021-02-11,2703,836,26374,7713,4.12854305040066,1.20738047121181,3539,34087,fhi:git
county,Vestland,2021-02-12,626,458,27000,8171,4.22653607191999,1.27907504606142,1084,35171,fhi:git
county,Vestland,2021-02-13,0,0,27000,8171,4.22653607191999,1.27907504606142,0,35171,fhi:git
county,Vestland,2021-02-14,0,2,27000,8173,4.22653607191999,1.27938812280748,2,35173,fhi:git
county,Vestland,2021-02-15,94,1,27094,8174,4.24125067898519,1.27954466118052,95,35268,fhi:git
county,Vestland,2021-02-16,1087,55,28181,8229,4.41140789047323,1.28815427169739,1142,36410,fhi:git
county,Vestland,2021-02-17,2690,1328,30871,9557,4.83249611393489,1.49603723108664,4018,40428,fhi:git
county,Vestland,2021-02-18,2006,1999,32877,11556,5.14651209024124,1.80895743878176,4005,44433,fhi:git
county,Vestland,2021-02-19,1157,540,34034,12096,5.32762698784167,1.89348816022016,1697,46130,fhi:git
county,Vestland,2021-02-20,3,4,34037,12100,5.32809660296077,1.89411431371229,7,46137,fhi:git
county,Vestland,2021-02-21,0,1,34037,12101,5.32809660296077,1.89427085208533,1,46138,fhi:git
county,Vestland,2021-02-22,48,2,34085,12103,5.3356104448664,1.89458392883139,50,46188,fhi:git
county,Vestland,2021-02-23,542,591,34627,12694,5.42045424305087,1.98709810729453,1133,47321,fhi:git
county,Vestland,2021-02-24,1414,2401,36041,15095,5.64179950252105,2.36294674094934,3815,51136,fhi:git
county,Vestland,2021-02-25,1258,2645,37299,17740,5.83872477579792,2.77699073762447,3903,55039,fhi:git
county,Vestland,2021-02-26,1426,875,38725,18615,6.0619484957445,2.91396181402928,2301,57340,fhi:git
county,Vestland,2021-02-27,1,0,38726,18615,6.06210503411754,2.91396181402928,1,57341,fhi:git
county,Vestland,2021-02-28,0,7,38726,18622,6.06210503411754,2.91505758264052,7,57348,fhi:git
county,Vestland,2021-03-01,440,11,39166,18633,6.13098191825253,2.9167795047439,451,57799,fhi:git
county,Vestland,2021-03-02,1351,757,40517,19390,6.34246526022157,3.03527905313069,2108,59907,fhi:git
county,Vestland,2021-03-03,1743,2045,42260,21435,6.61531164441996,3.35540002598537,3788,63695,fhi:git
county,Vestland,2021-03-04,1795,2848,44055,24283,6.89629802401612,3.80122131238641,4643,68338,fhi:git
county,Vestland,2021-03-05,1248,900,45303,25183,7.09165791356264,3.94210584811708,2148,70486,fhi:git
county,Vestland,2021-03-06,1,6,45304,25189,7.09181445193568,3.94304507835528,7,70493,fhi:git
county,Vestland,2021-03-07,2,0,45306,25189,7.09212752868174,3.94304507835528,2,70495,fhi:git
county,Vestland,2021-03-08,636,14,45942,25203,7.19168593393142,3.94523661557776,650,71145,fhi:git
county,Vestland,2021-03-09,1500,527,47442,25730,7.42649349348253,4.02773233816672,2027,73172,fhi:git
county,Vestland,2021-03-10,2480,1831,49922,27561,7.81470865860703,4.31435409919211,4311,77483,fhi:git
county,Vestland,2021-03-11,1402,1543,51324,29104,8.0341754576008,4.55589280878368,2945,80428,fhi:git
county,Vestland,2021-03-12,179,976,51503,30080,8.0621958263739,4.70867426086494,1155,81583,fhi:git
county,Vestland,2021-03-13,8,10,51511,30090,8.06344813335817,4.71023964459528,18,81601,fhi:git
county,Vestland,2021-03-14,0,0,51511,30090,8.06344813335817,4.71023964459528,0,81601,fhi:git
county,Vestland,2021-03-15,7,8,51518,30098,8.06454390196941,4.71149195157955,15,81616,fhi:git
county,Vestland,2021-03-16,1195,33,52713,30131,8.25160725774513,4.71665771788967,1228,82844,fhi:git
county,Vestland,2021-03-17,2429,222,55142,30353,8.63183896584489,4.75140923670324,2651,85495,fhi:git
county,Vestland,2021-03-18,2313,145,57455,30498,8.99391222267271,4.77410730079318,2458,87953,fhi:git
county,Vestland,2021-03-19,587,115,58042,30613,9.08580024764371,4.7921092136921,702,88655,fhi:git
county,Vestland,2021-03-20,1,2,58043,30615,9.08595678601674,4.79242229043817,3,88658,fhi:git
county,Vestland,2021-03-21,0,0,58043,30615,9.08595678601674,4.79242229043817,0,88658,fhi:git
county,Vestland,2021-03-22,8,13,58051,30628,9.08720909300101,4.79445728928761,21,88679,fhi:git
county,Vestland,2021-03-23,2050,339,60101,30967,9.40811275772086,4.84752379774616,2389,91068,fhi:git
county,Vestland,2021-03-24,4020,514,64121,31481,10.0373970173178,4.92798452148568,4534,95602,fhi:git
county,Vestland,2021-03-25,3130,374,67251,31855,10.5273621249145,4.98652987300042,3504,99106,fhi:git
county,Vestland,2021-03-26,996,188,68247,32043,10.6832743444564,5.01595908713082,1184,100290,fhi:git
county,Vestland,2021-03-27,2,0,68249,32043,10.6835874212025,5.01595908713082,2,100292,fhi:git
county,Vestland,2021-03-28,0,0,68249,32043,10.6835874212025,5.01595908713082,0,100292,fhi:git
county,Vestland,2021-03-29,115,2,68364,32045,10.7015893341014,5.01627216387689,117,100409,fhi:git
county,Vestland,2021-03-30,3565,569,71929,32614,11.2596486339679,5.10534249813328,4134,104543,fhi:git
county,Vestland,2021-03-31,3361,1111,75290,33725,11.7857741057354,5.27925663057414,4472,109015,fhi:git
county,Vestland,2021-04-01,950,233,76240,33958,11.9344855601178,5.31573007149108,1183,110198,fhi:git
county,Vestland,2021-04-02,53,89,76293,34047,11.9427820938886,5.32966198669111,142,110340,fhi:git
county,Vestland,2021-04-03,0,0,76293,34047,11.9427820938886,5.32966198669111,0,110340,fhi:git
county,Vestland,2021-04-04,0,2,76293,34049,11.9427820938886,5.32997506343718,2,110342,fhi:git
county,Vestland,2021-04-05,1,1,76294,34050,11.9429386322616,5.33013160181021,2,110344,fhi:git
county,Vestland,2021-04-06,3067,96,79361,34146,12.4230418223571,5.34515928562148,3163,113507,fhi:git
county,Vestland,2021-04-07,7069,136,86430,34282,13.529611581335,5.36644850435412,7205,120712,fhi:git
county,Viken,2020-12-27,0,0,0,0,0.0,0.0,0,0,fhi:git
county,Viken,2020-12-28,65,0,65,0,0.0052370152236004,0.0,65,65,fhi:git
county,Viken,2020-12-29,689,0,754,0,0.0607493765937647,0.0,689,754,fhi:git
county,Viken,2020-12-30,219,0,973,0,0.0783940894240492,0.0,219,973,fhi:git
county,Viken,2020-12-31,67,0,1040,0,0.0837922435776065,0.0,67,1040,fhi:git
county,Viken,2021-01-01,0,0,1040,0,0.0837922435776065,0.0,0,1040,fhi:git
county,Viken,2021-01-02,0,0,1040,0,0.0837922435776065,0.0,0,1040,fhi:git
county,Viken,2021-01-03,0,0,1040,0,0.0837922435776065,0.0,0,1040,fhi:git
county,Viken,2021-01-04,0,0,1040,0,0.0830416230165828,0.0,0,1040,fhi:git
county,Viken,2021-01-05,526,0,1566,0,0.125041520811508,0.0,526,1566,fhi:git
county,Viken,2021-01-06,1649,0,3215,0,0.256710401921455,0.0,1649,3215,fhi:git
county,Viken,2021-01-07,1922,0,5137,0,0.410177709073256,0.0,1922,5137,fhi:git
county,Viken,2021-01-08,282,0,5419,0,0.43269476454506,0.0,282,5419,fhi:git
county,Viken,2021-01-09,6,0,5425,0,0.433173850831694,0.0,6,5425,fhi:git
county,Viken,2021-01-10,5,0,5430,0,0.433573089403889,0.0,5,5430,fhi:git
county,Viken,2021-01-11,59,0,5489,0,0.438284104555791,0.0,59,5489,fhi:git
county,Viken,2021-01-12,788,0,6277,0,0.50120410353374,0.0,788,6277,fhi:git
county,Viken,2021-01-13,1945,0,8222,0,0.656507908117638,0.0,1945,8222,fhi:git
county,Viken,2021-01-14,1951,0,10173,0,0.81229079898817,0.0,1951,10173,fhi:git
county,Viken,2021-01-15,1050,0,11223,0,0.896130899149143,0.0,1050,11223,fhi:git
county,Viken,2021-01-16,90,0,11313,0,0.903317193448655,0.0,90,11313,fhi:git
county,Viken,2021-01-17,23,0,11336,0,0.905153690880752,0.0,23,11336,fhi:git
county,Viken,2021-01-18,144,51,11480,51,0.916651761759971,0.0040722334363901,195,11531,fhi:git
county,Viken,2021-01-19,649,384,12129,435,0.968472928430897,0.0347337557809745,1033,12564,fhi:git
county,Viken,2021-01-20,1492,342,13621,777,1.08760571837392,0.06204167411912,1834,14398,fhi:git
county,Viken,2021-01-21,1997,100,15618,877,1.24706160410864,0.0700264455630222,2097,16495,fhi:git
county,Viken,2021-01-22,820,1,16438,878,1.31253672994864,0.0701062932774612,821,17316,fhi:git
county,Viken,2021-01-23,98,0,16536,878,1.32036180596367,0.0701062932774612,98,17414,fhi:git
county,Viken,2021-01-24,0,0,16536,878,1.32036180596367,0.0701062932774612,0,17414,fhi:git
county,Viken,2021-01-25,62,0,16598,878,1.32531236425889,0.0701062932774612,62,17476,fhi:git
county,Viken,2021-01-26,563,402,17161,1280,1.37026662748805,0.102205074481948,965,18441,fhi:git
county,Viken,2021-01-27,1942,1218,19103,2498,1.52533088892864,0.199459590668677,3160,21601,fhi:git
county,Viken,2021-01-28,3105,1710,22208,4208,1.7732580422618,0.335999182359404,4815,26416,fhi:git
county,Viken,2021-01-29,1041,427,23249,4635,1.85637951299282,0.370094156424867,1468,27884,fhi:git
county,Viken,2021-01-30,11,18,23260,4653,1.85725783785165,0.371531415284769,29,27913,fhi:git
county,Viken,2021-01-31,10,3,23270,4656,1.85805631499604,0.371770958428086,13,27926,fhi:git
county,Viken,2021-02-01,36,47,23306,4703,1.86093083271584,0.37552380100672,83,28009,fhi:git
county,Viken,2021-02-02,1024,687,24330,5390,1.9426948923014,0.430379180826328,1711,29720,fhi:git
county,Viken,2021-02-03,4777,1723,29107,7113,2.32412742417661,0.567956792804763,6500,36220,fhi:git
county,Viken,2021-02-04,6643,1750,35750,8863,2.85455579119503,0.707690293073051,8393,44613,fhi:git
county,Viken,2021-02-05,3146,1099,38896,9962,3.1057567008202,0.795442931241536,4245,48858,fhi:git
county,Viken,2021-02-06,38,90,38934,10052,3.10879091396888,0.802629225541048,128,48986,fhi:git
county,Viken,2021-02-07,16,20,38950,10072,3.1100684773999,0.804226179829829,36,49022,fhi:git
county,Viken,2021-02-08,15,95,38965,10167,3.11126619311649,0.811811712701536,110,49132,fhi:git
county,Viken,2021-02-09,795,566,39760,10733,3.17474512609551,0.857005519074022,1361,50493,fhi:git
county,Viken,2021-02-10,3446,1325,43206,12058,3.44990035005238,0.962803740705726,4771,55264,fhi:git
county,Viken,2021-02-11,4849,1917,48055,13975,3.8370819173672,1.11587180928533,6766,62030,fhi:git
county,Viken,2021-02-12,2429,979,50484,14954,4.03103201573958,1.19404272172113,3408,65438,fhi:git
county,Viken,2021-02-13,24,97,50508,15051,4.03294836088612,1.20178795002172,121,65559,fhi:git
county,Viken,2021-02-14,6,0,50514,15051,4.03342744717275,1.20178795002172,6,65565,fhi:git
county,Viken,2021-02-15,357,125,50871,15176,4.06193308122748,1.2117689143266,482,66047,fhi:git
county,Viken,2021-02-16,1426,359,52297,15535,4.17579592201753,1.24043424381021,1785,67832,fhi:git
county,Viken,2021-02-17,4430,1813,56727,17348,4.5295212969824,1.38519815008815,6243,74075,fhi:git
county,Viken,2021-02-18,4893,2926,61620,20274,4.92021616373253,1.61883256253673,7819,81894,fhi:git
county,Viken,2021-02-19,3798,1282,65418,21556,5.22347778317193,1.72119733244756,5080,86974,fhi:git
county,Viken,2021-02-20,30,10,65448,21566,5.22587321460511,1.72199580959195,40,87014,fhi:git
county,Viken,2021-02-21,1,9,65449,21575,5.22595306231955,1.7227144390219,10,87024,fhi:git
county,Viken,2021-02-22,703,8,66152,21583,5.28208600557018,1.72335322073741,711,87735,fhi:git
county,Viken,2021-02-23,2125,756,68277,22339,5.4517623987531,1.78371809285331,2881,90616,fhi:git
county,Viken,2021-02-24,2468,4211,70745,26550,5.6488265579886,2.11995681835603,6679,97295,fhi:git
county,Viken,2021-02-25,2543,6271,73288,32821,5.85187929580704,2.62068183560314,8814,106109,fhi:git
county,Viken,2021-02-26,1929,2722,75217,35543,6.00590553695991,2.83802731430616,4651,110760,fhi:git
county,Viken,2021-02-27,165,89,75382,35632,6.01908040984235,2.84513376089123,254,111014,fhi:git
county,Viken,2021-02-28,416,1,75798,35633,6.05229705904898,2.84521360860567,417,111431,fhi:git
county,Viken,2021-03-01,1521,2,77319,35635,6.17374543271073,2.84537330403455,1523,112954,fhi:git
county,Viken,2021-03-02,3018,520,80337,36155,6.4147258348877,2.88689411554284,3538,116492,fhi:git
county,Viken,2021-03-03,4957,2698,85294,38853,6.81053095536193,3.10232324909932,7655,124147,fhi:git
county,Viken,2021-03-04,4399,3261,89693,42114,7.16178105117919,3.36270664588497,7660,131807,fhi:git
county,Viken,2021-03-05,2723,1782,92416,43896,7.37920637759665,3.50499527301531,4505,136312,fhi:git
county,Viken,2021-03-06,210,2,92626,43898,7.39597439762884,3.50515496844418,212,136524,fhi:git
county,Viken,2021-03-07,17,0,92643,43898,7.39733180877431,3.50515496844418,17,136541,fhi:git
county,Viken,2021-03-08,1135,22,93778,43920,7.4879589646626,3.50691161816184,1157,137698,fhi:git
county,Viken,2021-03-09,2889,715,96667,44635,7.71863901167693,3.56400273398574,3604,141302,fhi:git
county,Viken,2021-03-10,5391,3207,102058,47842,8.1490980402177,3.82007435419169,8598,149900,fhi:git
county,Viken,2021-03-11,3413,4763,105471,52605,8.42161828959808,4.20038901806475,8176,158076,fhi:git
county,Viken,2021-03-12,1220,3306,106691,55911,8.51903250121369,4.46436556200015,4526,162602,fhi:git
county,Viken,2021-03-13,7,8,106698,55919,8.51959143521476,4.46500434371567,15,162617,fhi:git
county,Viken,2021-03-14,2,5,106700,55924,8.51975113064364,4.46540358228786,7,162624,fhi:git
county,Viken,2021-03-15,35,48,106735,55972,8.522545800649,4.46923627258093,83,162707,fhi:git
county,Viken,2021-03-16,774,303,107509,56275,8.58434793162481,4.49343013005596,1077,163784,fhi:git
county,Viken,2021-03-17,3983,413,111492,56688,8.90238137823543,4.52640723611927,4396,168180,fhi:git
county,Viken,2021-03-18,5904,435,117396,57123,9.37380228428341,4.56114099190025,6339,174519,fhi:git
county,Viken,2021-03-19,2030,365,119426,57488,9.53589314459463,4.59028540767049,2395,176914,fhi:git
county,Viken,2021-03-20,6,2,119432,57490,9.53637223088126,4.59044510309937,8,176922,fhi:git
county,Viken,2021-03-21,6,1,119438,57491,9.5368513171679,4.59052495081381,7,176929,fhi:git
county,Viken,2021-03-22,400,24,119838,57515,9.56879040294351,4.59244129596034,424,177353,fhi:git
county,Viken,2021-03-23,2468,81,122306,57596,9.76585456217901,4.59890896082991,2549,179902,fhi:git
county,Viken,2021-03-24,7378,747,129684,58343,10.3549709993101,4.65855520351586,8125,188027,fhi:git
county,Viken,2021-03-25,10200,621,139884,58964,11.1694176865881,4.70814063418249,10821,198848,fhi:git
county,Viken,2021-03-26,5888,314,145772,59278,11.6395610292051,4.73321281651634,6202,205050,fhi:git
county,Viken,2021-03-27,4,1,145776,59279,11.6398804200629,4.73329266423078,5,205055,fhi:git
county,Viken,2021-03-28,5,0,145781,59279,11.6402796586351,4.73329266423078,5,205060,fhi:git
county,Viken,2021-03-29,1315,4,147096,59283,11.7452794031224,4.73361205508854,1319,206379,fhi:git
county,Viken,2021-03-30,6057,1602,153153,60885,12.2289170094795,4.86152809361985,7659,214038,fhi:git
county,Viken,2021-03-31,9880,1811,163033,62696,13.0178124281371,5.00613230446892,11691,225729,fhi:git
county,Viken,2021-04-01,3671,477,166704,63173,13.3109333878427,5.04421966425633,4148,229877,fhi:git
county,Viken,2021-04-02,2258,264,168962,63437,13.491229527046,5.06529946086823,2522,232399,fhi:git
county,Viken,2021-04-03,4,0,168966,63437,13.4915489179038,5.06529946086823,4,232403,fhi:git
county,Viken,2021-04-04,13,0,168979,63437,13.4925869381915,5.06529946086823,13,232416,fhi:git
county,Viken,2021-04-05,52,1,169031,63438,13.4967390193423,5.06537930858267,53,232469,fhi:git
county,Viken,2021-04-06,3381,2069,172412,65507,13.7667041418606,5.23058422975701,5450,237919,fhi:git
county,Viken,2021-04-07,10863,2443,183275,67950,14.6340898638117,5.42565219613154,13306,251225,fhi:git
nation,Norge,2020-12-27,5,0,5,0,9.31518486915891e-05,0.0,5,5,fhi:git
nation,Norge,2020-12-28,604,0,609,0,0.0113458951706356,0.0,604,609,fhi:git
nation,Norge,2020-12-29,1067,0,1676,0,0.0312244996814207,0.0,1067,1676,fhi:git
nation,Norge,2020-12-30,427,0,2103,0,0.0391796675596824,0.0,427,2103,fhi:git
nation,Norge,2020-12-31,72,0,2175,0,0.0405210541808413,0.0,72,2175,fhi:git
nation,Norge,2021-01-01,6,0,2181,0,0.0406328363992712,0.0,6,2181,fhi:git
nation,Norge,2021-01-02,0,0,2181,0,0.0406328363992712,0.0,0,2181,fhi:git
nation,Norge,2021-01-03,3,0,2184,0,0.0406887275084861,0.0,3,2184,fhi:git
nation,Norge,2021-01-04,6,0,2190,0,0.0406204806237525,0.0,6,2190,fhi:git
nation,Norge,2021-01-05,3385,0,5575,0,0.103406018026219,0.0,3385,5575,fhi:git
nation,Norge,2021-01-06,9065,0,14640,0,0.271545130745085,0.0,9065,14640,fhi:git
nation,Norge,2021-01-07,6552,0,21192,0,0.393072705652312,0.0,6552,21192,fhi:git
nation,Norge,2021-01-08,1616,0,22808,0,0.423046539756414,0.0,1616,22808,fhi:git
nation,Norge,2021-01-09,135,0,22943,0,0.425550541986646,0.0,135,22943,fhi:git
nation,Norge,2021-01-10,108,0,23051,0,0.427553743770831,0.0,108,23051,fhi:git
nation,Norge,2021-01-11,356,0,23407,0,0.434156890392774,0.0,356,23407,fhi:git
nation,Norge,2021-01-12,4260,0,27667,0,0.513172071880074,0.0,4260,27667,fhi:git
nation,Norge,2021-01-13,9778,0,37445,0,0.694536026007495,0.0,9778,37445,fhi:git
nation,Norge,2021-01-14,8473,0,45918,0,0.85169462524268,0.0,8473,45918,fhi:git
nation,Norge,2021-01-15,4477,0,50395,0,0.934734758463017,0.0,4477,50395,fhi:git
nation,Norge,2021-01-16,746,0,51141,0,0.948571689305629,0.0,746,51141,fhi:git
nation,Norge,2021-01-17,349,5,51490,5,0.955044998774894,9.27408233419007e-05,354,51495,fhi:git
nation,Norge,2021-01-18,1284,283,52774,288,0.978860842209094,0.0053418714244934,1567,53062,fhi:git
nation,Norge,2021-01-19,4590,772,57364,1060,1.06399691803696,0.019661054548483,5362,58424,fhi:git
nation,Norge,2021-01-20,10062,693,67426,1753,1.2506285509302,0.0325149326636704,10755,69179,fhi:git
nation,Norge,2021-01-21,8440,169,75866,1922,1.40717506073133,0.0356495724926266,8609,77788,fhi:git
nation,Norge,2021-01-22,3317,7,79183,1929,1.46869932293635,0.0357794096453053,3324,81112,fhi:git
nation,Norge,2021-01-23,359,0,79542,1929,1.47535811405229,0.0357794096453053,359,81471,fhi:git
nation,Norge,2021-01-24,67,0,79609,1929,1.47660084108508,0.0357794096453053,67,81538,fhi:git
nation,Norge,2021-01-25,581,0,80190,1929,1.4873773247574,0.0357794096453053,581,82119,fhi:git
nation,Norge,2021-01-26,2278,2142,82468,4071,1.52963004387197,0.0755095783649756,4420,86539,fhi:git
nation,Norge,2021-01-27,11417,7596,93885,11667,1.74139443989087,0.216401437185991,19013,105552,fhi:git
nation,Norge,2021-01-28,10901,6572,104786,18239,1.94358798294088,0.338299975386586,17473,123025,fhi:git
nation,Norge,2021-01-29,3813,2108,108599,20347,2.01431213482142,0.377399506507531,5921,128946,fhi:git
nation,Norge,2021-01-30,148,172,108747,20519,2.01705726319234,0.380589790830492,320,129266,fhi:git
nation,Norge,2021-01-31,102,51,108849,20570,2.01894917598851,0.38153574722858,153,129419,fhi:git
nation,Norge,2021-02-01,198,304,109047,20874,2.02262171259285,0.387174389287767,502,129921,fhi:git
nation,Norge,2021-02-02,6354,3144,115401,24018,2.14047675089574,0.445489819005154,9498,139419,fhi:git
nation,Norge,2021-02-03,25136,8320,140537,32338,2.60670341800014,0.599810549046077,33456,172875,fhi:git
nation,Norge,2021-02-04,25970,8663,166507,41001,3.08839925443797,0.760493299568254,34633,207508,fhi:git
nation,Norge,2021-02-05,10629,4865,177136,45866,3.28554769669819,0.850730120679924,15494,223002,fhi:git
nation,Norge,2021-02-06,809,737,177945,46603,3.30055316191491,0.86440011804052,1546,224548,fhi:git
nation,Norge,2021-02-07,324,296,178269,46899,3.30656276726746,0.86989037478236,620,225168,fhi:git
nation,Norge,2021-02-08,123,922,178392,47821,3.30884419152167,0.886991782606607,1045,226213,fhi:git
nation,Norge,2021-02-09,5544,3241,183936,51062,3.41167521644317,0.947106384296827,8785,234998,fhi:git
nation,Norge,2021-02-10,22996,8666,206932,59728,3.83820881115724,1.10784477931301,31662,266660,fhi:git
nation,Norge,2021-02-11,20944,8579,227876,68307,4.22668157197179,1.26696948400304,29523,296183,fhi:git
nation,Norge,2021-02-12,8050,3613,235926,71920,4.37599429755225,1.3339840029499,11663,307846,fhi:git
nation,Norge,2021-02-13,894,306,236820,72226,4.39257635676579,1.33965974133842,1200,309046,fhi:git
nation,Norge,2021-02-14,110,3,236930,72229,4.39461665487931,1.33971538583243,113,309159,fhi:git
nation,Norge,2021-02-15,804,751,237734,72980,4.40952937927269,1.35364505749838,1555,310714,fhi:git
nation,Norge,2021-02-16,6027,2175,243761,75155,4.52131916772901,1.39398731565211,8202,318916,fhi:git
nation,Norge,2021-02-17,21815,10206,265576,85361,4.92594737996973,1.5832898842576,32021,350937,fhi:git
nation,Norge,2021-02-18,18899,10818,284475,96179,5.27648914403744,1.78394392964013,29717,380654,fhi:git
nation,Norge,2021-02-19,10737,4799,295212,100978,5.47564078808184,1.87295657188369,15536,396190,fhi:git
nation,Norge,2021-02-20,502,173,295714,101151,5.48495196674537,1.87616540437132,675,396865,fhi:git
nation,Norge,2021-02-21,58,102,295772,101253,5.48602776029613,1.8780573171675,160,397025,fhi:git
nation,Norge,2021-02-22,2573,141,298345,101394,5.53375218798788,1.88067260838574,2714,399739,fhi:git
nation,Norge,2021-02-23,5749,5206,304094,106600,5.64038558666639,1.97723435364932,10955,410694,fhi:git
nation,Norge,2021-02-24,11054,22360,315148,128960,5.84541699891067,2.3919713156343,33414,444108,fhi:git
nation,Norge,2021-02-25,11151,25103,326299,154063,6.05224758312777,2.85758589330465,36254,480362,fhi:git
nation,Norge,2021-02-26,8330,9935,334629,163998,6.20675379481538,3.04186190928501,18265,498627,fhi:git
nation,Norge,2021-02-27,440,203,335069,164201,6.21491498726947,3.04562718671269,643,499270,fhi:git
nation,Norge,2021-02-28,538,159,335607,164360,6.22489389986106,3.04857634489496,697,499967,fhi:git
nation,Norge,2021-03-01,5927,63,341534,164423,6.33482887185055,3.04974487926907,5990,505957,fhi:git
nation,Norge,2021-03-02,10534,3824,352068,168247,6.53021523846726,3.12067306096095,14358,520315,fhi:git
nation,Norge,2021-03-03,17654,18070,369722,186317,6.85766453752284,3.45583839651858,35724,556039,fhi:git
nation,Norge,2021-03-04,16258,18476,385980,204793,7.15922059870137,3.79853428693158,34734,590773,fhi:git
nation,Norge,2021-03-05,11892,6536,397872,211329,7.37979537293775,3.91976509120411,18428,609201,fhi:git
nation,Norge,2021-03-06,381,479,398253,211808,7.3868622236764,3.92864966208026,860,610061,fhi:git
nation,Norge,2021-03-07,92,2,398345,211810,7.38856865482589,3.9286867584096,94,610155,fhi:git
nation,Norge,2021-03-08,4919,46,403264,211856,7.47980707682965,3.92953997398434,4965,615120,fhi:git
nation,Norge,2021-03-09,12443,4271,415707,216127,7.71060188979831,4.008759185283,16714,631834,fhi:git
nation,Norge,2021-03-10,21006,17207,436713,233334,8.1002246368223,4.32791745473181,38213,670047,fhi:git
nation,Norge,2021-03-11,11951,16570,448664,249904,8.32189375277411,4.63526054328687,28521,698568,fhi:git
nation,Norge,2021-03-12,2315,8305,450979,258209,8.36483275398141,4.78930305085777,10620,709188,fhi:git
nation,Norge,2021-03-13,34,305,451013,258514,8.36546339158013,4.79496024108163,339,709527,fhi:git
nation,Norge,2021-03-14,3,109,451016,258623,8.36551903607414,4.79698199103048,112,709639,fhi:git
nation,Norge,2021-03-15,99,437,451115,259060,8.36735530437631,4.80508753899056,536,710175,fhi:git
nation,Norge,2021-03-16,5649,626,456764,259686,8.47213388658799,4.81669869007297,6275,716450,fhi:git
nation,Norge,2021-03-17,23026,1556,479790,261242,8.89922392624211,4.84555963429697,24582,741032,fhi:git
nation,Norge,2021-03-18,20988,1405,500778,262647,9.28851280630207,4.87161980565604,22393,763425,fhi:git
nation,Norge,2021-03-19,6753,970,507531,263617,9.41376856230764,4.88961152538437,7723,771148,fhi:git
nation,Norge,2021-03-20,458,22,507989,263639,9.42226362172576,4.89001958500707,480,771628,fhi:git
nation,Norge,2021-03-21,187,68,508176,263707,9.42573212851875,4.89128086020452,255,771883,fhi:git
nation,Norge,2021-03-22,1504,85,509680,263792,9.45362856817999,4.89285745420134,1589,773472,fhi:git
nation,Norge,2021-03-23,13093,953,522773,264745,9.69647968818309,4.9105338551303,14046,787518,fhi:git
nation,Norge,2021-03-24,39061,3658,561834,268403,10.4209895482947,4.97838304148724,42719,830237,fhi:git
nation,Norge,2021-03-25,38650,2328,600484,270731,11.1378761127276,5.02156316883523,40978,871215,fhi:git
nation,Norge,2021-03-26,17305,1143,617789,271874,11.4588521023139,5.04276372105118,18448,889663,fhi:git
nation,Norge,2021-03-27,566,6,618355,271880,11.4693503635162,5.04287501003919,572,890235,fhi:git
nation,Norge,2021-03-28,329,3,618684,271883,11.4754527096921,5.0429306545332,332,890567,fhi:git
nation,Norge,2021-03-29,4728,26,623412,271909,11.5631484322442,5.04341290681458,4754,895321,fhi:git
nation,Norge,2021-03-30,31803,4006,655215,275915,12.1530357131927,5.11771685447611,35809,931130,fhi:git
nation,Norge,2021-03-31,36138,6917,691353,282832,12.8233292879786,5.24601450948729,43055,974185,fhi:git
nation,Norge,2021-04-01,9395,1463,700748,284295,12.9975892950381,5.27315047439713,10858,985043,fhi:git
nation,Norge,2021-04-02,4268,668,705016,284963,13.0767528618427,5.28554064839561,4936,989979,fhi:git
nation,Norge,2021-04-03,260,6,705276,284969,13.0815753846565,5.28565193738362,266,990245,fhi:git
nation,Norge,2021-04-04,388,43,705664,285012,13.0887720725478,5.28644950846436,431,990676,fhi:git
nation,Norge,2021-04-05,1307,56,706971,285068,13.1130145237694,5.28748820568579,1363,992039,fhi:git
nation,Norge,2021-04-06,18371,2528,725342,287596,13.4537628568922,5.33437796596746,20899,1012938,fhi:git
nation,Norge,2021-04-07,53564,3516,778906,291112,14.4472767491893,5.39959331294148,57080,1070018,fhi:git
