granularity_geo,location_name,date,new_dose_1,new_dose_2,total_dose_1,total_dose_2,total_pr100_dose_1,total_pr100_dose_2,new_doses,total_doses,source
county,Agder,2020-12-27,0,0,0,0,0.0,0.0,0,0,fhi:git
county,Agder,2020-12-28,0,0,0,0,0.0,0.0,0,0,fhi:git
county,Agder,2020-12-29,0,0,0,0,0.0,0.0,0,0,fhi:git
county,Agder,2020-12-30,0,0,0,0,0.0,0.0,0,0,fhi:git
county,Agder,2020-12-31,0,0,0,0,0.0,0.0,0,0,fhi:git
county,Agder,2021-01-01,0,0,0,0,0.0,0.0,0,0,fhi:git
county,Agder,2021-01-02,0,0,0,0,0.0,0.0,0,0,fhi:git
county,Agder,2021-01-03,3,0,3,0,0.0009764639635974,0.0,3,3,fhi:git
county,Agder,2021-01-04,0,0,3,0,0.0009713673290312,0.0,0,3,fhi:git
county,Agder,2021-01-05,79,0,82,0,0.026550706993521,0.0,79,82,fhi:git
county,Agder,2021-01-06,794,0,876,0,0.283639260077127,0.0,794,876,fhi:git
county,Agder,2021-01-07,229,0,1105,0,0.357786966193179,0.0,229,1105,fhi:git
county,Agder,2021-01-08,49,0,1154,0,0.373652632567356,0.0,49,1154,fhi:git
county,Agder,2021-01-09,0,0,1154,0,0.373652632567356,0.0,0,1154,fhi:git
county,Agder,2021-01-10,0,0,1154,0,0.373652632567356,0.0,0,1154,fhi:git
county,Agder,2021-01-11,1,0,1155,0,0.373976421677033,0.0,1,1155,fhi:git
county,Agder,2021-01-12,226,0,1381,0,0.447152760464055,0.0,226,1381,fhi:git
county,Agder,2021-01-13,861,0,2242,0,0.725935183896025,0.0,861,2242,fhi:git
county,Agder,2021-01-14,517,0,2759,0,0.893334153599078,0.0,517,2759,fhi:git
county,Agder,2021-01-15,119,0,2878,0,0.931865057650651,0.0,119,2878,fhi:git
county,Agder,2021-01-16,2,0,2880,0,0.932512635870005,0.0,2,2880,fhi:git
county,Agder,2021-01-17,2,0,2882,0,0.933160214089359,0.0,2,2882,fhi:git
county,Agder,2021-01-18,15,0,2897,0,0.938017050734516,0.0,15,2897,fhi:git
county,Agder,2021-01-19,346,0,3243,0,1.05004808268279,0.0,346,3243,fhi:git
county,Agder,2021-01-20,462,0,3705,0,1.1996386513536,0.0,462,3705,fhi:git
county,Agder,2021-01-21,341,0,4046,0,1.31005073775349,0.0,341,4046,fhi:git
county,Agder,2021-01-22,67,0,4113,0,1.33174460810185,0.0,67,4113,fhi:git
county,Agder,2021-01-23,1,0,4114,0,1.33206839721153,0.0,1,4114,fhi:git
county,Agder,2021-01-24,0,0,4114,0,1.33206839721153,0.0,0,4114,fhi:git
county,Agder,2021-01-25,3,0,4117,0,1.33303976454056,0.0,3,4117,fhi:git
county,Agder,2021-01-26,63,66,4180,66,1.35343847845022,0.0213700812386876,129,4246,fhi:git
county,Agder,2021-01-27,567,681,4747,747,1.53702690363712,0.241870464928783,1248,5494,fhi:git
county,Agder,2021-01-28,958,250,5705,997,1.84721687070777,0.322817742348054,1208,6702,fhi:git
county,Agder,2021-01-29,205,61,5910,1058,1.91359363819157,0.342568878038356,266,6968,fhi:git
county,Agder,2021-01-30,33,0,5943,1058,1.92427867881092,0.342568878038356,33,7001,fhi:git
county,Agder,2021-01-31,26,0,5969,1058,1.93269719566252,0.342568878038356,26,7027,fhi:git
county,Agder,2021-02-01,1,2,5970,1060,1.9330209847722,0.34321645625771,3,7030,fhi:git
county,Agder,2021-02-02,203,171,6173,1231,1.99875017403665,0.398584394012492,374,7404,fhi:git
county,Agder,2021-02-03,1336,602,7509,1833,2.43133242456523,0.593505438038097,1938,9342,fhi:git
county,Agder,2021-02-04,1711,507,9220,2340,2.98533559122272,0.757666516644379,2218,11560,fhi:git
county,Agder,2021-02-05,621,135,9841,2475,3.1864086283322,0.801378046450786,756,12316,fhi:git
county,Agder,2021-02-06,512,3,10353,2478,3.35218865248686,0.802349413779817,515,12831,fhi:git
county,Agder,2021-02-07,87,2,10440,2480,3.38035830502877,0.802996991999171,89,12920,fhi:git
county,Agder,2021-02-08,13,2,10453,2482,3.38456756345457,0.803644570218525,15,12935,fhi:git
county,Agder,2021-02-09,190,255,10643,2737,3.44608749429322,0.886210793186182,445,13380,fhi:git
county,Agder,2021-02-10,1154,372,11797,3109,3.81974012686057,1.00666034198606,1526,14906,fhi:git
county,Agder,2021-02-11,1009,416,12806,3525,4.14644333852475,1.14135661161173,1425,16331,fhi:git
county,Agder,2021-02-12,358,70,13164,3595,4.26235983978915,1.16402184928912,428,16759,fhi:git
county,Agder,2021-02-13,510,2,13674,3597,4.42749228572446,1.16466942750848,512,17271,fhi:git
county,Agder,2021-02-14,0,0,13674,3597,4.42749228572446,1.16466942750848,0,17271,fhi:git
county,Agder,2021-02-15,2,1,13676,3598,4.42813986394382,1.16499321661815,3,17274,fhi:git
county,Agder,2021-02-16,142,117,13818,3715,4.47411791751796,1.20287654245037,259,17533,fhi:git
county,Agder,2021-02-17,1223,435,15041,4150,4.87011199865304,1.3437248051599,1658,19191,fhi:git
county,Agder,2021-02-18,1081,832,16122,4982,5.22012802621397,1.61311734441124,1913,21104,fhi:git
county,Agder,2021-02-19,719,344,16841,5326,5.45293239607179,1.72450079814016,1063,22167,fhi:git
county,Agder,2021-02-20,355,38,17196,5364,5.56787753000716,1.73680478430788,393,22560,fhi:git
county,Agder,2021-02-21,52,25,17248,5389,5.58471456371037,1.74489951204981,77,22637,fhi:git
county,Agder,2021-02-22,223,1,17471,5390,5.65691953516835,1.74522330115949,224,22861,fhi:git
county,Agder,2021-02-23,294,201,17765,5591,5.75211353341342,1.81030491220458,495,23356,fhi:git
county,Agder,2021-02-24,979,1115,18744,6706,6.06910307178728,2.17132976949453,2094,25450,fhi:git
county,Agder,2021-02-25,719,1571,19463,8277,6.30190744164511,2.68000246079723,2290,27740,fhi:git
county,Agder,2021-02-26,400,466,19863,8743,6.43142308551594,2.83088818590676,866,28606,fhi:git
county,Agder,2021-02-27,0,1,19863,8744,6.43142308551594,2.83121197501643,1,28607,fhi:git
county,Agder,2021-02-28,10,82,19873,8826,6.43466097661271,2.85776268200995,92,28699,fhi:git
county,Agder,2021-03-01,263,0,20136,8826,6.51981751245779,2.85776268200995,263,28962,fhi:git
county,Agder,2021-03-02,578,193,20714,9019,6.70696761785114,2.92025398017763,771,29733,fhi:git
county,Agder,2021-03-03,636,880,21350,9899,6.91289749160577,3.20518839669347,1516,31249,fhi:git
county,Agder,2021-03-04,796,1081,22146,10980,7.17063362290873,3.5552044242544,1877,33126,fhi:git
county,Agder,2021-03-05,960,384,23106,11364,7.48147116819873,3.6795394423704,1344,34470,fhi:git
county,Agder,2021-03-06,37,406,23143,11770,7.49345136525678,3.81099782089929,443,34913,fhi:git
county,Agder,2021-03-07,5,1,23148,11771,7.49507031080517,3.81132161000897,6,34919,fhi:git
county,Agder,2021-03-08,226,0,23374,11771,7.56824664959219,3.81132161000897,226,35145,fhi:git
county,Agder,2021-03-09,724,141,24098,11912,7.8026699649984,3.85697587447344,865,36010,fhi:git
county,Agder,2021-03-10,1037,811,25135,12723,8.13843927173354,4.11956884242155,1848,37858,fhi:git
county,Agder,2021-03-11,649,814,25784,13537,8.34857840391396,4.3831331776987,1463,39321,fhi:git
county,Agder,2021-03-12,99,328,25883,13865,8.38063352577199,4.48933600567279,427,39748,fhi:git
county,Agder,2021-03-13,1,0,25884,13865,8.38095731488167,4.48933600567279,1,39749,fhi:git
county,Agder,2021-03-14,0,0,25884,13865,8.38095731488167,4.48933600567279,0,39749,fhi:git
county,Agder,2021-03-15,1,3,25885,13868,8.38128110399135,4.49030737300182,4,39753,fhi:git
county,Agder,2021-03-16,242,15,26127,13883,8.4596380685332,4.49516420964697,257,40010,fhi:git
county,Agder,2021-03-17,1612,48,27739,13931,8.98158611333266,4.51070608691147,1660,41670,fhi:git
county,Agder,2021-03-18,1247,95,28986,14026,9.38535113309999,4.5414660523308,1342,43012,fhi:git
county,Agder,2021-03-19,266,41,29252,14067,9.47147903627409,4.55474140582756,307,43319,fhi:git
county,Agder,2021-03-20,0,0,29252,14067,9.47147903627409,4.55474140582756,0,43319,fhi:git
county,Agder,2021-03-21,17,53,29269,14120,9.4769834511386,4.57190222864044,70,43389,fhi:git
county,Agder,2021-03-22,9,1,29278,14121,9.4798975531257,4.57222601775012,10,43399,fhi:git
county,Agder,2021-03-23,314,14,29592,14135,9.5815673335643,4.5767590652856,328,43727,fhi:git
county,Agder,2021-03-24,2271,78,31863,14213,10.316892401641,4.60201461584041,2349,46076,fhi:git
county,Agder,2021-03-25,2042,55,33905,14268,10.9780697636016,4.61982301687265,2097,48173,fhi:git
county,Agder,2021-03-26,778,12,34683,14280,11.2299776909303,4.62370848618878,790,48963,fhi:git
county,Agder,2021-03-27,1,0,34684,14280,11.23030148004,4.62370848618878,1,48964,fhi:git
county,Agder,2021-03-28,173,3,34857,14283,11.2863169960142,4.62467985351781,176,49140,fhi:git
county,Agder,2021-03-29,107,0,34964,14283,11.3209624307496,4.62467985351781,107,49247,fhi:git
county,Agder,2021-03-30,689,71,35653,14354,11.5440531273171,4.64766888030488,760,50007,fhi:git
county,Agder,2021-03-31,3379,404,39032,14758,12.638136528916,4.77847968061442,3783,53790,fhi:git
county,Agder,2021-04-01,237,49,39269,14807,12.7148745479095,4.7943453469886,286,54076,fhi:git
county,Agder,2021-04-02,1,0,39270,14807,12.7151983370191,4.7943453469886,1,54077,fhi:git
county,Agder,2021-04-03,14,0,39284,14807,12.7197313845546,4.7943453469886,14,54091,fhi:git
county,Agder,2021-04-04,1,5,39285,14812,12.7200551736643,4.79596429253699,6,54097,fhi:git
county,Agder,2021-04-05,0,0,39285,14812,12.7200551736643,4.79596429253699,0,54097,fhi:git
county,Agder,2021-04-06,619,1,39904,14813,12.9204806325544,4.79628808164666,620,54717,fhi:git
county,Agder,2021-04-07,3667,60,43571,14873,14.1078152977403,4.81571542822729,3727,58444,fhi:git
county,Agder,2021-04-08,3507,83,47078,14956,15.2433437053778,4.84258992433049,3590,62034,fhi:git
county,Agder,2021-04-09,900,1,47978,14957,15.5347539040872,4.84291371344016,901,62935,fhi:git
county,Agder,2021-04-10,0,1,47978,14958,15.5347539040872,4.84323750254984,1,62936,fhi:git
county,Agder,2021-04-11,164,0,48142,14958,15.5878553180742,4.84323750254984,164,63100,fhi:git
county,Agder,2021-04-12,35,2,48177,14960,15.5991879369129,4.84388508076919,37,63137,fhi:git
county,Agder,2021-04-13,764,6,48941,14966,15.8465628167062,4.84582781542726,770,63907,fhi:git
county,Agder,2021-04-14,4193,34,53134,15000,17.2042105535822,4.85683664515628,4227,68134,fhi:git
county,Agder,2021-04-15,4770,38,57904,15038,18.7486846067419,4.86914063132401,4808,72942,fhi:git
county,Agder,2021-04-16,1716,4,59620,15042,19.3043067189478,4.87043578776271,1720,74662,fhi:git
county,Agder,2021-04-17,2,0,59622,15042,19.3049542971672,4.87043578776271,2,74664,fhi:git
county,Agder,2021-04-18,216,8,59838,15050,19.3748927448574,4.87302610064013,224,74888,fhi:git
county,Agder,2021-04-19,2,0,59840,15050,19.3755403230768,4.87302610064013,2,74890,fhi:git
county,Agder,2021-04-20,446,10,60286,15060,19.5199502659928,4.8762639917369,456,75346,fhi:git
county,Agder,2021-04-21,3408,94,63694,15154,20.6234235517723,4.90670016804655,3502,78848,fhi:git
county,Agder,2021-04-22,3768,51,67462,15205,21.8434609170355,4.92321341264008,3819,82667,fhi:git
county,Agder,2021-04-23,712,17,68174,15222,22.0739987631256,4.92871782750459,729,83396,fhi:git
county,Agder,2021-04-24,3,0,68177,15222,22.0749701304546,4.92871782750459,3,83399,fhi:git
county,Agder,2021-04-25,199,3,68376,15225,22.1394041632804,4.92968919483362,202,83601,fhi:git
county,Agder,2021-04-26,3,0,68379,15225,22.1403755306094,4.92968919483362,3,83604,fhi:git
county,Agder,2021-04-27,553,237,68932,15462,22.3194309082608,5.00642721382709,790,84394,fhi:git
county,Agder,2021-04-28,3448,1502,72380,16964,23.4358557584274,5.49275845656207,4950,89344,fhi:git
county,Agder,2021-04-29,4057,1412,76437,18376,24.7494681763874,5.94994867942612,5469,94813,fhi:git
county,Agder,2021-04-30,2418,321,78855,18697,25.5323902435865,6.05388498363246,2739,97552,fhi:git
county,Agder,2021-05-01,0,0,78855,18697,25.5323902435865,6.05388498363246,0,97552,fhi:git
county,Agder,2021-05-02,3,25,78858,18722,25.5333616109156,6.06197971137439,28,97580,fhi:git
county,Agder,2021-05-03,11,1,78869,18723,25.536923291122,6.06230350048407,12,97592,fhi:git
county,Agder,2021-05-04,415,290,79284,19013,25.671295771638,6.15620234229042,705,98297,fhi:git
county,Agder,2021-05-05,1991,2096,81275,21109,26.3159598890051,6.83486431617359,4087,102384,fhi:git
county,Agder,2021-05-06,2030,2163,83305,23272,26.9732517816496,7.53522016040513,4193,106577,fhi:git
county,Agder,2021-05-07,646,659,83951,23931,27.182419546501,7.74859718368232,1305,107882,fhi:git
county,Agder,2021-05-08,0,1,83951,23932,27.182419546501,7.748920972792,1,107883,fhi:git
county,Agder,2021-05-09,11,163,83962,24095,27.1859812267074,7.80169859766937,174,108057,fhi:git
county,Innlandet,2020-12-27,0,0,0,0,0.0,0.0,0,0,fhi:git
county,Innlandet,2020-12-28,272,0,272,0,0.0732393607711674,0.0,272,272,fhi:git
county,Innlandet,2020-12-29,260,0,532,0,0.143247573273019,0.0,260,532,fhi:git
county,Innlandet,2020-12-30,149,0,681,0,0.183367664283695,0.0,149,681,fhi:git
county,Innlandet,2020-12-31,0,0,681,0,0.183367664283695,0.0,0,681,fhi:git
county,Innlandet,2021-01-01,0,0,681,0,0.183367664283695,0.0,0,681,fhi:git
county,Innlandet,2021-01-02,0,0,681,0,0.183367664283695,0.0,0,681,fhi:git
county,Innlandet,2021-01-03,0,0,681,0,0.183367664283695,0.0,0,681,fhi:git
county,Innlandet,2021-01-04,0,0,681,0,0.183754583745949,0.0,0,681,fhi:git
county,Innlandet,2021-01-05,270,0,951,0,0.256608823997647,0.0,270,951,fhi:git
county,Innlandet,2021-01-06,703,0,1654,0,0.446299679171512,0.0,703,1654,fhi:git
county,Innlandet,2021-01-07,695,0,2349,0,0.633831890189772,0.0,695,2349,fhi:git
county,Innlandet,2021-01-08,75,0,2424,0,0.654069179148577,0.0,75,2424,fhi:git
county,Innlandet,2021-01-09,0,0,2424,0,0.654069179148577,0.0,0,2424,fhi:git
county,Innlandet,2021-01-10,0,0,2424,0,0.654069179148577,0.0,0,2424,fhi:git
county,Innlandet,2021-01-11,50,0,2474,0,0.667560705121113,0.0,50,2474,fhi:git
county,Innlandet,2021-01-12,407,0,2881,0,0.777381726537562,0.0,407,2881,fhi:git
county,Innlandet,2021-01-13,993,0,3874,0,1.04532343235214,0.0,993,3874,fhi:git
county,Innlandet,2021-01-14,958,0,4832,0,1.30382106998594,0.0,958,4832,fhi:git
county,Innlandet,2021-01-15,284,0,5116,0,1.38045293750995,0.0,284,5116,fhi:git
county,Innlandet,2021-01-16,4,0,5120,0,1.38153225958775,0.0,4,5120,fhi:git
county,Innlandet,2021-01-17,0,0,5120,0,1.38153225958775,0.0,0,5120,fhi:git
county,Innlandet,2021-01-18,61,0,5181,0,1.39799192127425,0.0,61,5181,fhi:git
county,Innlandet,2021-01-19,331,318,5512,318,1.48730582321244,0.0858061051853331,649,5830,fhi:git
county,Innlandet,2021-01-20,663,252,6175,570,1.66620345760828,0.153803396086918,915,6745,fhi:git
county,Innlandet,2021-01-21,835,48,7010,618,1.89151194134964,0.166755261020553,883,7628,fhi:git
county,Innlandet,2021-01-22,239,0,7249,618,1.95600143549836,0.166755261020553,239,7867,fhi:git
county,Innlandet,2021-01-23,6,0,7255,618,1.95762041861507,0.166755261020553,6,7873,fhi:git
county,Innlandet,2021-01-24,0,0,7255,618,1.95762041861507,0.166755261020553,0,7873,fhi:git
county,Innlandet,2021-01-25,1,0,7256,618,1.95789024913452,0.166755261020553,1,7874,fhi:git
county,Innlandet,2021-01-26,152,130,7408,748,1.99890448809103,0.201833228549148,282,8156,fhi:git
county,Innlandet,2021-01-27,934,604,8342,1352,2.25092619325801,0.364810862297391,1538,9694,fhi:git
county,Innlandet,2021-01-28,903,707,9245,2059,2.49458315232203,0.555581039549059,1610,11304,fhi:git
county,Innlandet,2021-01-29,318,132,9563,2191,2.58038925750736,0.591198668116556,450,11754,fhi:git
county,Innlandet,2021-01-30,2,0,9565,2191,2.58092891854626,0.591198668116556,2,11756,fhi:git
county,Innlandet,2021-01-31,2,0,9567,2191,2.58146857958516,0.591198668116556,2,11758,fhi:git
county,Innlandet,2021-02-01,9,49,9576,2240,2.58389705426022,0.604420363569642,58,11816,fhi:git
county,Innlandet,2021-02-02,611,342,10187,2582,2.74876350164462,0.696702401221793,953,12769,fhi:git
county,Innlandet,2021-02-03,2312,872,12499,3454,3.37261166261471,0.931994614182832,3184,15953,fhi:git
county,Innlandet,2021-02-04,2657,1000,15156,4454,4.08955135279531,1.20182513363356,3657,19610,fhi:git
county,Innlandet,2021-02-05,812,275,15968,4729,4.3086537345893,1.27602852648252,1087,20697,fhi:git
county,Innlandet,2021-02-06,8,4,15976,4733,4.31081237874491,1.27710784856032,12,20709,fhi:git
county,Innlandet,2021-02-07,0,0,15976,4733,4.31081237874491,1.27710784856032,0,20709,fhi:git
county,Innlandet,2021-02-08,2,61,15978,4794,4.31135203978381,1.29356751024681,63,20772,fhi:git
county,Innlandet,2021-02-09,259,269,16237,5063,4.38123814432155,1.36615191997906,528,21300,fhi:git
county,Innlandet,2021-02-10,2057,591,18294,5654,4.93627952283171,1.52562175697444,2648,23948,fhi:git
county,Innlandet,2021-02-11,2242,851,20536,6505,5.54123954744025,1.75524752902702,3093,27041,fhi:git
county,Innlandet,2021-02-12,430,283,20966,6788,5.65726667080407,1.83160956603158,713,27754,fhi:git
county,Innlandet,2021-02-13,0,5,20966,6793,5.65726667080407,1.83295871862883,5,27759,fhi:git
county,Innlandet,2021-02-14,1,1,20967,6794,5.65753650132352,1.83322854914828,2,27761,fhi:git
county,Innlandet,2021-02-15,84,14,21051,6808,5.68020226495738,1.83700617642059,98,27859,fhi:git
county,Innlandet,2021-02-16,613,92,21664,6900,5.84560837338068,1.86183058421006,705,28564,fhi:git
county,Innlandet,2021-02-17,1574,783,23238,7683,6.27032161099613,2.07310788093998,2357,30921,fhi:git
county,Innlandet,2021-02-18,1464,904,24702,8587,6.66535349147201,2.31703467052344,2368,33289,fhi:git
county,Innlandet,2021-02-19,542,295,25244,8882,6.8116016330143,2.39663467376141,837,34126,fhi:git
county,Innlandet,2021-02-20,0,3,25244,8885,6.8116016330143,2.39744416531976,3,34129,fhi:git
county,Innlandet,2021-02-21,0,2,25244,8887,6.8116016330143,2.39798382635866,2,34131,fhi:git
county,Innlandet,2021-02-22,285,3,25529,8890,6.88850333105776,2.39879331791702,288,34419,fhi:git
county,Innlandet,2021-02-23,319,307,25848,9197,6.97457926676255,2.48163128738839,626,35045,fhi:git
county,Innlandet,2021-02-24,858,2320,26706,11517,7.20609385245128,3.10763809251409,3178,38223,fhi:git
county,Innlandet,2021-02-25,1751,2478,28457,13995,7.67856709200951,3.77627811971301,4229,42452,fhi:git
county,Innlandet,2021-02-26,680,816,29137,14811,7.86205184523601,3.99645982358481,1496,43948,fhi:git
county,Innlandet,2021-02-27,3,1,29140,14812,7.86286133679436,3.99672965410426,4,43952,fhi:git
county,Innlandet,2021-02-28,3,6,29143,14818,7.86367082835271,3.99834863722096,9,43961,fhi:git
county,Innlandet,2021-03-01,190,7,29333,14825,7.91493862704835,4.00023745085712,197,44158,fhi:git
county,Innlandet,2021-03-02,528,160,29861,14985,8.05740914131834,4.04341033396923,688,44846,fhi:git
county,Innlandet,2021-03-03,1598,1976,31459,16961,8.48859831140061,4.57659544040388,3574,48420,fhi:git
county,Innlandet,2021-03-04,1517,2296,32976,19257,8.89793120940737,5.19612631306277,3813,52233,fhi:git
county,Innlandet,2021-03-05,550,420,33526,19677,9.04633799510527,5.30945513123207,970,53203,fhi:git
county,Innlandet,2021-03-06,7,4,33533,19681,9.04822680874143,5.31053445330988,11,53214,fhi:git
county,Innlandet,2021-03-07,0,0,33533,19681,9.04822680874143,5.31053445330988,0,53214,fhi:git
county,Innlandet,2021-03-08,111,0,33644,19681,9.07817799640046,5.31053445330988,111,53325,fhi:git
county,Innlandet,2021-03-09,939,311,34583,19992,9.3315488541647,5.39445174485905,1250,54575,fhi:git
county,Innlandet,2021-03-10,2034,1306,36617,21298,9.88038413072749,5.74685040326171,3340,57915,fhi:git
county,Innlandet,2021-03-11,1015,973,37632,22271,10.15426210797,6.00939549868728,1988,59903,fhi:git
county,Innlandet,2021-03-12,45,180,37677,22451,10.1664044813453,6.05796499218841,225,60128,fhi:git
county,Innlandet,2021-03-13,0,0,37677,22451,10.1664044813453,6.05796499218841,0,60128,fhi:git
county,Innlandet,2021-03-14,0,7,37677,22458,10.1664044813453,6.05985380582456,7,60135,fhi:git
county,Innlandet,2021-03-15,25,3,37702,22461,10.1731502443315,6.06066329738291,28,60163,fhi:git
county,Innlandet,2021-03-16,366,9,38068,22470,10.2719082144505,6.06309177205797,375,60538,fhi:git
county,Innlandet,2021-03-17,1813,161,39881,22631,10.7611109462147,6.10653448568954,1974,62512,fhi:git
county,Innlandet,2021-03-18,1657,106,41538,22737,11.2082201169445,6.13513652075132,1763,64275,fhi:git
county,Innlandet,2021-03-19,194,23,41732,22760,11.260567237718,6.14134262269868,217,64492,fhi:git
county,Innlandet,2021-03-20,0,0,41732,22760,11.260567237718,6.14134262269868,0,64492,fhi:git
county,Innlandet,2021-03-21,1,0,41733,22760,11.2608370682374,6.14134262269868,1,64493,fhi:git
county,Innlandet,2021-03-22,99,9,41832,22769,11.2875502896631,6.14377109737374,108,64601,fhi:git
county,Innlandet,2021-03-23,814,51,42646,22820,11.507192332496,6.15753245386573,865,65466,fhi:git
county,Innlandet,2021-03-24,3260,526,45906,23346,12.3868398259054,6.29946330709681,3786,69252,fhi:git
county,Innlandet,2021-03-25,3200,321,49106,23667,13.2502974881477,6.3860789038405,3521,72773,fhi:git
county,Innlandet,2021-03-26,677,52,49783,23719,13.4329727498158,6.40011009085194,729,73502,fhi:git
county,Innlandet,2021-03-27,0,0,49783,23719,13.4329727498158,6.40011009085194,0,73502,fhi:git
county,Innlandet,2021-03-28,0,0,49783,23719,13.4329727498158,6.40011009085194,0,73502,fhi:git
county,Innlandet,2021-03-29,398,2,50181,23721,13.5403652965572,6.40064975189084,400,73902,fhi:git
county,Innlandet,2021-03-30,2888,229,53069,23950,14.3196358367309,6.46244094084506,3117,77019,fhi:git
county,Innlandet,2021-03-31,2850,566,55919,24516,15.0886528171655,6.61516501485417,3416,80435,fhi:git
county,Innlandet,2021-04-01,88,18,56007,24534,15.1123979028772,6.62002196420428,106,80541,fhi:git
county,Innlandet,2021-04-02,6,1,56013,24535,15.1140168859939,6.62029179472374,7,80548,fhi:git
county,Innlandet,2021-04-03,2,6,56015,24541,15.1145565470328,6.62191077784044,8,80556,fhi:git
county,Innlandet,2021-04-04,0,0,56015,24541,15.1145565470328,6.62191077784044,0,80556,fhi:git
county,Innlandet,2021-04-05,13,2,56028,24543,15.1180643437857,6.62245043887934,15,80571,fhi:git
county,Innlandet,2021-04-06,510,35,56538,24578,15.2556779087055,6.63189450706012,545,81116,fhi:git
county,Innlandet,2021-04-07,4315,90,60853,24668,16.4199966001355,6.65617925381068,4405,85521,fhi:git
county,Innlandet,2021-04-08,4574,93,65427,24761,17.6542013961031,6.6812734921196,4667,90188,fhi:git
county,Innlandet,2021-04-09,1538,13,66965,24774,18.0692007350183,6.68478128887246,1551,91739,fhi:git
county,Innlandet,2021-04-10,2,0,66967,24774,18.0697403960572,6.68478128887246,2,91741,fhi:git
county,Innlandet,2021-04-11,0,0,66967,24774,18.0697403960572,6.68478128887246,0,91741,fhi:git
county,Innlandet,2021-04-12,9,11,66976,24785,18.0721688707323,6.68774942458642,20,91761,fhi:git
county,Innlandet,2021-04-13,1280,8,68256,24793,18.4175519356292,6.68990806874202,1288,93049,fhi:git
county,Innlandet,2021-04-14,4747,59,73003,24852,19.6984374114619,6.70582806938962,4806,97855,fhi:git
county,Innlandet,2021-04-15,5613,111,78616,24963,21.2129961171388,6.73577925704865,5724,103579,fhi:git
county,Innlandet,2021-04-16,873,33,79489,24996,21.4485581606193,6.74468366419052,906,104485,fhi:git
county,Innlandet,2021-04-17,3,0,79492,24996,21.4493676521777,6.74468366419052,3,104488,fhi:git
county,Innlandet,2021-04-18,0,0,79492,24996,21.4493676521777,6.74468366419052,0,104488,fhi:git
county,Innlandet,2021-04-19,65,7,79557,25003,21.466906635942,6.74657247782668,72,104560,fhi:git
county,Innlandet,2021-04-20,1400,15,80957,25018,21.844669363173,6.75061993561844,1415,105975,fhi:git
county,Innlandet,2021-04-21,4197,153,85154,25171,22.9771480533077,6.7919040050944,4350,110325,fhi:git
county,Innlandet,2021-04-22,4785,55,89939,25226,24.2682870888795,6.80674468366419,4840,115165,fhi:git
county,Innlandet,2021-04-23,682,13,90621,25239,24.4523115031449,6.81025248041705,695,115860,fhi:git
county,Innlandet,2021-04-24,62,0,90683,25239,24.4690409953508,6.81025248041705,62,115922,fhi:git
county,Innlandet,2021-04-25,0,0,90683,25239,24.4690409953508,6.81025248041705,0,115922,fhi:git
county,Innlandet,2021-04-26,15,16,90698,25255,24.4730884531426,6.81456976872826,31,115953,fhi:git
county,Innlandet,2021-04-27,1411,286,92109,25541,24.8538193160876,6.89174129729117,1697,117650,fhi:git
county,Innlandet,2021-04-28,4373,1804,96482,27345,26.0337881776456,7.37851555438029,6177,123827,fhi:git
county,Innlandet,2021-04-29,4618,1421,101100,28766,27.2798655164691,7.76194472251979,6039,129866,fhi:git
county,Innlandet,2021-04-30,935,469,102035,29235,27.5321570521555,7.88849523614218,1404,131270,fhi:git
county,Innlandet,2021-05-01,12,1,102047,29236,27.535395018389,7.88876506666163,13,131283,fhi:git
county,Innlandet,2021-05-02,0,1,102047,29237,27.535395018389,7.88903489718108,1,131284,fhi:git
county,Innlandet,2021-05-03,32,7,102079,29244,27.5440295950114,7.89092371081724,39,131323,fhi:git
county,Innlandet,2021-05-04,601,844,102680,30088,27.7061977372013,8.11866066923365,1445,132768,fhi:git
county,Innlandet,2021-05-05,2531,2887,105211,32975,28.3891387819311,8.89766137888792,5418,138186,fhi:git
county,Innlandet,2021-05-06,2423,3062,107634,36037,29.0429381305602,9.72388242944607,5485,143671,fhi:git
county,Innlandet,2021-05-07,1094,754,108728,36791,29.3381327188393,9.92733464111192,1848,145519,fhi:git
county,Innlandet,2021-05-08,1,2,108729,36793,29.3384025493588,9.92787430215082,3,145522,fhi:git
county,Innlandet,2021-05-09,0,0,108729,36793,29.3384025493588,9.92787430215082,0,145522,fhi:git
county,Møre og Romsdal,2020-12-27,0,0,0,0,0.0,0.0,0,0,fhi:git
county,Møre og Romsdal,2020-12-28,1,0,1,0,0.0003770198840286,0.0,1,1,fhi:git
county,Møre og Romsdal,2020-12-29,0,0,1,0,0.0003770198840286,0.0,0,1,fhi:git
county,Møre og Romsdal,2020-12-30,0,0,1,0,0.0003770198840286,0.0,0,1,fhi:git
county,Møre og Romsdal,2020-12-31,0,0,1,0,0.0003770198840286,0.0,0,1,fhi:git
county,Møre og Romsdal,2021-01-01,0,0,1,0,0.0003770198840286,0.0,0,1,fhi:git
county,Møre og Romsdal,2021-01-02,0,0,1,0,0.0003770198840286,0.0,0,1,fhi:git
county,Møre og Romsdal,2021-01-03,0,0,1,0,0.0003770198840286,0.0,0,1,fhi:git
county,Møre og Romsdal,2021-01-04,0,0,1,0,0.0003765854246377,0.0,0,1,fhi:git
county,Møre og Romsdal,2021-01-05,186,0,187,0,0.0704214744072545,0.0,186,187,fhi:git
county,Møre og Romsdal,2021-01-06,496,0,683,0,0.257207845027566,0.0,496,683,fhi:git
county,Møre og Romsdal,2021-01-07,457,0,1140,0,0.429307384087006,0.0,457,1140,fhi:git
county,Møre og Romsdal,2021-01-08,36,0,1176,0,0.442864459373964,0.0,36,1176,fhi:git
county,Møre og Romsdal,2021-01-09,1,0,1177,0,0.443241044798602,0.0,1,1177,fhi:git
county,Møre og Romsdal,2021-01-10,0,0,1177,0,0.443241044798602,0.0,0,1177,fhi:git
county,Møre og Romsdal,2021-01-11,1,0,1178,0,0.44361763022324,0.0,1,1178,fhi:git
county,Møre og Romsdal,2021-01-12,225,0,1403,0,0.528349350766728,0.0,225,1403,fhi:git
county,Møre og Romsdal,2021-01-13,387,0,1790,0,0.674087910101528,0.0,387,1790,fhi:git
county,Møre og Romsdal,2021-01-14,407,0,2197,0,0.827358177929082,0.0,407,2197,fhi:git
county,Møre og Romsdal,2021-01-15,150,0,2347,0,0.88384599162474,0.0,150,2347,fhi:git
county,Møre og Romsdal,2021-01-16,1,0,2348,0,0.884222577049378,0.0,1,2348,fhi:git
county,Møre og Romsdal,2021-01-17,2,0,2350,0,0.884975747898653,0.0,2,2350,fhi:git
county,Møre og Romsdal,2021-01-18,11,0,2361,0,0.889118187569668,0.0,11,2361,fhi:git
county,Møre og Romsdal,2021-01-19,203,0,2564,0,0.965565028771126,0.0,203,2564,fhi:git
county,Møre og Romsdal,2021-01-20,500,0,3064,0,1.15385774108999,0.0,500,3064,fhi:git
county,Møre og Romsdal,2021-01-21,800,0,3864,0,1.45512608080017,0.0,800,3864,fhi:git
county,Møre og Romsdal,2021-01-22,212,0,4076,0,1.53496219082337,0.0,212,4076,fhi:git
county,Møre og Romsdal,2021-01-23,0,0,4076,0,1.53496219082337,0.0,0,4076,fhi:git
county,Møre og Romsdal,2021-01-24,0,0,4076,0,1.53496219082337,0.0,0,4076,fhi:git
county,Møre og Romsdal,2021-01-25,3,0,4079,0,1.53609194709728,0.0,3,4079,fhi:git
county,Møre og Romsdal,2021-01-26,78,129,4157,129,1.56546561021902,0.0485795197782665,207,4286,fhi:git
county,Møre og Romsdal,2021-01-27,543,358,4700,487,1.76995149579731,0.183397101798572,901,5187,fhi:git
county,Møre og Romsdal,2021-01-28,492,509,5192,996,1.95523152471907,0.375079082939174,1001,6188,fhi:git
county,Møre og Romsdal,2021-01-29,99,78,5291,1074,1.9925134817582,0.404452746060916,177,6365,fhi:git
county,Møre og Romsdal,2021-01-30,0,1,5291,1075,1.9925134817582,0.404829331485554,1,6366,fhi:git
county,Møre og Romsdal,2021-01-31,1,0,5292,1075,1.99289006718284,0.404829331485554,1,6367,fhi:git
county,Møre og Romsdal,2021-02-01,0,0,5292,1075,1.99289006718284,0.404829331485554,0,6367,fhi:git
county,Møre og Romsdal,2021-02-02,291,193,5583,1268,2.10247642575242,0.477510318440635,484,6851,fhi:git
county,Møre og Romsdal,2021-02-03,1064,311,6647,1579,2.50316331756696,0.594628385502968,1375,8226,fhi:git
county,Møre og Romsdal,2021-02-04,1548,460,8195,2039,3.08611755490616,0.767857680836321,2008,10234,fhi:git
county,Møre og Romsdal,2021-02-05,218,154,8413,2193,3.16821317747718,0.82585183623053,372,10606,fhi:git
county,Møre og Romsdal,2021-02-06,1,2,8414,2195,3.16858976290182,0.826605007079806,3,10609,fhi:git
county,Møre og Romsdal,2021-02-07,0,1,8414,2196,3.16858976290182,0.826981592504444,1,10610,fhi:git
county,Møre og Romsdal,2021-02-08,1,2,8415,2198,3.16896634832645,0.827734763353719,3,10613,fhi:git
county,Møre og Romsdal,2021-02-09,335,183,8750,2381,3.29512246558009,0.896649896062423,518,11131,fhi:git
county,Møre og Romsdal,2021-02-10,1265,435,10015,2816,3.77150302774681,1.06046455577983,1700,12831,fhi:git
county,Møre og Romsdal,2021-02-11,1255,805,11270,3621,4.24411773566716,1.3636158226132,2060,14891,fhi:git
county,Møre og Romsdal,2021-02-12,296,207,11566,3828,4.35558702135993,1.44156900551321,503,15394,fhi:git
county,Møre og Romsdal,2021-02-13,24,0,11590,3828,4.36462507155123,1.44156900551321,24,15418,fhi:git
county,Møre og Romsdal,2021-02-14,0,0,11590,3828,4.36462507155123,1.44156900551321,0,15418,fhi:git
county,Møre og Romsdal,2021-02-15,1,8,11591,3836,4.36500165697587,1.44458168891031,9,15427,fhi:git
county,Møre og Romsdal,2021-02-16,354,58,11945,3894,4.49831289729762,1.4664236435393,412,15839,fhi:git
county,Møre og Romsdal,2021-02-17,1207,427,13152,4321,4.95285150483536,1.62722561985961,1634,17473,fhi:git
county,Møre og Romsdal,2021-02-18,1165,522,14317,4843,5.39157352453831,1.8238032115205,1687,19160,fhi:git
county,Møre og Romsdal,2021-02-19,499,94,14816,4937,5.57948965143253,1.85920224143645,593,19753,fhi:git
county,Møre og Romsdal,2021-02-20,11,0,14827,4937,5.58363209110355,1.85920224143645,11,19764,fhi:git
county,Møre og Romsdal,2021-02-21,0,1,14827,4938,5.58363209110355,1.85957882686109,1,19765,fhi:git
county,Møre og Romsdal,2021-02-22,14,0,14841,4938,5.58890428704847,1.85957882686109,14,19779,fhi:git
county,Møre og Romsdal,2021-02-23,393,223,15234,5161,5.7369023589311,1.9435573765553,616,20395,fhi:git
county,Møre og Romsdal,2021-02-24,730,879,15964,6040,6.01180971891664,2.27457596481186,1609,22004,fhi:git
county,Møre og Romsdal,2021-02-25,704,1478,16668,7518,6.2769258578616,2.83116922242642,2182,24186,fhi:git
county,Møre og Romsdal,2021-02-26,262,201,16930,7719,6.37559123911668,2.9068628927786,463,24649,fhi:git
county,Møre og Romsdal,2021-02-27,1,1,16931,7720,6.37596782454132,2.90723947820324,2,24651,fhi:git
county,Møre og Romsdal,2021-02-28,0,0,16931,7720,6.37596782454132,2.90723947820324,0,24651,fhi:git
county,Møre og Romsdal,2021-03-01,101,1,17032,7721,6.41400295242973,2.90761606362787,102,24753,fhi:git
county,Møre og Romsdal,2021-03-02,741,260,17773,7981,6.69305275208628,3.00552827403368,1001,25754,fhi:git
county,Møre og Romsdal,2021-03-03,869,1134,18642,9115,7.02030548609647,3.43257614557286,2003,27757,fhi:git
county,Møre og Romsdal,2021-03-04,1013,1310,19655,10425,7.40178652125448,3.92590305184828,2323,30080,fhi:git
county,Møre og Romsdal,2021-03-05,814,275,20469,10700,7.70832705690959,4.02946404362366,1089,31169,fhi:git
county,Møre og Romsdal,2021-03-06,3,6,20472,10706,7.7094568131835,4.03172355617148,9,31178,fhi:git
county,Møre og Romsdal,2021-03-07,0,0,20472,10706,7.7094568131835,4.03172355617148,0,31178,fhi:git
county,Møre og Romsdal,2021-03-08,157,0,20629,10706,7.76858072485163,4.03172355617148,157,31335,fhi:git
county,Møre og Romsdal,2021-03-09,671,239,21300,10945,8.02126954478354,4.1217274726599,910,32245,fhi:git
county,Møre og Romsdal,2021-03-10,1284,951,22584,11896,8.50480523001838,4.47986021149038,2235,34480,fhi:git
county,Møre og Romsdal,2021-03-11,539,974,23123,12870,8.70778477389811,4.84665441508752,1513,35993,fhi:git
county,Møre og Romsdal,2021-03-12,66,249,23189,13119,8.7326394119242,4.94042418582231,315,36308,fhi:git
county,Møre og Romsdal,2021-03-13,1,16,23190,13135,8.73301599734884,4.94644955261652,17,36325,fhi:git
county,Møre og Romsdal,2021-03-14,0,0,23190,13135,8.73301599734884,4.94644955261652,0,36325,fhi:git
county,Møre og Romsdal,2021-03-15,0,1,23190,13136,8.73301599734884,4.94682613804115,1,36326,fhi:git
county,Møre og Romsdal,2021-03-16,341,11,23531,13147,8.8614316271503,4.95096857771217,352,36678,fhi:git
county,Møre og Romsdal,2021-03-17,1542,129,25073,13276,9.44212635194168,4.99954809749043,1671,38349,fhi:git
county,Møre og Romsdal,2021-03-18,1485,60,26558,13336,10.0013557075287,5.0221432229687,1545,39894,fhi:git
county,Møre og Romsdal,2021-03-19,208,37,26766,13373,10.0796854758533,5.03607688368029,245,40139,fhi:git
county,Møre og Romsdal,2021-03-20,18,0,26784,13373,10.0864640134968,5.03607688368029,18,40157,fhi:git
county,Møre og Romsdal,2021-03-21,0,0,26784,13373,10.0864640134968,5.03607688368029,0,40157,fhi:git
county,Møre og Romsdal,2021-03-22,1,7,26785,13380,10.0868405989215,5.03871298165276,8,40165,fhi:git
county,Møre og Romsdal,2021-03-23,597,19,27382,13399,10.3116620974302,5.04586810472088,616,40781,fhi:git
county,Møre og Romsdal,2021-03-24,1825,50,29207,13449,10.998930497394,5.06469737595276,1875,42656,fhi:git
county,Møre og Romsdal,2021-03-25,2327,71,31534,13520,11.875244780526,5.09143494110204,2398,45054,fhi:git
county,Møre og Romsdal,2021-03-26,225,20,31759,13540,11.9599765010695,5.09896664959479,245,45299,fhi:git
county,Møre og Romsdal,2021-03-27,26,1,31785,13541,11.9697677221101,5.09934323501943,27,45326,fhi:git
county,Møre og Romsdal,2021-03-28,0,0,31785,13541,11.9697677221101,5.09934323501943,0,45326,fhi:git
county,Møre og Romsdal,2021-03-29,7,5,31792,13546,11.9724038200825,5.10122616214262,12,45338,fhi:git
county,Møre og Romsdal,2021-03-30,2234,102,34026,13648,12.8136956587232,5.13963787545567,2336,47674,fhi:git
county,Møre og Romsdal,2021-03-31,1942,216,35968,13864,13.5450245533697,5.22098032717742,2158,49832,fhi:git
county,Møre og Romsdal,2021-04-01,99,32,36067,13896,13.5823065104088,5.23303106076582,131,49963,fhi:git
county,Møre og Romsdal,2021-04-02,20,5,36087,13901,13.5898382189016,5.23491398788901,25,49988,fhi:git
county,Møre og Romsdal,2021-04-03,14,0,36101,13901,13.5951104148465,5.23491398788901,14,50002,fhi:git
county,Møre og Romsdal,2021-04-04,0,0,36101,13901,13.5951104148465,5.23491398788901,0,50002,fhi:git
county,Møre og Romsdal,2021-04-05,2,0,36103,13901,13.5958635856958,5.23491398788901,2,50004,fhi:git
county,Møre og Romsdal,2021-04-06,821,49,36924,13950,13.9050402193234,5.25336667369626,870,50874,fhi:git
county,Møre og Romsdal,2021-04-07,2463,40,39387,13990,14.8325701202061,5.26843009068177,2503,53377,fhi:git
county,Møre og Romsdal,2021-04-08,3353,77,42740,14067,16.0952610490164,5.29742716837888,3430,56807,fhi:git
county,Møre og Romsdal,2021-04-09,681,27,43421,14094,16.3517157231946,5.30759497484409,708,57515,fhi:git
county,Møre og Romsdal,2021-04-10,0,0,43421,14094,16.3517157231946,5.30759497484409,0,57515,fhi:git
county,Møre og Romsdal,2021-04-11,0,0,43421,14094,16.3517157231946,5.30759497484409,0,57515,fhi:git
county,Møre og Romsdal,2021-04-12,4,0,43425,14094,16.3532220648932,5.30759497484409,4,57519,fhi:git
county,Møre og Romsdal,2021-04-13,1334,5,44759,14099,16.8555870213599,5.30947790196728,1339,58858,fhi:git
county,Møre og Romsdal,2021-04-14,2524,15,47283,14114,17.8060886331455,5.31512668333685,2539,61397,fhi:git
county,Møre og Romsdal,2021-04-15,3650,30,50933,14144,19.1806254330732,5.32642424607598,3680,65077,fhi:git
county,Møre og Romsdal,2021-04-16,937,13,51870,14157,19.5334859759588,5.33131985659627,950,66027,fhi:git
county,Møre og Romsdal,2021-04-17,13,0,51883,14157,19.5383815864791,5.33131985659627,13,66040,fhi:git
county,Møre og Romsdal,2021-04-18,0,0,51883,14157,19.5383815864791,5.33131985659627,0,66040,fhi:git
county,Møre og Romsdal,2021-04-19,11,0,51894,14157,19.5425240261501,5.33131985659627,11,66051,fhi:git
county,Møre og Romsdal,2021-04-20,1358,13,53252,14170,20.0539270328081,5.33621546711656,1371,67422,fhi:git
county,Møre og Romsdal,2021-04-21,1955,25,55207,14195,20.7901515379749,5.3456301027325,1980,69402,fhi:git
county,Møre og Romsdal,2021-04-22,3265,103,58472,14298,22.0197029494171,5.38441840147019,3368,72770,fhi:git
county,Møre og Romsdal,2021-04-23,513,1,58985,14299,22.2128912722562,5.38479498689483,514,73284,fhi:git
county,Møre og Romsdal,2021-04-24,25,1,59010,14300,22.2223059078721,5.38517157231947,26,73310,fhi:git
county,Møre og Romsdal,2021-04-25,1,0,59011,14300,22.2226824932968,5.38517157231947,1,73311,fhi:git
county,Møre og Romsdal,2021-04-26,5,0,59016,14300,22.22456542042,5.38517157231947,5,73316,fhi:git
county,Møre og Romsdal,2021-04-27,1547,347,60563,14647,22.8071430723345,5.51584671466876,1894,75210,fhi:git
county,Møre og Romsdal,2021-04-28,2522,1463,63085,16110,23.7568915132709,6.06679119091375,3985,79195,fhi:git
county,Møre og Romsdal,2021-04-29,3057,1468,66142,17578,24.9081131563884,6.61961859428193,4525,83720,fhi:git
county,Møre og Romsdal,2021-04-30,428,201,66570,17779,25.0692917181333,6.69531226463411,629,84349,fhi:git
county,Møre og Romsdal,2021-05-01,4,15,66574,17794,25.0707980598319,6.70096104600368,19,84368,fhi:git
county,Møre og Romsdal,2021-05-02,0,0,66574,17794,25.0707980598319,6.70096104600368,0,84368,fhi:git
county,Møre og Romsdal,2021-05-03,17,2,66591,17796,25.0772000120507,6.70171421685295,19,84387,fhi:git
county,Møre og Romsdal,2021-05-04,526,861,67117,18657,25.2752839454102,7.02595426746603,1387,85774,fhi:git
county,Møre og Romsdal,2021-05-05,1893,1551,69010,20208,25.9881601542494,7.61003826107914,3444,89218,fhi:git
county,Møre og Romsdal,2021-05-06,2171,2359,71181,22567,26.8057271111379,8.49840327779954,4530,93748,fhi:git
county,Møre og Romsdal,2021-05-07,277,296,71458,22863,26.9100412737625,8.6098725634923,573,94321,fhi:git
county,Møre og Romsdal,2021-05-08,8,21,71466,22884,26.9130539571596,8.6177808574097,29,94350,fhi:git
county,Møre og Romsdal,2021-05-09,0,2,71466,22886,26.9130539571596,8.61853402825897,2,94352,fhi:git
county,Nordland,2020-12-27,0,0,0,0,0.0,0.0,0,0,fhi:git
county,Nordland,2020-12-28,0,0,0,0,0.0,0.0,0,0,fhi:git
county,Nordland,2020-12-29,0,0,0,0,0.0,0.0,0,0,fhi:git
county,Nordland,2020-12-30,1,0,1,0,0.0004145335461272,0.0,1,1,fhi:git
county,Nordland,2020-12-31,0,0,1,0,0.0004145335461272,0.0,0,1,fhi:git
county,Nordland,2021-01-01,0,0,1,0,0.0004145335461272,0.0,0,1,fhi:git
county,Nordland,2021-01-02,0,0,1,0,0.0004145335461272,0.0,0,1,fhi:git
county,Nordland,2021-01-03,0,0,1,0,0.0004145335461272,0.0,0,1,fhi:git
county,Nordland,2021-01-04,0,0,1,0,0.0004160685681,0.0,0,1,fhi:git
county,Nordland,2021-01-05,200,0,201,0,0.0836297821881046,0.0,200,201,fhi:git
county,Nordland,2021-01-06,686,0,887,0,0.36905281990472,0.0,686,887,fhi:git
county,Nordland,2021-01-07,238,0,1125,0,0.468077139112526,0.0,238,1125,fhi:git
county,Nordland,2021-01-08,114,0,1239,0,0.515508955875928,0.0,114,1239,fhi:git
county,Nordland,2021-01-09,0,0,1239,0,0.515508955875928,0.0,0,1239,fhi:git
county,Nordland,2021-01-10,0,0,1239,0,0.515508955875928,0.0,0,1239,fhi:git
county,Nordland,2021-01-11,0,0,1239,0,0.515508955875928,0.0,0,1239,fhi:git
county,Nordland,2021-01-12,292,0,1531,0,0.637000977761135,0.0,292,1531,fhi:git
county,Nordland,2021-01-13,625,0,2156,0,0.897043832823649,0.0,625,2156,fhi:git
county,Nordland,2021-01-14,273,0,2429,0,1.01063055191496,0.0,273,2429,fhi:git
county,Nordland,2021-01-15,69,0,2498,0,1.03933928311386,0.0,69,2498,fhi:git
county,Nordland,2021-01-16,0,0,2498,0,1.03933928311386,0.0,0,2498,fhi:git
county,Nordland,2021-01-17,1,0,2499,0,1.03975535168196,0.0,1,2499,fhi:git
county,Nordland,2021-01-18,0,0,2499,0,1.03975535168196,0.0,0,2499,fhi:git
county,Nordland,2021-01-19,313,0,2812,0,1.16998481349726,0.0,313,2812,fhi:git
county,Nordland,2021-01-20,787,0,3599,0,1.49743077659198,0.0,787,3599,fhi:git
county,Nordland,2021-01-21,619,0,4218,0,1.7549772202459,0.0,619,4218,fhi:git
county,Nordland,2021-01-22,173,0,4391,0,1.8269570825272,0.0,173,4391,fhi:git
county,Nordland,2021-01-23,4,0,4395,0,1.8286213567996,0.0,4,4395,fhi:git
county,Nordland,2021-01-24,0,0,4395,0,1.8286213567996,0.0,0,4395,fhi:git
county,Nordland,2021-01-25,51,0,4446,0,1.8498408537727,0.0,51,4446,fhi:git
county,Nordland,2021-01-26,119,90,4565,90,1.8993530133766,0.0374461711290021,209,4655,fhi:git
county,Nordland,2021-01-27,628,528,5193,618,2.16064407414342,0.257130375085814,1156,5811,fhi:git
county,Nordland,2021-01-28,472,365,5665,983,2.35702843828663,0.408995402442323,837,6648,fhi:git
county,Nordland,2021-01-29,212,144,5877,1127,2.44523497472383,0.468909276248726,356,7004,fhi:git
county,Nordland,2021-01-30,1,0,5878,1127,2.44565104329193,0.468909276248726,1,7005,fhi:git
county,Nordland,2021-01-31,0,0,5878,1127,2.44565104329193,0.468909276248726,0,7005,fhi:git
county,Nordland,2021-02-01,9,4,5887,1131,2.44939566040484,0.470573550521126,13,7018,fhi:git
county,Nordland,2021-02-02,111,200,5998,1331,2.49557927146394,0.553787264141131,311,7329,fhi:git
county,Nordland,2021-02-03,1435,458,7433,1789,3.09263766668747,0.744346668330941,1893,9222,fhi:git
county,Nordland,2021-02-04,1682,349,9115,2138,3.79246499823171,0.889554598597849,2031,11253,fhi:git
county,Nordland,2021-02-05,330,157,9445,2295,3.92976762570472,0.954877363789553,487,11740,fhi:git
county,Nordland,2021-02-06,0,0,9445,2295,3.92976762570472,0.954877363789553,0,11740,fhi:git
county,Nordland,2021-02-07,1,0,9446,2295,3.93018369427282,0.954877363789553,1,11741,fhi:git
county,Nordland,2021-02-08,7,1,9453,2296,3.93309617424952,0.955293432357653,8,11749,fhi:git
county,Nordland,2021-02-09,73,262,9526,2558,3.96346917972082,1.06430339719986,335,12084,fhi:git
county,Nordland,2021-02-10,2036,635,11562,3193,4.81058478437246,1.32850693794337,2671,14755,fhi:git
county,Nordland,2021-02-11,1224,586,12786,3779,5.31985271172689,1.57232311884999,1810,16565,fhi:git
county,Nordland,2021-02-12,285,239,13071,4018,5.4384322536354,1.67176350662589,524,17089,fhi:git
county,Nordland,2021-02-13,53,3,13124,4021,5.4604838877447,1.67301171233019,56,17145,fhi:git
county,Nordland,2021-02-14,0,0,13124,4021,5.4604838877447,1.67301171233019,0,17145,fhi:git
county,Nordland,2021-02-15,0,1,13124,4022,5.4604838877447,1.67342778089829,1,17146,fhi:git
county,Nordland,2021-02-16,222,71,13346,4093,5.55285110986291,1.70296864923339,293,17439,fhi:git
county,Nordland,2021-02-17,1491,517,14837,4610,6.17320934490004,1.91807609894111,2008,19447,fhi:git
county,Nordland,2021-02-18,849,608,15686,5218,6.52645155921696,2.17104578834592,1457,20904,fhi:git
county,Nordland,2021-02-19,306,231,15992,5449,6.65376854105557,2.26715762757702,537,21441,fhi:git
county,Nordland,2021-02-20,1,1,15993,5450,6.65418460962367,2.26757369614512,2,21443,fhi:git
county,Nordland,2021-02-21,0,0,15993,5450,6.65418460962367,2.26757369614512,0,21443,fhi:git
county,Nordland,2021-02-22,270,0,16263,5450,6.76652312301067,2.26757369614512,270,21713,fhi:git
county,Nordland,2021-02-23,309,57,16572,5507,6.89508831055358,2.29128960452683,366,22079,fhi:git
county,Nordland,2021-02-24,977,1008,17549,6515,7.3015873015873,2.71068672117165,1985,24064,fhi:git
county,Nordland,2021-02-25,600,1873,18149,8388,7.55122844244732,3.48998314922299,2473,26537,fhi:git
county,Nordland,2021-02-26,428,398,18577,8786,7.72930578959413,3.6555784393268,826,27363,fhi:git
county,Nordland,2021-02-27,1,4,18578,8790,7.72972185816223,3.6572427135992,5,27368,fhi:git
county,Nordland,2021-02-28,0,1,18578,8791,7.72972185816223,3.6576587821673,1,27369,fhi:git
county,Nordland,2021-03-01,240,0,18818,8791,7.82957831450623,3.6576587821673,240,27609,fhi:git
county,Nordland,2021-03-02,517,50,19335,8841,8.04468576421394,3.6784622105723,567,28176,fhi:git
county,Nordland,2021-03-03,618,1585,19953,10426,8.30181613929976,4.33793089101084,2203,30379,fhi:git
county,Nordland,2021-03-04,719,1388,20672,11814,8.60096943976367,4.91543406353367,2107,32486,fhi:git
county,Nordland,2021-03-05,448,341,21120,12155,8.78736815827248,5.05731344525578,789,33275,fhi:git
county,Nordland,2021-03-06,13,51,21133,12206,8.79277704965778,5.07853294222888,64,33339,fhi:git
county,Nordland,2021-03-07,0,0,21133,12206,8.79277704965778,5.07853294222888,0,33339,fhi:git
county,Nordland,2021-03-08,362,0,21495,12206,8.94339387130999,5.07853294222888,362,33701,fhi:git
county,Nordland,2021-03-09,653,51,22148,12257,9.21508664627931,5.09975243920198,704,34405,fhi:git
county,Nordland,2021-03-10,1208,1188,23356,13445,9.71769747654414,5.59404189810481,2396,36801,fhi:git
county,Nordland,2021-03-11,728,990,24084,14435,10.020595394121,6.00594978052383,1718,38519,fhi:git
county,Nordland,2021-03-12,71,262,24155,14697,10.0501362624561,6.11495974536604,333,38852,fhi:git
county,Nordland,2021-03-13,3,2,24158,14699,10.0513844681604,6.11579188250224,5,38857,fhi:git
county,Nordland,2021-03-14,1,0,24159,14699,10.0518005367285,6.11579188250224,1,38858,fhi:git
county,Nordland,2021-03-15,0,1,24159,14700,10.0518005367285,6.11620795107034,1,38859,fhi:git
county,Nordland,2021-03-16,120,5,24279,14705,10.1017287649005,6.11828829391084,125,38984,fhi:git
county,Nordland,2021-03-17,902,64,25181,14769,10.4770226133267,6.14491668226924,966,39950,fhi:git
county,Nordland,2021-03-18,1161,75,26342,14844,10.9600782208908,6.17612182487674,1236,41186,fhi:git
county,Nordland,2021-03-19,228,28,26570,14872,11.0549418544176,6.18777174478354,256,41442,fhi:git
county,Nordland,2021-03-20,40,0,26610,14872,11.0715845971416,6.18777174478354,40,41482,fhi:git
county,Nordland,2021-03-21,0,0,26610,14872,11.0715845971416,6.18777174478354,0,41482,fhi:git
county,Nordland,2021-03-22,36,1,26646,14873,11.0865630655932,6.18818781335164,37,41519,fhi:git
county,Nordland,2021-03-23,559,8,27205,14881,11.3191453951611,6.19151636189644,567,42086,fhi:git
county,Nordland,2021-03-24,2196,49,29401,14930,12.2328319707088,6.21190372173334,2245,44331,fhi:git
county,Nordland,2021-03-25,1597,71,30998,15001,12.8972934739645,6.24144459006844,1668,45999,fhi:git
county,Nordland,2021-03-26,344,12,31342,15013,13.0404210613909,6.24643741288564,356,46355,fhi:git
county,Nordland,2021-03-27,0,0,31342,15013,13.0404210613909,6.24643741288564,0,46355,fhi:git
county,Nordland,2021-03-28,0,0,31342,15013,13.0404210613909,6.24643741288564,0,46355,fhi:git
county,Nordland,2021-03-29,9,1,31351,15014,13.0441656785038,6.24685348145374,10,46365,fhi:git
county,Nordland,2021-03-30,1570,128,32921,15142,13.6973933304209,6.30011025817055,1698,48063,fhi:git
county,Nordland,2021-03-31,1159,312,34080,15454,14.1796168008488,6.42992365141775,1471,49534,fhi:git
county,Nordland,2021-04-01,227,164,34307,15618,14.2740643658075,6.49815889658616,391,49925,fhi:git
county,Nordland,2021-04-02,98,10,34405,15628,14.3148390854813,6.50231958226716,108,50033,fhi:git
county,Nordland,2021-04-03,0,0,34405,15628,14.3148390854813,6.50231958226716,0,50033,fhi:git
county,Nordland,2021-04-04,0,0,34405,15628,14.3148390854813,6.50231958226716,0,50033,fhi:git
county,Nordland,2021-04-05,0,1,34405,15629,14.3148390854813,6.50273565083526,1,50034,fhi:git
county,Nordland,2021-04-06,469,13,34874,15642,14.5099752439202,6.50814454222056,482,50516,fhi:git
county,Nordland,2021-04-07,3185,80,38059,15722,15.8351536333188,6.54143002766856,3265,53781,fhi:git
county,Nordland,2021-04-08,2298,423,40357,16145,16.7912792028126,6.71742703197487,2721,56502,fhi:git
county,Nordland,2021-04-09,701,29,41058,16174,17.0829432690507,6.72949302044977,730,57232,fhi:git
county,Nordland,2021-04-10,0,0,41058,16174,17.0829432690507,6.72949302044977,0,57232,fhi:git
county,Nordland,2021-04-11,1,0,41059,16174,17.0833593376188,6.72949302044977,1,57233,fhi:git
county,Nordland,2021-04-12,3,27,41062,16201,17.0846075433231,6.74072687178847,30,57263,fhi:git
county,Nordland,2021-04-13,957,10,42019,16211,17.4827851629949,6.74488755746947,967,58230,fhi:git
county,Nordland,2021-04-14,3833,29,45852,16240,19.0775759845222,6.75695354594437,3862,62092,fhi:git
county,Nordland,2021-04-15,2580,32,48432,16272,20.1510328902203,6.77026774012357,2612,64704,fhi:git
county,Nordland,2021-04-16,799,27,49231,16299,20.4834716761322,6.78150159146227,826,65530,fhi:git
county,Nordland,2021-04-17,0,1,49231,16300,20.4834716761322,6.78191766003037,1,65531,fhi:git
county,Nordland,2021-04-18,0,0,49231,16300,20.4834716761322,6.78191766003037,0,65531,fhi:git
county,Nordland,2021-04-19,120,7,49351,16307,20.5333999043042,6.78483014000707,127,65658,fhi:git
county,Nordland,2021-04-20,863,34,50214,16341,20.8924670785746,6.79897647132247,897,66555,fhi:git
county,Nordland,2021-04-21,3850,60,54064,16401,22.4943310657596,6.82394058540848,3910,70465,fhi:git
county,Nordland,2021-04-22,2581,58,56645,16459,23.5682040400258,6.84807256235828,2639,73104,fhi:git
county,Nordland,2021-04-23,562,8,57207,16467,23.802034575298,6.85140111090308,570,73674,fhi:git
county,Nordland,2021-04-24,0,0,57207,16467,23.802034575298,6.85140111090308,0,73674,fhi:git
county,Nordland,2021-04-25,0,0,57207,16467,23.802034575298,6.85140111090308,0,73674,fhi:git
county,Nordland,2021-04-26,47,160,57254,16627,23.8215897979987,6.91797208179908,207,73881,fhi:git
county,Nordland,2021-04-27,251,49,57505,16676,23.9260230085918,6.93835944163598,300,74181,fhi:git
county,Nordland,2021-04-28,3511,1071,61016,17747,25.386839751191,7.38396887807111,4582,78763,fhi:git
county,Nordland,2021-04-29,2727,1048,63743,18795,26.5214587363998,7.82000873743993,3775,82538,fhi:git
county,Nordland,2021-04-30,401,170,64144,18965,26.6883022322079,7.89074039401694,571,83109,fhi:git
county,Nordland,2021-05-01,1,0,64145,18965,26.688718300776,7.89074039401694,1,83110,fhi:git
county,Nordland,2021-05-02,0,0,64145,18965,26.688718300776,7.89074039401694,0,83110,fhi:git
county,Nordland,2021-05-03,30,1,64175,18966,26.701200357819,7.89115646258503,31,83141,fhi:git
county,Nordland,2021-05-04,32,222,64207,19188,26.7145145519982,7.98352368470324,254,83395,fhi:git
county,Nordland,2021-05-05,2637,1707,66844,20895,27.8116873660779,8.69375273044998,4344,87739,fhi:git
county,Nordland,2021-05-06,1962,1284,68806,22179,28.6280138966902,9.22798477189041,3246,90985,fhi:git
county,Nordland,2021-05-07,252,673,69058,22852,28.7328631758514,9.50799891822172,925,91910,fhi:git
county,Nordland,2021-05-08,0,0,69058,22852,28.7328631758514,9.50799891822172,0,91910,fhi:git
county,Nordland,2021-05-09,0,0,69058,22852,28.7328631758514,9.50799891822172,0,91910,fhi:git
county,Oslo,2020-12-27,5,0,5,0,0.0007209867713347,0.0,5,5,fhi:git
county,Oslo,2020-12-28,264,0,269,0,0.0387890882978079,0.0,264,269,fhi:git
county,Oslo,2020-12-29,118,0,387,0,0.0558043761013073,0.0,118,387,fhi:git
county,Oslo,2020-12-30,58,0,445,0,0.06416782264879,0.0,58,445,fhi:git
county,Oslo,2020-12-31,6,0,451,0,0.0650330067743917,0.0,6,451,fhi:git
county,Oslo,2021-01-01,6,0,457,0,0.0658981908999934,0.0,6,457,fhi:git
county,Oslo,2021-01-02,0,0,457,0,0.0658981908999934,0.0,0,457,fhi:git
county,Oslo,2021-01-03,0,0,457,0,0.0658981908999934,0.0,0,457,fhi:git
county,Oslo,2021-01-04,0,0,457,0,0.0655657738052539,0.0,0,457,fhi:git
county,Oslo,2021-01-05,482,0,939,0,0.134718296724581,0.0,482,939,fhi:git
county,Oslo,2021-01-06,603,0,1542,0,0.221230685356021,0.0,603,1542,fhi:git
county,Oslo,2021-01-07,968,0,2510,0,0.360109611052926,0.0,968,2510,fhi:git
county,Oslo,2021-01-08,450,0,2960,0,0.42467109510624,0.0,450,2960,fhi:git
county,Oslo,2021-01-09,129,0,3089,0,0.443178720534856,0.0,129,3089,fhi:git
county,Oslo,2021-01-10,100,0,3189,0,0.457525716991148,0.0,100,3189,fhi:git
county,Oslo,2021-01-11,78,0,3267,0,0.468716374227056,0.0,78,3267,fhi:git
county,Oslo,2021-01-12,241,0,3508,0,0.503292635686719,0.0,241,3508,fhi:git
county,Oslo,2021-01-13,492,0,4000,0,0.573879858251675,0.0,492,4000,fhi:git
county,Oslo,2021-01-14,1240,0,5240,0,0.751782614309694,0.0,1240,5240,fhi:git
county,Oslo,2021-01-15,1637,0,6877,0,0.986642946299192,0.0,1637,6877,fhi:git
county,Oslo,2021-01-16,642,0,7519,0,1.07875066354859,0.0,642,7519,fhi:git
county,Oslo,2021-01-17,281,5,7800,5,1.11906572359077,0.0007173498228145,286,7805,fhi:git
county,Oslo,2021-01-18,764,231,8564,236,1.22867677651684,0.0338589116368488,995,8800,fhi:git
county,Oslo,2021-01-19,809,70,9373,306,1.34474397784824,0.0439018091562531,879,9679,fhi:git
county,Oslo,2021-01-20,992,99,10365,405,1.48706618269465,0.0581053356479821,1091,10770,fhi:git
county,Oslo,2021-01-21,1020,21,11385,426,1.63340554654883,0.0611182049038034,1041,11811,fhi:git
county,Oslo,2021-01-22,670,6,12055,432,1.72953042280599,0.0619790246911809,676,12487,fhi:git
county,Oslo,2021-01-23,233,0,12288,432,1.76295892454915,0.0619790246911809,233,12720,fhi:git
county,Oslo,2021-01-24,68,0,12356,432,1.77271488213942,0.0619790246911809,68,12788,fhi:git
county,Oslo,2021-01-25,258,0,12614,432,1.80973013299666,0.0619790246911809,258,13046,fhi:git
county,Oslo,2021-01-26,313,406,12927,838,1.85463623190485,0.120227830303726,719,13765,fhi:git
county,Oslo,2021-01-27,1099,528,14026,1366,2.0123097229595,0.195979971592947,1627,15392,fhi:git
county,Oslo,2021-01-28,872,847,14898,2213,2.13741553205836,0.317499031577739,1719,17111,fhi:git
county,Oslo,2021-01-29,431,505,15329,2718,2.19925108678498,0.389951363682013,936,18047,fhi:git
county,Oslo,2021-01-30,95,154,15424,2872,2.21288073341846,0.412045738224703,249,18296,fhi:git
county,Oslo,2021-01-31,63,46,15487,2918,2.22191934118592,0.418645356594597,109,18405,fhi:git
county,Oslo,2021-02-01,54,48,15541,2966,2.22966671927232,0.425531914893617,102,18507,fhi:git
county,Oslo,2021-02-02,1521,150,17062,3116,2.44788453537252,0.447052409578055,1671,20178,fhi:git
county,Oslo,2021-02-03,2460,458,19522,3574,2.8008206481973,0.512761653347872,2918,23096,fhi:git
county,Oslo,2021-02-04,2052,1235,21574,4809,3.09522101548041,0.689947059583076,3287,26383,fhi:git
county,Oslo,2021-02-05,1380,1573,22954,6382,3.29320956657724,0.915625313840548,2953,29336,fhi:git
county,Oslo,2021-02-06,243,631,23197,7013,3.32807276796603,1.00615486147975,874,30210,fhi:git
county,Oslo,2021-02-07,210,275,23407,7288,3.35820146052424,1.04560910173455,485,30695,fhi:git
county,Oslo,2021-02-08,46,445,23453,7733,3.36480107889413,1.10945323596505,491,31186,fhi:git
county,Oslo,2021-02-09,1161,245,24614,7978,3.53136970775168,1.14460337728297,1406,32592,fhi:git
county,Oslo,2021-02-10,1827,813,26441,8791,3.79348933300814,1.26124445847262,2640,35232,fhi:git
county,Oslo,2021-02-11,1585,746,28026,9537,4.02088922684036,1.36827305203656,2331,37563,fhi:git
county,Oslo,2021-02-12,1356,423,29382,9960,4.21543449878768,1.42896084704667,1779,39342,fhi:git
county,Oslo,2021-02-13,274,194,29656,10154,4.25474526907792,1.45679402017188,468,39810,fhi:git
county,Oslo,2021-02-14,102,1,29758,10155,4.26937920546334,1.45693749013644,103,39913,fhi:git
county,Oslo,2021-02-15,276,447,30034,10602,4.3089769156827,1.52106856429606,723,40636,fhi:git
county,Oslo,2021-02-16,725,776,30759,11378,4.41299263999082,1.63240125679689,1501,42137,fhi:git
county,Oslo,2021-02-17,1425,1148,32184,12526,4.61743733949298,1.79710477611512,2573,44710,fhi:git
county,Oslo,2021-02-18,1073,921,33257,13447,4.77138061146899,1.92924061347757,1994,46704,fhi:git
county,Oslo,2021-02-19,1492,976,34749,14423,4.98543779859686,2.06926729889098,2468,49172,fhi:git
county,Oslo,2021-02-20,101,117,34850,14540,4.99992826501772,2.08605328474484,218,49390,fhi:git
county,Oslo,2021-02-21,4,63,34854,14603,5.00050214487597,2.0950918925123,67,49457,fhi:git
county,Oslo,2021-02-22,602,112,35456,14715,5.08687106354285,2.11116052854335,714,50171,fhi:git
county,Oslo,2021-02-23,341,1530,35797,16245,5.1357943214588,2.33066957432462,1871,52042,fhi:git
county,Oslo,2021-02-24,706,2346,36503,18591,5.23708411644022,2.66725011118922,3052,55094,fhi:git
county,Oslo,2021-02-25,603,1982,37106,20573,5.32359650507166,2.95160758095293,2585,57679,fhi:git
county,Oslo,2021-02-26,782,1375,37888,21948,5.43579001735987,3.14887878222694,2157,59836,fhi:git
county,Oslo,2021-02-27,259,105,38147,22053,5.47294873818166,3.16394312850605,364,60200,fhi:git
county,Oslo,2021-02-28,102,62,38249,22115,5.48758267456708,3.17283826630895,164,60364,fhi:git
county,Oslo,2021-03-01,1049,39,39298,22154,5.63808266739358,3.1784335949269,1088,61452,fhi:git
county,Oslo,2021-03-02,773,137,40071,22291,5.74898495000072,3.19808898007202,910,62362,fhi:git
county,Oslo,2021-03-03,1364,172,41435,22463,5.94467798166454,3.22276581397684,1536,63898,fhi:git
county,Oslo,2021-03-04,1185,202,42620,22665,6.1146898896716,3.25174674681855,1387,65285,fhi:git
county,Oslo,2021-03-05,1306,69,43926,22734,6.30206166339077,3.26164617437339,1375,66660,fhi:git
county,Oslo,2021-03-06,114,3,44040,22737,6.31841723935094,3.26207658426708,117,66777,fhi:git
county,Oslo,2021-03-07,70,0,44110,22737,6.32846013687035,3.26207658426708,70,66847,fhi:git
county,Oslo,2021-03-08,671,11,44781,22748,6.42472848309207,3.26365475387728,682,67529,fhi:git
county,Oslo,2021-03-09,780,1323,45561,24071,6.53663505545114,3.45346551699402,2103,69632,fhi:git
county,Oslo,2021-03-10,1210,2423,46771,26494,6.71023371257227,3.80109324112997,3633,73265,fhi:git
county,Oslo,2021-03-11,888,2391,47659,28885,6.83763504110415,4.14412992639991,3279,76544,fhi:git
county,Oslo,2021-03-12,278,1637,47937,30522,6.87751969125264,4.37899025838941,1915,78459,fhi:git
county,Oslo,2021-03-13,16,266,47953,30788,6.87981521068564,4.41715326896314,282,78741,fhi:git
county,Oslo,2021-03-14,5,96,47958,30884,6.88053256050846,4.43092638556118,101,78842,fhi:git
county,Oslo,2021-03-15,22,360,47980,31244,6.88368889972884,4.48257557280383,382,79224,fhi:git
county,Oslo,2021-03-16,1008,138,48988,31382,7.02830662400826,4.50237442791352,1146,80370,fhi:git
county,Oslo,2021-03-17,2744,116,51732,31498,7.42198820676891,4.51901694380282,2860,83230,fhi:git
county,Oslo,2021-03-18,2032,126,53764,31624,7.71351917476076,4.53709415933774,2158,85388,fhi:git
county,Oslo,2021-03-19,2031,188,55795,31812,8.00490667278805,4.56406651267557,2219,87607,fhi:git
county,Oslo,2021-03-20,394,18,56189,31830,8.06143383882584,4.5666489720377,412,88019,fhi:git
county,Oslo,2021-03-21,163,15,56352,31845,8.0848194430496,4.56880102150615,178,88197,fhi:git
county,Oslo,2021-03-22,928,11,57280,31856,8.21795957016399,4.57037919111634,939,89136,fhi:git
county,Oslo,2021-03-23,3332,104,60612,31960,8.69600149208763,4.58530006743088,3436,92572,fhi:git
county,Oslo,2021-03-24,5136,213,65748,32173,9.43286323008278,4.61585916988279,5349,97921,fhi:git
county,Oslo,2021-03-25,5153,50,70901,32223,10.1721639574755,4.62303266811093,5203,103124,fhi:git
county,Oslo,2021-03-26,4177,87,75078,32310,10.7714379994548,4.63551455502791,4264,107388,fhi:git
county,Oslo,2021-03-27,655,1,75733,32311,10.8654108262435,4.63565802499247,656,108044,fhi:git
county,Oslo,2021-03-28,150,0,75883,32311,10.886931320928,4.63565802499247,150,108194,fhi:git
county,Oslo,2021-03-29,2200,11,78083,32322,11.2025652429664,4.63723619460266,2211,110405,fhi:git
county,Oslo,2021-03-30,4393,212,82476,32534,11.8328287972913,4.66765182709,4605,115010,fhi:git
county,Oslo,2021-03-31,4248,772,86724,33306,12.4422892067546,4.77841063973257,5020,120030,fhi:git
county,Oslo,2021-04-01,2810,295,89534,33601,12.8454398071764,4.82073427927863,3105,123135,fhi:git
county,Oslo,2021-04-02,1671,167,91205,33768,13.085178117961,4.84469376336064,1838,124973,fhi:git
county,Oslo,2021-04-03,231,1,91436,33769,13.118319679775,4.8448372333252,232,125205,fhi:git
county,Oslo,2021-04-04,375,36,91811,33805,13.1721209164861,4.85000215204947,411,125616,fhi:git
county,Oslo,2021-04-05,1251,56,93062,33861,13.3516018421543,4.85803647006499,1307,126923,fhi:git
county,Oslo,2021-04-06,4559,109,97621,33970,14.0056814105967,4.87367469620235,4668,131591,fhi:git
county,Oslo,2021-04-07,6238,163,103859,34133,14.9006470495402,4.89706030042611,6401,137992,fhi:git
county,Oslo,2021-04-08,6088,149,109947,34282,15.7740921937992,4.91843732514598,6237,144229,fhi:git
county,Oslo,2021-04-09,5171,67,115118,34349,16.5159753805541,4.9280498127717,5238,149467,fhi:git
county,Oslo,2021-04-10,753,0,115871,34349,16.62400826387,4.9280498127717,753,150220,fhi:git
county,Oslo,2021-04-11,367,9,116238,34358,16.6766617408646,4.92934104245276,376,150596,fhi:git
county,Oslo,2021-04-12,1797,4,118035,34362,16.9344772671841,4.92991492231101,1801,152397,fhi:git
county,Oslo,2021-04-13,3139,47,121174,34409,17.3848294859471,4.93665801064547,3186,155583,fhi:git
county,Oslo,2021-04-14,5596,53,126770,34462,18.1876874076412,4.94426191876731,5649,161232,fhi:git
county,Oslo,2021-04-15,5639,159,132409,34621,18.9967145378115,4.96707364313281,5798,167030,fhi:git
county,Oslo,2021-04-16,5053,272,137462,34893,19.7216682687479,5.00609747349393,5325,172355,fhi:git
county,Oslo,2021-04-17,1597,156,139059,35049,19.9507898021549,5.02847878796574,1753,174108,fhi:git
county,Oslo,2021-04-18,1009,3,140068,35052,20.0955509963989,5.02890919785943,1012,175120,fhi:git
county,Oslo,2021-04-19,3176,112,143244,35164,20.5512116038507,5.04497783389048,3288,178408,fhi:git
county,Oslo,2021-04-20,3235,420,146479,35584,21.0153369392118,5.1052352190069,3655,182063,fhi:git
county,Oslo,2021-04-21,4490,482,150969,36066,21.6595170800993,5.17438774192623,4972,187035,fhi:git
county,Oslo,2021-04-22,4639,410,155608,36476,22.3250742457067,5.23321042739703,5049,192084,fhi:git
county,Oslo,2021-04-23,3220,510,158828,36986,22.7870475315993,5.30638010932411,3730,195814,fhi:git
county,Oslo,2021-04-24,239,26,159067,37012,22.8213368531298,5.31011032840275,265,196079,fhi:git
county,Oslo,2021-04-25,75,0,159142,37012,22.832097100472,5.31011032840275,75,196154,fhi:git
county,Oslo,2021-04-26,932,249,160074,37261,22.9658111074447,5.34583434957892,1181,197335,fhi:git
county,Oslo,2021-04-27,3770,1485,163844,38746,23.5066928738469,5.55888724695485,5255,202590,fhi:git
county,Oslo,2021-04-28,5368,3096,169212,41842,24.2768396436206,6.00307025724165,8464,211054,fhi:git
county,Oslo,2021-04-29,5143,2601,174355,44443,25.0147056713677,6.3762356350698,7744,218798,fhi:git
county,Oslo,2021-04-30,4062,2612,178417,47055,25.5974806674223,6.75097918250814,6674,225472,fhi:git
county,Oslo,2021-05-01,961,256,179378,47311,25.7353553033672,6.78770749343625,1217,226689,fhi:git
county,Oslo,2021-05-02,830,226,180208,47537,25.8544353739545,6.82013170542747,1056,227745,fhi:git
county,Oslo,2021-05-03,1328,924,181536,48461,26.044963486894,6.95269795268361,2252,229997,fhi:git
county,Oslo,2021-05-04,2802,2270,184338,50731,26.4469663275993,7.27837477224143,5072,235069,fhi:git
county,Oslo,2021-05-05,3907,4239,188245,54970,27.0075034791466,7.88654395202364,8146,243215,fhi:git
county,Oslo,2021-05-06,3807,4591,192052,59561,27.5536936342377,8.545214559332,8398,251613,fhi:git
county,Oslo,2021-05-07,3623,3682,195675,63243,28.0734853158491,9.07347096885267,7305,258918,fhi:git
county,Oslo,2021-05-08,398,495,196073,63738,28.1305863617452,9.14448860131131,893,259811,fhi:git
county,Oslo,2021-05-09,181,159,196254,63897,28.1565544253311,9.16730032567682,340,260151,fhi:git
county,Rogaland,2020-12-27,0,0,0,0,0.0,0.0,0,0,fhi:git
county,Rogaland,2020-12-28,1,0,1,0,0.0002083802188825,0.0,1,1,fhi:git
county,Rogaland,2020-12-29,0,0,1,0,0.0002083802188825,0.0,0,1,fhi:git
county,Rogaland,2020-12-30,0,0,1,0,0.0002083802188825,0.0,0,1,fhi:git
county,Rogaland,2020-12-31,0,0,1,0,0.0002083802188825,0.0,0,1,fhi:git
county,Rogaland,2021-01-01,0,0,1,0,0.0002083802188825,0.0,0,1,fhi:git
county,Rogaland,2021-01-02,0,0,1,0,0.0002083802188825,0.0,0,1,fhi:git
county,Rogaland,2021-01-03,1,0,2,0,0.0004167604377651,0.0,1,2,fhi:git
county,Rogaland,2021-01-04,0,0,2,0,0.0004143832423416,0.0,0,2,fhi:git
county,Rogaland,2021-01-05,547,0,549,0,0.113748200022791,0.0,547,549,fhi:git
county,Rogaland,2021-01-06,641,0,1190,0,0.246558029193299,0.0,641,1190,fhi:git
county,Rogaland,2021-01-07,213,0,1403,0,0.290689844502688,0.0,213,1403,fhi:git
county,Rogaland,2021-01-08,20,0,1423,0,0.294833676926105,0.0,20,1423,fhi:git
county,Rogaland,2021-01-09,1,0,1424,0,0.295040868547276,0.0,1,1424,fhi:git
county,Rogaland,2021-01-10,0,0,1424,0,0.295040868547276,0.0,0,1424,fhi:git
county,Rogaland,2021-01-11,4,0,1428,0,0.295869635031959,0.0,4,1428,fhi:git
county,Rogaland,2021-01-12,117,0,1545,0,0.320111054708948,0.0,117,1545,fhi:git
county,Rogaland,2021-01-13,763,0,2308,0,0.478198261662298,0.0,763,2308,fhi:git
county,Rogaland,2021-01-14,536,0,2844,0,0.589252970609869,0.0,536,2844,fhi:git
county,Rogaland,2021-01-15,293,0,3137,0,0.649960115612925,0.0,293,3137,fhi:git
county,Rogaland,2021-01-16,0,0,3137,0,0.649960115612925,0.0,0,3137,fhi:git
county,Rogaland,2021-01-17,2,0,3139,0,0.650374498855266,0.0,2,3139,fhi:git
county,Rogaland,2021-01-18,71,0,3210,0,0.665085103958396,0.0,71,3210,fhi:git
county,Rogaland,2021-01-19,513,0,3723,0,0.771374405619037,0.0,513,3723,fhi:git
county,Rogaland,2021-01-20,659,0,4382,0,0.90791368397062,0.0,659,4382,fhi:git
county,Rogaland,2021-01-21,431,0,4813,0,0.997213272695252,0.0,431,4813,fhi:git
county,Rogaland,2021-01-22,271,0,5084,0,1.05336220203255,0.0,271,5084,fhi:git
county,Rogaland,2021-01-23,0,0,5084,0,1.05336220203255,0.0,0,5084,fhi:git
county,Rogaland,2021-01-24,1,0,5085,0,1.05356939365372,0.0,1,5085,fhi:git
county,Rogaland,2021-01-25,150,0,5235,0,1.08464813682935,0.0,150,5235,fhi:git
county,Rogaland,2021-01-26,339,380,5574,380,1.15488609640626,0.0787328160449192,719,5954,fhi:git
county,Rogaland,2021-01-27,865,603,6439,983,1.33410684871904,0.203669363610936,1468,7422,fhi:git
county,Rogaland,2021-01-28,525,283,6964,1266,1.44288244983373,0.262304592402283,808,8230,fhi:git
county,Rogaland,2021-01-29,410,22,7374,1288,1.52783101451377,0.266862808068042,432,8662,fhi:git
county,Rogaland,2021-01-30,5,1,7379,1289,1.52886697261963,0.267069999689213,6,8668,fhi:git
county,Rogaland,2021-01-31,2,0,7381,1289,1.52928135586197,0.267069999689213,2,8670,fhi:git
county,Rogaland,2021-02-01,13,6,7394,1295,1.53197484693719,0.268313149416238,19,8689,fhi:git
county,Rogaland,2021-02-02,451,78,7845,1373,1.62541826808524,0.284474095867563,529,9218,fhi:git
county,Rogaland,2021-02-03,2437,638,10282,2011,2.13034424887858,0.416662350174559,3075,12293,fhi:git
county,Rogaland,2021-02-04,1889,563,12171,2574,2.52172922127029,0.533311232893742,2452,14745,fhi:git
county,Rogaland,2021-02-05,654,283,12825,2857,2.65723254151602,0.591946461685089,937,15682,fhi:git
county,Rogaland,2021-02-06,0,0,12825,2857,2.65723254151602,0.591946461685089,0,15682,fhi:git
county,Rogaland,2021-02-07,0,2,12825,2859,2.65723254151602,0.592360844927431,2,15684,fhi:git
county,Rogaland,2021-02-08,7,70,12832,2929,2.65868288286422,0.60686425840939,77,15761,fhi:git
county,Rogaland,2021-02-09,588,396,13420,3325,2.78051155611267,0.688912140393042,984,16745,fhi:git
county,Rogaland,2021-02-10,1924,685,15344,4010,3.17914823524537,0.830838400895068,2609,19354,fhi:git
county,Rogaland,2021-02-11,1185,496,16529,4506,3.42467030633281,0.933605444995804,1681,21035,fhi:git
county,Rogaland,2021-02-12,489,267,17018,4773,3.52598700908535,0.988925607848419,756,21791,fhi:git
county,Rogaland,2021-02-13,2,0,17020,4773,3.52640139232769,0.988925607848419,2,21793,fhi:git
county,Rogaland,2021-02-14,0,0,17020,4773,3.52640139232769,0.988925607848419,0,21793,fhi:git
county,Rogaland,2021-02-15,0,147,17020,4920,3.52640139232769,1.01938277616053,147,21940,fhi:git
county,Rogaland,2021-02-16,480,315,17500,5235,3.6258533704897,1.08464813682935,795,22735,fhi:git
county,Rogaland,2021-02-17,1489,783,18989,6018,3.93436169441308,1.24687917620611,2272,25007,fhi:git
county,Rogaland,2021-02-18,1103,476,20092,6494,4.16289405256451,1.34550238788343,1579,26586,fhi:git
county,Rogaland,2021-02-19,445,412,20537,6906,4.25509432398554,1.43086533580582,857,27443,fhi:git
county,Rogaland,2021-02-20,1,3,20538,6909,4.25530151560671,1.43148691066933,4,27447,fhi:git
county,Rogaland,2021-02-21,0,2,20538,6911,4.25530151560671,1.43190129391167,2,27449,fhi:git
county,Rogaland,2021-02-22,252,13,20790,6924,4.30751380414176,1.4345947849869,265,27714,fhi:git
county,Rogaland,2021-02-23,379,408,21169,7332,4.38603942856551,1.5191289664246,787,28501,fhi:git
county,Rogaland,2021-02-24,816,2177,21985,9509,4.55510779144091,1.97018512571352,2993,31494,fhi:git
county,Rogaland,2021-02-25,1232,1819,23217,11328,4.81036786872339,2.34706668462327,3051,34545,fhi:git
county,Rogaland,2021-02-26,999,683,24216,12011,5.01735229827306,2.48857856188296,1682,36227,fhi:git
county,Rogaland,2021-02-27,1,1,24217,12012,5.01755948989423,2.48878575350413,2,36229,fhi:git
county,Rogaland,2021-02-28,4,0,24221,12012,5.01838825637891,2.48878575350413,4,36233,fhi:git
county,Rogaland,2021-03-01,648,2,24869,12014,5.15264842689762,2.48920013674647,650,36883,fhi:git
county,Rogaland,2021-03-02,797,545,25666,12559,5.31778014897078,2.60211957028458,1342,38225,fhi:git
county,Rogaland,2021-03-03,1268,1462,26934,14021,5.5804991246154,2.90503372043635,2730,40955,fhi:git
county,Rogaland,2021-03-04,1090,1484,28024,15505,5.80633799169162,3.21250608625387,2574,43529,fhi:git
county,Rogaland,2021-03-05,597,433,28621,15938,5.93003138953061,3.30222005822085,1030,44559,fhi:git
county,Rogaland,2021-03-06,4,2,28625,15940,5.93086015601529,3.30263444146319,6,44565,fhi:git
county,Rogaland,2021-03-07,0,0,28625,15940,5.93086015601529,3.30263444146319,0,44565,fhi:git
county,Rogaland,2021-03-08,543,0,29168,15940,6.04336520631106,3.30263444146319,543,45108,fhi:git
county,Rogaland,2021-03-09,1576,466,30744,16406,6.3698992012763,3.3991857369288,2042,47150,fhi:git
county,Rogaland,2021-03-10,2204,1085,32948,17491,6.82654953433683,3.62398864589916,3289,50439,fhi:git
county,Rogaland,2021-03-11,1445,1059,34393,18550,7.12594142692869,3.84340457271908,2504,52943,fhi:git
county,Rogaland,2021-03-12,118,545,34511,19095,7.15039003822685,3.95632400625719,663,53606,fhi:git
county,Rogaland,2021-03-13,0,0,34511,19095,7.15039003822685,3.95632400625719,0,53606,fhi:git
county,Rogaland,2021-03-14,0,0,34511,19095,7.15039003822685,3.95632400625719,0,53606,fhi:git
county,Rogaland,2021-03-15,0,1,34511,19096,7.15039003822685,3.95653119787836,1,53607,fhi:git
county,Rogaland,2021-03-16,589,95,35100,19191,7.27242590309648,3.97621440188959,684,54291,fhi:git
county,Rogaland,2021-03-17,2402,95,37502,19286,7.77010017714884,3.99589760590082,2497,56788,fhi:git
county,Rogaland,2021-03-18,1675,83,39177,19369,8.11714614260999,4.013094510458,1758,58546,fhi:git
county,Rogaland,2021-03-19,276,26,39453,19395,8.17433103005314,4.01848149260844,302,58848,fhi:git
county,Rogaland,2021-03-20,0,0,39453,19395,8.17433103005314,4.01848149260844,0,58848,fhi:git
county,Rogaland,2021-03-21,1,0,39454,19395,8.17453822167432,4.01848149260844,1,58849,fhi:git
county,Rogaland,2021-03-22,15,17,39469,19412,8.17764609599188,4.02200375016834,32,58881,fhi:git
county,Rogaland,2021-03-23,837,49,40306,19461,8.35106548291187,4.03215613960571,886,59767,fhi:git
county,Rogaland,2021-03-24,3427,82,43733,19543,9.06111116866434,4.04914585254172,3509,63276,fhi:git
county,Rogaland,2021-03-25,3241,166,46974,19709,9.73261921287903,4.08353966165608,3407,66683,fhi:git
county,Rogaland,2021-03-26,822,77,47796,19786,9.90293072548146,4.09949341648624,899,67582,fhi:git
county,Rogaland,2021-03-27,0,0,47796,19786,9.90293072548146,4.09949341648624,0,67582,fhi:git
county,Rogaland,2021-03-28,1,2,47797,19788,9.90313791710263,4.09990779972858,3,67585,fhi:git
county,Rogaland,2021-03-29,235,0,48032,19788,9.95182794807778,4.09990779972858,235,67820,fhi:git
county,Rogaland,2021-03-30,4270,356,52302,20144,10.8365361704773,4.1736680168654,4626,72446,fhi:git
county,Rogaland,2021-03-31,2186,621,54488,20765,11.2894570543567,4.30233401361249,2807,75253,fhi:git
county,Rogaland,2021-04-01,569,1,55057,20766,11.4073490868029,4.30254120523366,570,75823,fhi:git
county,Rogaland,2021-04-02,8,21,55065,20787,11.4090066197723,4.30689222927825,29,75852,fhi:git
county,Rogaland,2021-04-03,0,1,55065,20788,11.4090066197723,4.30709942089942,1,75853,fhi:git
county,Rogaland,2021-04-04,0,0,55065,20788,11.4090066197723,4.30709942089942,0,75853,fhi:git
county,Rogaland,2021-04-05,0,1,55065,20789,11.4090066197723,4.30730661252059,1,75854,fhi:git
county,Rogaland,2021-04-06,1375,77,56440,20866,11.6938950988822,4.32326036735075,1452,77306,fhi:git
county,Rogaland,2021-04-07,5915,120,62355,20986,12.9194335381077,4.34812336189125,6035,83341,fhi:git
county,Rogaland,2021-04-08,5154,533,67509,21519,13.9872991536222,4.4585564959753,5687,89028,fhi:git
county,Rogaland,2021-04-09,1892,35,69401,21554,14.3793057008775,4.46580820271628,1927,90955,fhi:git
county,Rogaland,2021-04-10,5,1,69406,21555,14.3803416589833,4.46601539433745,6,90961,fhi:git
county,Rogaland,2021-04-11,0,0,69406,21555,14.3803416589833,4.46601539433745,0,90961,fhi:git
county,Rogaland,2021-04-12,16,14,69422,21569,14.383656724922,4.46891607703384,30,90991,fhi:git
county,Rogaland,2021-04-13,1623,36,71045,21605,14.7199287260823,4.476374975396,1659,92650,fhi:git
county,Rogaland,2021-04-14,7630,39,78675,21644,16.3008007956158,4.48445544862166,7669,100319,fhi:git
county,Rogaland,2021-04-15,5193,81,83868,21725,17.376746884356,4.5012379699365,5274,105593,fhi:git
county,Rogaland,2021-04-16,2143,20,86011,21745,17.8207585285251,4.50538180235991,2163,107756,fhi:git
county,Rogaland,2021-04-17,1,0,86012,21745,17.8209657201463,4.50538180235991,1,107757,fhi:git
county,Rogaland,2021-04-18,0,0,86012,21745,17.8209657201463,4.50538180235991,0,107757,fhi:git
county,Rogaland,2021-04-19,28,2,86040,21747,17.8267670855391,4.50579618560226,30,107787,fhi:git
county,Rogaland,2021-04-20,1075,38,87115,21785,18.0494980782977,4.51366946720675,1113,108900,fhi:git
county,Rogaland,2021-04-21,6676,357,93791,22142,19.4327093412342,4.58763687596474,7033,115933,fhi:git
county,Rogaland,2021-04-22,5112,149,98903,22291,20.4918729086596,4.61850842751919,5261,121194,fhi:git
county,Rogaland,2021-04-23,1674,68,100577,22359,20.8387116824996,4.63259745775881,1742,122936,fhi:git
county,Rogaland,2021-04-24,0,0,100577,22359,20.8387116824996,4.63259745775881,0,122936,fhi:git
county,Rogaland,2021-04-25,0,0,100577,22359,20.8387116824996,4.63259745775881,0,122936,fhi:git
county,Rogaland,2021-04-26,10,2,100587,22361,20.8407835987113,4.63301184100115,12,122948,fhi:git
county,Rogaland,2021-04-27,1121,693,101708,23054,21.0730454060438,4.77659563447254,1814,124762,fhi:git
county,Rogaland,2021-04-28,5785,2450,107493,25504,22.2716489345171,5.2842151063411,8235,132997,fhi:git
county,Rogaland,2021-04-29,5307,1220,112800,26724,23.3712148680707,5.53698888416952,6527,139524,fhi:git
county,Rogaland,2021-04-30,2332,359,115132,27083,23.8543857286411,5.61137067616986,2691,142215,fhi:git
county,Rogaland,2021-05-01,3,0,115135,27083,23.8550073035046,5.61137067616986,3,142218,fhi:git
county,Rogaland,2021-05-02,0,0,115135,27083,23.8550073035046,5.61137067616986,0,142218,fhi:git
county,Rogaland,2021-05-03,33,13,115168,27096,23.8618446270033,5.61406416724508,46,142264,fhi:git
county,Rogaland,2021-05-04,288,968,115456,28064,23.9215158139005,5.81462565653845,1256,143520,fhi:git
county,Rogaland,2021-05-05,3715,3389,119171,31453,24.6912326865502,6.51679806068643,7104,150624,fhi:git
county,Rogaland,2021-05-06,3034,3046,122205,34499,25.3198520651825,7.1479037387728,6080,156704,fhi:git
county,Rogaland,2021-05-07,747,905,122952,35404,25.4746242061971,7.33541215593241,1652,158356,fhi:git
county,Rogaland,2021-05-08,0,0,122952,35404,25.4746242061971,7.33541215593241,0,158356,fhi:git
county,Rogaland,2021-05-09,0,1,122952,35405,25.4746242061971,7.33561934755358,1,158357,fhi:git
county,Troms og Finnmark,2020-12-27,0,0,0,0,0.0,0.0,0,0,fhi:git
county,Troms og Finnmark,2020-12-28,1,0,1,0,0.0004109966257177,0.0,1,1,fhi:git
county,Troms og Finnmark,2020-12-29,0,0,1,0,0.0004109966257177,0.0,0,1,fhi:git
county,Troms og Finnmark,2020-12-30,0,0,1,0,0.0004109966257177,0.0,0,1,fhi:git
county,Troms og Finnmark,2020-12-31,0,0,1,0,0.0004109966257177,0.0,0,1,fhi:git
county,Troms og Finnmark,2021-01-01,0,0,1,0,0.0004109966257177,0.0,0,1,fhi:git
county,Troms og Finnmark,2021-01-02,0,0,1,0,0.0004109966257177,0.0,0,1,fhi:git
county,Troms og Finnmark,2021-01-03,13,0,14,0,0.0057539527600478,0.0,13,14,fhi:git
county,Troms og Finnmark,2021-01-04,0,0,14,0,0.00578111063394,0.0,0,14,fhi:git
county,Troms og Finnmark,2021-01-05,53,0,67,0,0.0276667437481418,0.0,53,67,fhi:git
county,Troms og Finnmark,2021-01-06,530,0,597,0,0.246523074890159,0.0,530,597,fhi:git
county,Troms og Finnmark,2021-01-07,189,0,786,0,0.32456806844835,0.0,189,786,fhi:git
county,Troms og Finnmark,2021-01-08,247,0,1033,0,0.426563377490007,0.0,247,1033,fhi:git
county,Troms og Finnmark,2021-01-09,0,0,1033,0,0.426563377490007,0.0,0,1033,fhi:git
county,Troms og Finnmark,2021-01-10,0,0,1033,0,0.426563377490007,0.0,0,1033,fhi:git
county,Troms og Finnmark,2021-01-11,0,0,1033,0,0.426563377490007,0.0,0,1033,fhi:git
county,Troms og Finnmark,2021-01-12,190,0,1223,0,0.505021307522051,0.0,190,1223,fhi:git
county,Troms og Finnmark,2021-01-13,570,0,1793,0,0.740395097618182,0.0,570,1793,fhi:git
county,Troms og Finnmark,2021-01-14,331,0,2124,0,0.87707707046348,0.0,331,2124,fhi:git
county,Troms og Finnmark,2021-01-15,39,0,2163,0,0.893181592943742,0.0,39,2163,fhi:git
county,Troms og Finnmark,2021-01-16,2,0,2165,0,0.894007465891447,0.0,2,2165,fhi:git
county,Troms og Finnmark,2021-01-17,0,0,2165,0,0.894007465891447,0.0,0,2165,fhi:git
county,Troms og Finnmark,2021-01-18,0,1,2165,1,0.894007465891447,0.0004129364738528,1,2166,fhi:git
county,Troms og Finnmark,2021-01-19,251,0,2416,1,0.997654520828516,0.0004129364738528,251,2417,fhi:git
county,Troms og Finnmark,2021-01-20,924,0,3340,1,1.37920782266856,0.0004129364738528,924,3341,fhi:git
county,Troms og Finnmark,2021-01-21,246,0,3586,1,1.48079019523637,0.0004129364738528,246,3587,fhi:git
county,Troms og Finnmark,2021-01-22,82,0,3668,1,1.5146509860923,0.0004129364738528,82,3669,fhi:git
county,Troms og Finnmark,2021-01-23,12,0,3680,1,1.51960622377853,0.0004129364738528,12,3681,fhi:git
county,Troms og Finnmark,2021-01-24,0,0,3680,1,1.51960622377853,0.0004129364738528,0,3681,fhi:git
county,Troms og Finnmark,2021-01-25,6,0,3686,1,1.52208384262165,0.0004129364738528,6,3687,fhi:git
county,Troms og Finnmark,2021-01-26,85,0,3771,1,1.55718344289914,0.0004129364738528,85,3772,fhi:git
county,Troms og Finnmark,2021-01-27,668,357,4439,358,1.83302500743286,0.147831257639325,1025,4797,fhi:git
county,Troms og Finnmark,2021-01-28,234,277,4673,635,1.92965214231443,0.262214660896568,511,5308,fhi:git
county,Troms og Finnmark,2021-01-29,105,243,4778,878,1.97301047206898,0.362558224042813,348,5656,fhi:git
county,Troms og Finnmark,2021-01-30,0,0,4778,878,1.97301047206898,0.362558224042813,0,5656,fhi:git
county,Troms og Finnmark,2021-01-31,0,0,4778,878,1.97301047206898,0.362558224042813,0,5656,fhi:git
county,Troms og Finnmark,2021-02-01,0,1,4778,879,1.97301047206898,0.362971160516666,1,5657,fhi:git
county,Troms og Finnmark,2021-02-02,119,24,4897,903,2.02214991245747,0.372881635889135,143,5800,fhi:git
county,Troms og Finnmark,2021-02-03,1161,563,6058,1466,2.50156915860064,0.605364870668296,1724,7524,fhi:git
county,Troms og Finnmark,2021-02-04,1150,381,7208,1847,2.97644610353143,0.762693667206237,1531,9055,fhi:git
county,Troms og Finnmark,2021-02-05,288,141,7496,1988,3.09537180800106,0.820917710019491,429,9484,fhi:git
county,Troms og Finnmark,2021-02-06,1,2,7497,1990,3.09578474447491,0.821743582967196,3,9487,fhi:git
county,Troms og Finnmark,2021-02-07,0,0,7497,1990,3.09578474447491,0.821743582967196,0,9487,fhi:git
county,Troms og Finnmark,2021-02-08,0,0,7497,1990,3.09578474447491,0.821743582967196,0,9487,fhi:git
county,Troms og Finnmark,2021-02-09,71,29,7568,2019,3.12510323411846,0.833718740708929,100,9587,fhi:git
county,Troms og Finnmark,2021-02-10,1411,812,8979,2831,3.70775659872485,1.16902315747745,2223,11810,fhi:git
county,Troms og Finnmark,2021-02-11,997,465,9976,3296,4.11945426315616,1.36103861781903,1462,13272,fhi:git
county,Troms og Finnmark,2021-02-12,294,114,10270,3410,4.2408575864689,1.40811337583826,408,13680,fhi:git
county,Troms og Finnmark,2021-02-13,5,2,10275,3412,4.24292226883816,1.40893924878597,7,13687,fhi:git
county,Troms og Finnmark,2021-02-14,0,0,10275,3412,4.24292226883816,1.40893924878597,0,13687,fhi:git
county,Troms og Finnmark,2021-02-15,0,6,10275,3418,4.24292226883816,1.41141686762908,6,13693,fhi:git
county,Troms og Finnmark,2021-02-16,133,52,10408,3470,4.29784281986059,1.43288956426943,185,13878,fhi:git
county,Troms og Finnmark,2021-02-17,968,583,11376,4053,4.69756532655016,1.67363152852565,1551,15429,fhi:git
county,Troms og Finnmark,2021-02-18,1299,261,12675,4314,5.23396980608503,1.78140794820125,1560,16989,fhi:git
county,Troms og Finnmark,2021-02-19,233,135,12908,4449,5.33018400449275,1.83715437217139,368,17357,fhi:git
county,Troms og Finnmark,2021-02-20,0,0,12908,4449,5.33018400449275,1.83715437217139,0,17357,fhi:git
county,Troms og Finnmark,2021-02-21,1,0,12909,4449,5.3305969409666,1.83715437217139,1,17358,fhi:git
county,Troms og Finnmark,2021-02-22,107,0,13016,4449,5.37478114366886,1.83715437217139,107,17465,fhi:git
county,Troms og Finnmark,2021-02-23,79,78,13095,4527,5.40740312510323,1.86936341713191,157,17622,fhi:git
county,Troms og Finnmark,2021-02-24,431,993,13526,5520,5.58537874533382,2.2794093356678,1424,19046,fhi:git
county,Troms og Finnmark,2021-02-25,568,1055,14094,6575,5.81992666248224,2.71505731558257,1623,20669,fhi:git
county,Troms og Finnmark,2021-02-26,283,407,14377,6982,5.9367876845826,2.88312246044069,690,21359,fhi:git
county,Troms og Finnmark,2021-02-27,0,0,14377,6982,5.9367876845826,2.88312246044069,0,21359,fhi:git
county,Troms og Finnmark,2021-02-28,3,0,14380,6982,5.93802649400416,2.88312246044069,3,21362,fhi:git
county,Troms og Finnmark,2021-03-01,342,0,14722,6982,6.07925076806184,2.88312246044069,342,21704,fhi:git
county,Troms og Finnmark,2021-03-02,567,72,15289,7054,6.31338574873642,2.91285388655809,639,22343,fhi:git
county,Troms og Finnmark,2021-03-03,599,1184,15888,8238,6.56073469657428,3.40177067159988,1783,24126,fhi:git
county,Troms og Finnmark,2021-03-04,881,936,16769,9174,6.92453173003865,3.78827921112616,1817,25943,fhi:git
county,Troms og Finnmark,2021-03-05,726,374,17495,9548,7.22432361005583,3.94271745234713,1100,27043,fhi:git
county,Troms og Finnmark,2021-03-06,0,1,17495,9549,7.22432361005583,3.94313038882098,1,27044,fhi:git
county,Troms og Finnmark,2021-03-07,0,0,17495,9549,7.22432361005583,3.94313038882098,0,27044,fhi:git
county,Troms og Finnmark,2021-03-08,434,0,17929,9549,7.40353803970797,3.94313038882098,434,27478,fhi:git
county,Troms og Finnmark,2021-03-09,624,51,18553,9600,7.66121039939216,3.96419014898748,675,28153,fhi:git
county,Troms og Finnmark,2021-03-10,939,701,19492,10301,8.04895774834,4.25365861715834,1640,29793,fhi:git
county,Troms og Finnmark,2021-03-11,812,1043,20304,11344,8.38426216510852,4.68435135938687,1855,31648,fhi:git
county,Troms og Finnmark,2021-03-12,68,210,20372,11554,8.41234184533052,4.77106801889597,278,31926,fhi:git
county,Troms og Finnmark,2021-03-13,0,0,20372,11554,8.41234184533052,4.77106801889597,0,31926,fhi:git
county,Troms og Finnmark,2021-03-14,0,0,20372,11554,8.41234184533052,4.77106801889597,0,31926,fhi:git
county,Troms og Finnmark,2021-03-15,3,5,20375,11559,8.41358065475207,4.77313270126524,8,31934,fhi:git
county,Troms og Finnmark,2021-03-16,21,2,20396,11561,8.42225232070298,4.77395857421294,23,31957,fhi:git
county,Troms og Finnmark,2021-03-17,548,46,20944,11607,8.64854150837435,4.79295365201018,594,32551,fhi:git
county,Troms og Finnmark,2021-03-18,1113,122,22057,11729,9.10813980377259,4.84333190182022,1235,33786,fhi:git
county,Troms og Finnmark,2021-03-19,408,33,22465,11762,9.27661788510456,4.85695880545737,441,34227,fhi:git
county,Troms og Finnmark,2021-03-20,0,0,22465,11762,9.27661788510456,4.85695880545737,0,34227,fhi:git
county,Troms og Finnmark,2021-03-21,1,0,22466,11762,9.27703082157841,4.85695880545737,1,34228,fhi:git
county,Troms og Finnmark,2021-03-22,3,0,22469,11762,9.27826963099997,4.85695880545737,3,34231,fhi:git
county,Troms og Finnmark,2021-03-23,414,27,22883,11789,9.44922533117505,4.8681080902514,441,34672,fhi:git
county,Troms og Finnmark,2021-03-24,1878,42,24761,11831,10.2247200290707,4.88545142215322,1920,36592,fhi:git
county,Troms og Finnmark,2021-03-25,2006,38,26767,11869,11.0530705956196,4.90114300815962,2044,38636,fhi:git
county,Troms og Finnmark,2021-03-26,558,15,27325,11884,11.2834891480295,4.90733705526742,573,39209,fhi:git
county,Troms og Finnmark,2021-03-27,1,0,27326,11884,11.2839020845033,4.90733705526742,1,39210,fhi:git
county,Troms og Finnmark,2021-03-28,0,0,27326,11884,11.2839020845033,4.90733705526742,0,39210,fhi:git
county,Troms og Finnmark,2021-03-29,176,0,27502,11884,11.3565789039014,4.90733705526742,176,39386,fhi:git
county,Troms og Finnmark,2021-03-30,1625,149,29127,12033,12.0276006739123,4.96886458987149,1774,41160,fhi:git
county,Troms og Finnmark,2021-03-31,1429,291,30556,12324,12.6176868950481,5.08902910376268,1720,42880,fhi:git
county,Troms og Finnmark,2021-04-01,165,35,30721,12359,12.6858214132338,5.10348188034753,200,43080,fhi:git
county,Troms og Finnmark,2021-04-02,27,14,30748,12373,12.6969706980278,5.10926299098147,41,43121,fhi:git
county,Troms og Finnmark,2021-04-03,1,0,30749,12373,12.6973836345017,5.10926299098147,1,43122,fhi:git
county,Troms og Finnmark,2021-04-04,0,0,30749,12373,12.6973836345017,5.10926299098147,0,43122,fhi:git
county,Troms og Finnmark,2021-04-05,0,0,30749,12373,12.6973836345017,5.10926299098147,0,43122,fhi:git
county,Troms og Finnmark,2021-04-06,722,13,31471,12386,12.9955237686234,5.11463116514156,735,43857,fhi:git
county,Troms og Finnmark,2021-04-07,2687,60,34158,12446,14.1050840738661,5.13940735357273,2747,46604,fhi:git
county,Troms og Finnmark,2021-04-08,2506,319,36664,12765,15.1399028773414,5.27113408873179,2825,49429,fhi:git
county,Troms og Finnmark,2021-04-09,1994,62,38658,12827,15.963298206204,5.29673615011067,2056,51485,fhi:git
county,Troms og Finnmark,2021-04-10,4,1,38662,12828,15.9649499520994,5.29714908658452,5,51490,fhi:git
county,Troms og Finnmark,2021-04-11,1,0,38663,12828,15.9653628885732,5.29714908658452,1,51491,fhi:git
county,Troms og Finnmark,2021-04-12,4,4,38667,12832,15.9670146344686,5.29880083247993,8,51499,fhi:git
county,Troms og Finnmark,2021-04-13,505,17,39172,12849,16.1755475537643,5.30582075253543,522,52021,fhi:git
county,Troms og Finnmark,2021-04-14,3080,38,42252,12887,17.4473918932311,5.32151233854184,3118,55139,fhi:git
county,Troms og Finnmark,2021-04-15,3188,118,45440,13005,18.7638333718741,5.37023884245648,3306,58445,fhi:git
county,Troms og Finnmark,2021-04-16,1721,8,47161,13013,19.4744970433748,5.3735423342473,1729,60174,fhi:git
county,Troms og Finnmark,2021-04-17,2,0,47163,13013,19.4753229163226,5.3735423342473,2,60176,fhi:git
county,Troms og Finnmark,2021-04-18,0,0,47163,13013,19.4753229163226,5.3735423342473,0,60176,fhi:git
county,Troms og Finnmark,2021-04-19,6,0,47169,13013,19.4778005351657,5.3735423342473,6,60182,fhi:git
county,Troms og Finnmark,2021-04-20,547,1,47716,13014,19.7036767863632,5.37395527072115,548,60730,fhi:git
county,Troms og Finnmark,2021-04-21,2464,163,50180,13177,20.7211522579366,5.44126391595917,2627,63357,fhi:git
county,Troms og Finnmark,2021-04-22,2535,36,52715,13213,21.7679462191536,5.45612962901787,2571,65928,fhi:git
county,Troms og Finnmark,2021-04-23,1717,20,54432,13233,22.476958144759,5.46438835849493,1737,67665,fhi:git
county,Troms og Finnmark,2021-04-24,0,0,54432,13233,22.476958144759,5.46438835849493,0,67665,fhi:git
county,Troms og Finnmark,2021-04-25,0,0,54432,13233,22.476958144759,5.46438835849493,0,67665,fhi:git
county,Troms og Finnmark,2021-04-26,10,0,54442,13233,22.4810875094975,5.46438835849493,10,67675,fhi:git
county,Troms og Finnmark,2021-04-27,507,10,54949,13243,22.6904463017409,5.46851772323346,517,68192,fhi:git
county,Troms og Finnmark,2021-04-28,2562,597,57511,13840,23.748389547752,5.71504079812362,3159,71351,fhi:git
county,Troms og Finnmark,2021-04-29,2065,840,59576,14680,24.6011033662581,6.06190743616002,2905,74256,fhi:git
county,Troms og Finnmark,2021-04-30,1562,416,61138,15096,25.2461101384163,6.23368900928281,1978,76234,fhi:git
county,Troms og Finnmark,2021-05-01,0,0,61138,15096,25.2461101384163,6.23368900928281,0,76234,fhi:git
county,Troms og Finnmark,2021-05-02,0,1,61138,15097,25.2461101384163,6.23410194575667,1,76235,fhi:git
county,Troms og Finnmark,2021-05-03,57,2,61195,15099,25.2696475174259,6.23492781870437,59,76294,fhi:git
county,Troms og Finnmark,2021-05-04,239,545,61434,15644,25.3683393346768,6.45997819695418,784,77078,fhi:git
county,Troms og Finnmark,2021-05-05,1419,2013,62853,17657,25.954296191074,7.29121931881999,3432,80510,fhi:git
county,Troms og Finnmark,2021-05-06,1265,1929,64118,19586,26.4766608304978,8.08777377688216,3194,83704,fhi:git
county,Troms og Finnmark,2021-05-07,1363,556,65481,20142,27.0394932443593,8.31736645634436,1919,85623,fhi:git
county,Troms og Finnmark,2021-05-08,0,0,65481,20142,27.0394932443593,8.31736645634436,0,85623,fhi:git
county,Troms og Finnmark,2021-05-09,0,0,65481,20142,27.0394932443593,8.31736645634436,0,85623,fhi:git
county,Trøndelag,2020-12-27,0,0,0,0,0.0,0.0,0,0,fhi:git
county,Trøndelag,2020-12-28,0,0,0,0,0.0,0.0,0,0,fhi:git
county,Trøndelag,2020-12-29,0,0,0,0,0.0,0.0,0,0,fhi:git
county,Trøndelag,2020-12-30,0,0,0,0,0.0,0.0,0,0,fhi:git
county,Trøndelag,2020-12-31,0,0,0,0,0.0,0.0,0,0,fhi:git
county,Trøndelag,2021-01-01,0,0,0,0,0.0,0.0,0,0,fhi:git
county,Trøndelag,2021-01-02,0,0,0,0,0.0,0.0,0,0,fhi:git
county,Trøndelag,2021-01-03,0,0,0,0,0.0,0.0,0,0,fhi:git
county,Trøndelag,2021-01-04,3,0,3,0,0.0006367750316264,0.0,3,3,fhi:git
county,Trøndelag,2021-01-05,407,0,410,0,0.0870259209889541,0.0,407,410,fhi:git
county,Trøndelag,2021-01-06,675,0,1085,0,0.230300303104915,0.0,675,1085,fhi:git
county,Trøndelag,2021-01-07,483,0,1568,0,0.332821083196781,0.0,483,1568,fhi:git
county,Trøndelag,2021-01-08,141,0,1709,0,0.362749509683226,0.0,141,1709,fhi:git
county,Trøndelag,2021-01-09,0,0,1709,0,0.362749509683226,0.0,0,1709,fhi:git
county,Trøndelag,2021-01-10,0,0,1709,0,0.362749509683226,0.0,0,1709,fhi:git
county,Trøndelag,2021-01-11,96,0,1805,0,0.383126310695273,0.0,96,1805,fhi:git
county,Trøndelag,2021-01-12,502,0,2307,0,0.489679999320773,0.0,502,2307,fhi:git
county,Trøndelag,2021-01-13,861,0,3168,0,0.672434433397577,0.0,861,3168,fhi:git
county,Trøndelag,2021-01-14,671,0,3839,0,0.814859782138036,0.0,671,3839,fhi:git
county,Trøndelag,2021-01-15,252,0,4091,0,0.868348884794661,0.0,252,4091,fhi:git
county,Trøndelag,2021-01-16,0,0,4091,0,0.868348884794661,0.0,0,4091,fhi:git
county,Trøndelag,2021-01-17,0,0,4091,0,0.868348884794661,0.0,0,4091,fhi:git
county,Trøndelag,2021-01-18,152,0,4243,0,0.900612153063737,0.0,152,4243,fhi:git
county,Trøndelag,2021-01-19,568,0,4811,0,1.02117489238502,0.0,568,4811,fhi:git
county,Trøndelag,2021-01-20,741,0,5552,0,1.17845832519676,0.0,741,5552,fhi:git
county,Trøndelag,2021-01-21,539,0,6091,0,1.29286557254566,0.0,539,6091,fhi:git
county,Trøndelag,2021-01-22,283,0,6374,0,1.35293468386242,0.0,283,6374,fhi:git
county,Trøndelag,2021-01-23,1,0,6375,0,1.3531469422063,0.0,1,6375,fhi:git
county,Trøndelag,2021-01-24,0,0,6375,0,1.3531469422063,0.0,0,6375,fhi:git
county,Trøndelag,2021-01-25,1,0,6376,0,1.35335920055017,0.0,1,6376,fhi:git
county,Trøndelag,2021-01-26,313,191,6689,191,1.4197960621832,0.0405413436802201,504,6880,fhi:git
county,Trøndelag,2021-01-27,1013,605,7702,796,1.63481376452908,0.168957641724896,1618,8498,fhi:git
county,Trøndelag,2021-01-28,727,483,8429,1279,1.78912558052657,0.271478421816762,1210,9708,fhi:git
county,Trøndelag,2021-01-29,424,229,8853,1508,1.87912311832978,0.320085582564251,653,10361,fhi:git
county,Trøndelag,2021-01-30,1,0,8854,1508,1.87933537667366,0.320085582564251,1,10362,fhi:git
county,Trøndelag,2021-01-31,2,1,8856,1509,1.87975989336141,0.320297840908126,3,10365,fhi:git
county,Trøndelag,2021-02-01,15,86,8871,1595,1.88294376851954,0.338552058481419,101,10466,fhi:git
county,Trøndelag,2021-02-02,838,393,9709,1988,2.06081626068721,0.42196958762449,1231,11697,fhi:git
county,Trøndelag,2021-02-03,2129,811,11838,2799,2.51271427479814,0.594111104507518,2940,14637,fhi:git
county,Trøndelag,2021-02-04,2145,608,13983,3407,2.96800842241109,0.723164177583821,2753,17390,fhi:git
county,Trøndelag,2021-02-05,1290,320,15273,3727,3.24182168601048,0.79108684762398,1610,19000,fhi:git
county,Trøndelag,2021-02-06,7,0,15280,3727,3.24330749441761,0.79108684762398,7,19007,fhi:git
county,Trøndelag,2021-02-07,1,0,15281,3727,3.24351975276148,0.79108684762398,1,19008,fhi:git
county,Trøndelag,2021-02-08,2,150,15283,3877,3.24394426944923,0.822925599205305,152,19160,fhi:git
county,Trøndelag,2021-02-09,839,523,16122,4400,3.42202901996077,0.93393671305219,1362,20522,fhi:git
county,Trøndelag,2021-02-10,2238,633,18360,5033,3.89706319355414,1.06829624472538,2871,23393,fhi:git
county,Trøndelag,2021-02-11,2361,588,20721,5621,4.39820514344419,1.19310415092417,2949,26342,fhi:git
county,Trøndelag,2021-02-12,890,353,21611,5974,4.58711506949338,1.26803134631222,1243,27585,fhi:git
county,Trøndelag,2021-02-13,2,0,21613,5974,4.58753958618113,1.26803134631222,2,27587,fhi:git
county,Trøndelag,2021-02-14,0,0,21613,5974,4.58753958618113,1.26803134631222,0,27587,fhi:git
county,Trøndelag,2021-02-15,0,2,21613,5976,4.58753958618113,1.26845586299997,2,27589,fhi:git
county,Trøndelag,2021-02-16,345,210,21958,6186,4.66076871481818,1.31303011521383,555,28144,fhi:git
county,Trøndelag,2021-02-17,2227,924,24185,7110,5.13346804662891,1.50915682495479,3151,31295,fhi:git
county,Trøndelag,2021-02-18,2124,752,26309,7862,5.58430476902047,1.66877509954916,2876,34171,fhi:git
county,Trøndelag,2021-02-19,1263,415,27572,8277,5.85238705733522,1.7568623122575,1678,35849,fhi:git
county,Trøndelag,2021-02-20,1,1,27573,8278,5.8525993156791,1.75707457060137,2,35851,fhi:git
county,Trøndelag,2021-02-21,0,4,27573,8282,5.8525993156791,1.75792360397687,4,35855,fhi:git
county,Trøndelag,2021-02-22,17,3,27590,8285,5.85620770752498,1.7585603790085,20,35875,fhi:git
county,Trøndelag,2021-02-23,331,676,27921,8961,5.92646521934777,1.90204701946834,1007,36882,fhi:git
county,Trøndelag,2021-02-24,1008,2055,28929,11016,6.14042162997427,2.33823791613248,3063,39945,fhi:git
county,Trøndelag,2021-02-25,471,2000,29400,13016,6.24039530993963,2.76275460388348,2471,42416,fhi:git
county,Trøndelag,2021-02-26,630,1157,30030,14173,6.3741180665812,3.00833750774743,1787,44203,fhi:git
county,Trøndelag,2021-02-27,4,1,30034,14174,6.3749670999567,3.00854976609131,5,44208,fhi:git
county,Trøndelag,2021-02-28,0,0,30034,14174,6.3749670999567,3.00854976609131,0,44208,fhi:git
county,Trøndelag,2021-03-01,544,0,30578,14174,6.49043563902497,3.00854976609131,544,44752,fhi:git
county,Trøndelag,2021-03-02,816,789,31394,14963,6.66363844762738,3.17602159940907,1605,46357,fhi:git
county,Trøndelag,2021-03-03,2045,2151,33439,17114,7.09770676085277,3.63258929708527,4196,50553,fhi:git
county,Trøndelag,2021-03-04,1874,2283,35313,19397,7.49547889727545,4.11717509615303,4157,54710,fhi:git
county,Trøndelag,2021-03-05,1048,983,36361,20380,7.71792564165697,4.32582504818264,2031,56741,fhi:git
county,Trøndelag,2021-03-06,3,0,36364,20380,7.7185624166886,4.32582504818264,3,56744,fhi:git
county,Trøndelag,2021-03-07,0,1,36364,20381,7.7185624166886,4.32603730652652,1,56745,fhi:git
county,Trøndelag,2021-03-08,435,0,36799,20381,7.81089479627444,4.32603730652652,435,57180,fhi:git
county,Trøndelag,2021-03-09,1173,301,37972,20682,8.0598738336404,4.38992706803304,1474,58654,fhi:git
county,Trøndelag,2021-03-10,1687,1503,39659,22185,8.41795365975836,4.70895135887792,3190,61844,fhi:git
county,Trøndelag,2021-03-11,819,1216,40478,23401,8.5917932433924,4.96705750503052,2035,63879,fhi:git
county,Trøndelag,2021-03-12,122,505,40600,23906,8.61768876134521,5.07424796868765,627,64506,fhi:git
county,Trøndelag,2021-03-13,1,1,40601,23907,8.61790101968908,5.07446022703153,2,64508,fhi:git
county,Trøndelag,2021-03-14,0,0,40601,23907,8.61790101968908,5.07446022703153,0,64508,fhi:git
county,Trøndelag,2021-03-15,3,6,40604,23913,8.61853779472071,5.07573377709478,9,64517,fhi:git
county,Trøndelag,2021-03-16,608,12,41212,23925,8.74759086779701,5.07828087722128,620,65137,fhi:git
county,Trøndelag,2021-03-17,1982,122,43194,24047,9.16828690535825,5.10417639517409,2104,67241,fhi:git
county,Trøndelag,2021-03-18,1504,123,44698,24170,9.487523454547,5.13028417147078,1627,68868,fhi:git
county,Trøndelag,2021-03-19,543,87,45241,24257,9.60277973527139,5.14875064738795,630,69498,fhi:git
county,Trøndelag,2021-03-20,0,0,45241,24257,9.60277973527139,5.14875064738795,0,69498,fhi:git
county,Trøndelag,2021-03-21,0,0,45241,24257,9.60277973527139,5.14875064738795,0,69498,fhi:git
county,Trøndelag,2021-03-22,1,0,45242,24257,9.60299199361527,5.14875064738795,1,69499,fhi:git
county,Trøndelag,2021-03-23,1045,216,46287,24473,9.82480196296516,5.19459844966506,1261,70760,fhi:git
county,Trøndelag,2021-03-24,3158,569,49445,25042,10.495113812924,5.31537344733022,3727,74487,fhi:git
county,Trøndelag,2021-03-25,2890,304,52335,25346,11.1085404267242,5.37989998386837,3194,77681,fhi:git
county,Trøndelag,2021-03-26,1988,228,54323,25574,11.5305100143487,5.42829488627198,2216,79897,fhi:git
county,Trøndelag,2021-03-27,0,3,54323,25577,11.5305100143487,5.42893166130361,3,79900,fhi:git
county,Trøndelag,2021-03-28,0,0,54323,25577,11.5305100143487,5.42893166130361,0,79900,fhi:git
county,Trøndelag,2021-03-29,3,0,54326,25577,11.5311467893803,5.42893166130361,3,79903,fhi:git
county,Trøndelag,2021-03-30,1874,535,56200,26112,11.928918925803,5.542489875277,2409,82312,fhi:git
county,Trøndelag,2021-03-31,2569,422,58769,26534,12.4742106112191,5.63206289639246,2991,85303,fhi:git
county,Trøndelag,2021-04-01,164,156,58933,26690,12.5090209796147,5.66517519803703,320,85623,fhi:git
county,Trøndelag,2021-04-02,159,95,59092,26785,12.5427700562909,5.68533974070521,254,85877,fhi:git
county,Trøndelag,2021-04-03,0,0,59092,26785,12.5427700562909,5.68533974070521,0,85877,fhi:git
county,Trøndelag,2021-04-04,0,0,59092,26785,12.5427700562909,5.68533974070521,0,85877,fhi:git
county,Trøndelag,2021-04-05,1,0,59093,26785,12.5429823146348,5.68533974070521,1,85878,fhi:git
county,Trøndelag,2021-04-06,2099,41,61192,26826,12.9885125784295,5.6940423328041,2140,88018,fhi:git
county,Trøndelag,2021-04-07,4461,229,65653,27055,13.9353970504581,5.74264949355159,4690,92708,fhi:git
county,Trøndelag,2021-04-08,4737,116,70390,27171,14.9408648253963,5.76727146144115,4853,97561,fhi:git
county,Trøndelag,2021-04-09,2680,33,73070,27204,15.5097171869826,5.77427598678904,2713,100274,fhi:git
county,Trøndelag,2021-04-10,0,0,73070,27204,15.5097171869826,5.77427598678904,0,100274,fhi:git
county,Trøndelag,2021-04-11,0,0,73070,27204,15.5097171869826,5.77427598678904,0,100274,fhi:git
county,Trøndelag,2021-04-12,278,4,73348,27208,15.56872500658,5.77512502016454,282,100556,fhi:git
county,Trøndelag,2021-04-13,2136,11,75484,27219,16.0221088290981,5.77745986194717,2147,102703,fhi:git
county,Trøndelag,2021-04-14,5349,217,80833,27436,17.1574787104881,5.82351992256816,5566,108269,fhi:git
county,Trøndelag,2021-04-15,5041,178,85874,27614,18.2274730219645,5.86130190777799,5219,113488,fhi:git
county,Trøndelag,2021-04-16,2760,28,88634,27642,18.8133060510609,5.86724514140651,2788,116276,fhi:git
county,Trøndelag,2021-04-17,2,0,88636,27642,18.8137305677486,5.86724514140651,2,116278,fhi:git
county,Trøndelag,2021-04-18,0,0,88636,27642,18.8137305677486,5.86724514140651,0,116278,fhi:git
county,Trøndelag,2021-04-19,1077,1,89713,27643,19.0423328041025,5.86745739975039,1078,117356,fhi:git
county,Trøndelag,2021-04-20,1638,34,91351,27677,19.3900119713706,5.87467418344215,1672,119028,fhi:git
county,Trøndelag,2021-04-21,4552,120,95903,27797,20.3562119526919,5.90014518470721,4672,123700,fhi:git
county,Trøndelag,2021-04-22,4044,230,99947,28027,21.2145846953244,5.94896460379858,4274,127974,fhi:git
county,Trøndelag,2021-04-23,2557,16,102504,28043,21.757329280614,5.95236073730058,2573,130547,fhi:git
county,Trøndelag,2021-04-24,0,0,102504,28043,21.757329280614,5.95236073730058,0,130547,fhi:git
county,Trøndelag,2021-04-25,0,0,102504,28043,21.757329280614,5.95236073730058,0,130547,fhi:git
county,Trøndelag,2021-04-26,1031,5,103535,28048,21.9761676331497,5.95342202901996,1036,131583,fhi:git
county,Trøndelag,2021-04-27,1524,597,105059,28645,22.2996493492159,6.08014026031363,2121,133704,fhi:git
county,Trøndelag,2021-04-28,3579,1989,108638,30634,23.0593219619463,6.502322106282,5568,139272,fhi:git
county,Trøndelag,2021-04-29,3653,1685,112291,32319,23.8347016921235,6.85997741571221,5338,144610,fhi:git
county,Trøndelag,2021-04-30,2585,557,114876,32876,24.3833895110417,6.97820531325086,3142,147752,fhi:git
county,Trøndelag,2021-05-01,2,1,114878,32877,24.3838140277294,6.97841757159474,3,147755,fhi:git
county,Trøndelag,2021-05-02,0,0,114878,32877,24.3838140277294,6.97841757159474,0,147755,fhi:git
county,Trøndelag,2021-05-03,975,5,115853,32882,24.590765913008,6.97947886331412,980,148735,fhi:git
county,Trøndelag,2021-05-04,806,1160,116659,34042,24.7618461381717,7.22569854220969,1966,150701,fhi:git
county,Trøndelag,2021-05-05,3017,2921,119676,36963,25.4022295616441,7.84570516467002,5938,156639,fhi:git
county,Trøndelag,2021-05-06,1599,2890,121275,39853,25.741630653501,8.45913177847021,4489,161128,fhi:git
county,Trøndelag,2021-05-07,1102,2078,122377,41931,25.9755393484518,8.9002046170435,3180,164308,fhi:git
county,Trøndelag,2021-05-08,0,0,122377,41931,25.9755393484518,8.9002046170435,0,164308,fhi:git
county,Trøndelag,2021-05-09,0,0,122377,41931,25.9755393484518,8.9002046170435,0,164308,fhi:git
county,Vestfold og Telemark,2020-12-27,0,0,0,0,0.0,0.0,0,0,fhi:git
county,Vestfold og Telemark,2020-12-28,0,0,0,0,0.0,0.0,0,0,fhi:git
county,Vestfold og Telemark,2020-12-29,0,0,0,0,0.0,0.0,0,0,fhi:git
county,Vestfold og Telemark,2020-12-30,0,0,0,0,0.0,0.0,0,0,fhi:git
county,Vestfold og Telemark,2020-12-31,0,0,0,0,0.0,0.0,0,0,fhi:git
county,Vestfold og Telemark,2021-01-01,0,0,0,0,0.0,0.0,0,0,fhi:git
county,Vestfold og Telemark,2021-01-02,0,0,0,0,0.0,0.0,0,0,fhi:git
county,Vestfold og Telemark,2021-01-03,0,0,0,0,0.0,0.0,0,0,fhi:git
county,Vestfold og Telemark,2021-01-04,1,0,1,0,0.0002370331040433,0.0,1,1,fhi:git
county,Vestfold og Telemark,2021-01-05,218,0,219,0,0.051910249785485,0.0,218,219,fhi:git
county,Vestfold og Telemark,2021-01-06,1025,0,1244,0,0.294869181429879,0.0,1025,1244,fhi:git
county,Vestfold og Telemark,2021-01-07,444,0,1688,0,0.400111879625108,0.0,444,1688,fhi:git
county,Vestfold og Telemark,2021-01-08,63,0,1751,0,0.415044965179837,0.0,63,1751,fhi:git
county,Vestfold og Telemark,2021-01-09,0,0,1751,0,0.415044965179837,0.0,0,1751,fhi:git
county,Vestfold og Telemark,2021-01-10,3,0,1754,0,0.415756064491967,0.0,3,1754,fhi:git
county,Vestfold og Telemark,2021-01-11,3,0,1757,0,0.416467163804097,0.0,3,1757,fhi:git
county,Vestfold og Telemark,2021-01-12,420,0,2177,0,0.516021067502287,0.0,420,2177,fhi:git
county,Vestfold og Telemark,2021-01-13,1166,0,3343,0,0.792401666816788,0.0,1166,3343,fhi:git
county,Vestfold og Telemark,2021-01-14,583,0,3926,0,0.930591966474038,0.0,583,3926,fhi:git
county,Vestfold og Telemark,2021-01-15,158,0,4084,0,0.968043196912881,0.0,158,4084,fhi:git
county,Vestfold og Telemark,2021-01-16,4,0,4088,0,0.968991329329054,0.0,4,4088,fhi:git
county,Vestfold og Telemark,2021-01-17,42,0,4130,0,0.978946719698873,0.0,42,4130,fhi:git
county,Vestfold og Telemark,2021-01-18,7,0,4137,0,0.980605951427176,0.0,7,4137,fhi:git
county,Vestfold og Telemark,2021-01-19,232,0,4369,0,1.03559763156522,0.0,232,4369,fhi:git
county,Vestfold og Telemark,2021-01-20,1604,0,5973,0,1.41579873045069,0.0,1604,5973,fhi:git
county,Vestfold og Telemark,2021-01-21,833,0,6806,0,1.61324730611877,0.0,833,6806,fhi:git
county,Vestfold og Telemark,2021-01-22,181,0,6987,0,1.65615029795061,0.0,181,6987,fhi:git
county,Vestfold og Telemark,2021-01-23,3,0,6990,0,1.65686139726274,0.0,3,6990,fhi:git
county,Vestfold og Telemark,2021-01-24,0,0,6990,0,1.65686139726274,0.0,0,6990,fhi:git
county,Vestfold og Telemark,2021-01-25,44,0,7034,0,1.66729085384065,0.0,44,7034,fhi:git
county,Vestfold og Telemark,2021-01-26,103,179,7137,179,1.69170526355711,0.0424289256237526,282,7316,fhi:git
county,Vestfold og Telemark,2021-01-27,1625,898,8762,1077,2.07688405762749,0.255284653054646,2523,9839,fhi:git
county,Vestfold og Telemark,2021-01-28,657,451,9419,1528,2.23261480698394,0.362186582978179,1108,10947,fhi:git
county,Vestfold og Telemark,2021-01-29,86,91,9505,1619,2.25299965393167,0.38375659544612,177,11124,fhi:git
county,Vestfold og Telemark,2021-01-30,0,0,9505,1619,2.25299965393167,0.38375659544612,0,11124,fhi:git
county,Vestfold og Telemark,2021-01-31,2,2,9507,1621,2.25347372013975,0.384230661654207,4,11128,fhi:git
county,Vestfold og Telemark,2021-02-01,50,1,9557,1622,2.26532537534192,0.38446769475825,51,11179,fhi:git
county,Vestfold og Telemark,2021-02-02,465,327,10022,1949,2.37554576872206,0.461977519780413,792,11971,fhi:git
county,Vestfold og Telemark,2021-02-03,3219,893,13241,2842,3.13855533063748,0.673648081691089,4112,16083,fhi:git
county,Vestfold og Telemark,2021-02-04,1902,710,15143,3552,3.58939229452785,0.84194158556184,2612,18695,fhi:git
county,Vestfold og Telemark,2021-02-05,966,246,16109,3798,3.81836627303369,0.900251729156494,1212,19907,fhi:git
county,Vestfold og Telemark,2021-02-06,1,3,16110,3801,3.81860330613773,0.900962828468624,4,19911,fhi:git
county,Vestfold og Telemark,2021-02-07,2,1,16112,3802,3.81907737234582,0.901199861572667,3,19914,fhi:git
county,Vestfold og Telemark,2021-02-08,17,46,16129,3848,3.82310693511456,0.912103384358659,63,19977,fhi:git
county,Vestfold og Telemark,2021-02-09,356,208,16485,4056,3.90749072015398,0.961406269999668,564,20541,fhi:git
county,Vestfold og Telemark,2021-02-10,2891,1395,19376,5451,4.59275342394319,1.29206745014009,4286,24827,fhi:git
county,Vestfold og Telemark,2021-02-11,1545,882,20921,6333,4.9589695696901,1.50113064790629,2427,27254,fhi:git
county,Vestfold og Telemark,2021-02-12,602,213,21523,6546,5.10166349832418,1.55161869906751,815,28069,fhi:git
county,Vestfold og Telemark,2021-02-13,2,2,21525,6548,5.10213756453226,1.5520927652756,4,28073,fhi:git
county,Vestfold og Telemark,2021-02-14,0,0,21525,6548,5.10213756453226,1.5520927652756,0,28073,fhi:git
county,Vestfold og Telemark,2021-02-15,4,2,21529,6550,5.10308569694844,1.55256683148369,6,28079,fhi:git
county,Vestfold og Telemark,2021-02-16,579,75,22108,6625,5.24032786418951,1.57034431428693,654,28733,fhi:git
county,Vestfold og Telemark,2021-02-17,3045,1534,25153,8159,5.96209366600139,1.93395309588937,4579,33312,fhi:git
county,Vestfold og Telemark,2021-02-18,1826,638,26979,8797,6.39491611398448,2.085180216269,2464,35776,fhi:git
county,Vestfold og Telemark,2021-02-19,285,84,27264,8881,6.46247054863682,2.10509099700864,369,36145,fhi:git
county,Vestfold og Telemark,2021-02-20,0,1,27264,8882,6.46247054863682,2.10532803011269,1,36146,fhi:git
county,Vestfold og Telemark,2021-02-21,1,1,27265,8883,6.46270758174087,2.10556506321673,2,36148,fhi:git
county,Vestfold og Telemark,2021-02-22,51,0,27316,8883,6.47479627004707,2.10556506321673,51,36199,fhi:git
county,Vestfold og Telemark,2021-02-23,626,386,27942,9269,6.62317899317819,2.19705984137745,1012,37211,fhi:git
county,Vestfold og Telemark,2021-02-24,669,2871,28611,12140,6.78175413978316,2.87758188308579,3540,40751,fhi:git
county,Vestfold og Telemark,2021-02-25,707,2009,29318,14149,6.94933654434178,3.3537813891088,2716,43467,fhi:git
county,Vestfold og Telemark,2021-02-26,542,852,29860,15001,7.07780848673326,3.5557335937537,1394,44861,fhi:git
county,Vestfold og Telemark,2021-02-27,3,2,29863,15003,7.07851958604539,3.55620765996179,5,44866,fhi:git
county,Vestfold og Telemark,2021-02-28,1,0,29864,15003,7.07875661914943,3.55620765996179,1,44867,fhi:git
county,Vestfold og Telemark,2021-03-01,617,0,30481,15003,7.22500604434415,3.55620765996179,617,45484,fhi:git
county,Vestfold og Telemark,2021-03-02,846,354,31327,15357,7.42553605036479,3.64011737879312,1200,46684,fhi:git
county,Vestfold og Telemark,2021-03-03,2003,2815,33330,18172,7.90031335776355,4.30736556667504,4818,51502,fhi:git
county,Vestfold og Telemark,2021-03-04,1010,1437,34340,19609,8.13971679284729,4.64798213718528,2447,53949,fhi:git
county,Vestfold og Telemark,2021-03-05,1474,592,35814,20201,8.48910358820713,4.78830573477892,2066,56015,fhi:git
county,Vestfold og Telemark,2021-03-06,3,1,35817,20202,8.48981468751926,4.78854276788296,4,56019,fhi:git
county,Vestfold og Telemark,2021-03-07,1,0,35818,20202,8.4900517206233,4.78854276788296,1,56020,fhi:git
county,Vestfold og Telemark,2021-03-08,236,0,36054,20202,8.54599153317752,4.78854276788296,236,56256,fhi:git
county,Vestfold og Telemark,2021-03-09,950,142,37004,20344,8.77117298201867,4.82220146865711,1092,57348,fhi:git
county,Vestfold og Telemark,2021-03-10,1605,2263,38609,22607,9.15161111400818,5.35860738310713,3868,61216,fhi:git
county,Vestfold og Telemark,2021-03-11,304,841,38913,23448,9.22366917763735,5.55795222360755,1145,62361,fhi:git
county,Vestfold og Telemark,2021-03-12,36,126,38949,23574,9.23220236938291,5.58781839471701,162,62523,fhi:git
county,Vestfold og Telemark,2021-03-13,1,2,38950,23576,9.23243940248695,5.58829246092509,3,62526,fhi:git
county,Vestfold og Telemark,2021-03-14,0,0,38950,23576,9.23243940248695,5.58829246092509,0,62526,fhi:git
county,Vestfold og Telemark,2021-03-15,2,3,38952,23579,9.23291346869504,5.58900356023722,5,62531,fhi:git
county,Vestfold og Telemark,2021-03-16,403,26,39355,23605,9.32843780962449,5.59516642094235,429,62960,fhi:git
county,Vestfold og Telemark,2021-03-17,3118,169,42473,23774,10.0675070280315,5.63522501552567,3287,66247,fhi:git
county,Vestfold og Telemark,2021-03-18,912,53,43385,23827,10.283681218919,5.64778777003996,965,67212,fhi:git
county,Vestfold og Telemark,2021-03-19,28,32,43413,23859,10.2903181458322,5.65537282936935,60,67272,fhi:git
county,Vestfold og Telemark,2021-03-20,1,0,43414,23859,10.2905551789363,5.65537282936935,1,67273,fhi:git
county,Vestfold og Telemark,2021-03-21,0,1,43414,23860,10.2905551789363,5.65560986247339,1,67274,fhi:git
county,Vestfold og Telemark,2021-03-22,0,1,43414,23861,10.2905551789363,5.65584689557744,1,67275,fhi:git
county,Vestfold og Telemark,2021-03-23,663,58,44077,23919,10.447708126917,5.66959481561195,721,67996,fhi:git
county,Vestfold og Telemark,2021-03-24,4622,816,48699,24735,11.5432751338052,5.86301382851129,5438,73434,fhi:git
county,Vestfold og Telemark,2021-03-25,2951,275,51650,25010,12.242759823837,5.9281979321232,3226,76660,fhi:git
county,Vestfold og Telemark,2021-03-26,900,152,52550,25162,12.456089617476,5.96422696393778,1052,77712,fhi:git
county,Vestfold og Telemark,2021-03-27,0,0,52550,25162,12.456089617476,5.96422696393778,0,77712,fhi:git
county,Vestfold og Telemark,2021-03-28,0,0,52550,25162,12.456089617476,5.96422696393778,0,77712,fhi:git
county,Vestfold og Telemark,2021-03-29,184,3,52734,25165,12.4997037086199,5.96493806324991,187,77899,fhi:git
county,Vestfold og Telemark,2021-03-30,3018,81,55752,25246,13.2150696166227,5.98413774467742,3099,80998,fhi:git
county,Vestfold og Telemark,2021-03-31,3407,494,59159,25740,14.0226414020982,6.10123209807482,3901,84899,fhi:git
county,Vestfold og Telemark,2021-04-01,426,17,59585,25757,14.1236175044207,6.10526166084355,443,85342,fhi:git
county,Vestfold og Telemark,2021-04-02,3,3,59588,25760,14.1243286037328,6.10597276015568,6,85348,fhi:git
county,Vestfold og Telemark,2021-04-03,2,0,59590,25760,14.1248026699409,6.10597276015568,2,85350,fhi:git
county,Vestfold og Telemark,2021-04-04,0,0,59590,25760,14.1248026699409,6.10597276015568,0,85350,fhi:git
county,Vestfold og Telemark,2021-04-05,1,1,59591,25761,14.1250397030449,6.10620979325973,2,85352,fhi:git
county,Vestfold og Telemark,2021-04-06,968,40,60559,25801,14.3544877477589,6.11569111742146,1008,86360,fhi:git
county,Vestfold og Telemark,2021-04-07,6308,152,66867,25953,15.8496925680641,6.15172014923604,6460,92820,fhi:git
county,Vestfold og Telemark,2021-04-08,3684,60,70551,26013,16.7229225233596,6.16594213547864,3744,96564,fhi:git
county,Vestfold og Telemark,2021-04-09,1266,14,71817,26027,17.0230064330784,6.16926059893525,1280,97844,fhi:git
county,Vestfold og Telemark,2021-04-10,2,0,71819,26027,17.0234804992865,6.16926059893525,2,97846,fhi:git
county,Vestfold og Telemark,2021-04-11,1,0,71820,26027,17.0237175323906,6.16926059893525,1,97847,fhi:git
county,Vestfold og Telemark,2021-04-12,9,0,71829,26027,17.025850830327,6.16926059893525,9,97856,fhi:git
county,Vestfold og Telemark,2021-04-13,1284,14,73113,26041,17.3302013359186,6.17257906239185,1298,99154,fhi:git
county,Vestfold og Telemark,2021-04-14,6850,80,79963,26121,18.9538780986153,6.19154171071532,6930,106084,fhi:git
county,Vestfold og Telemark,2021-04-15,4555,90,84518,26211,20.0335638875325,6.21287469007922,4645,110729,fhi:git
county,Vestfold og Telemark,2021-04-16,1738,14,86256,26225,20.4455274223598,6.21619315353582,1752,112481,fhi:git
county,Vestfold og Telemark,2021-04-17,5,0,86261,26225,20.44671258788,6.21619315353582,5,112486,fhi:git
county,Vestfold og Telemark,2021-04-18,0,0,86261,26225,20.44671258788,6.21619315353582,0,112486,fhi:git
county,Vestfold og Telemark,2021-04-19,27,1,86288,26226,20.4531124816892,6.21643018663987,28,112514,fhi:git
county,Vestfold og Telemark,2021-04-20,707,20,86995,26246,20.6206948862478,6.22117084872073,727,113241,fhi:git
county,Vestfold og Telemark,2021-04-21,6487,784,93482,27030,22.1583286321768,6.40700480229069,7271,120512,fhi:git
county,Vestfold og Telemark,2021-04-22,3892,510,97374,27540,23.0808614731133,6.52789168535278,4402,124914,fhi:git
county,Vestfold og Telemark,2021-04-23,910,308,98284,27848,23.2965615977928,6.60089788139812,1218,126132,fhi:git
county,Vestfold og Telemark,2021-04-24,2,0,98286,27848,23.2970356640008,6.60089788139812,2,126134,fhi:git
county,Vestfold og Telemark,2021-04-25,0,0,98286,27848,23.2970356640008,6.60089788139812,0,126134,fhi:git
county,Vestfold og Telemark,2021-04-26,8,2,98294,27850,23.2989319288332,6.6013719476062,10,126144,fhi:git
county,Vestfold og Telemark,2021-04-27,1066,346,99360,28196,23.5516092177434,6.68338540160519,1412,127556,fhi:git
county,Vestfold og Telemark,2021-04-28,5291,3096,104651,31292,24.8057513712365,7.41723989172328,8387,135943,fhi:git
county,Vestfold og Telemark,2021-04-29,4879,995,109530,32287,25.9622358858638,7.65308783024637,5874,141817,fhi:git
county,Vestfold og Telemark,2021-04-30,1165,43,110695,32330,26.2383794520743,7.66328025372024,1208,143025,fhi:git
county,Vestfold og Telemark,2021-05-01,44,0,110739,32330,26.2488089086522,7.66328025372024,44,143069,fhi:git
county,Vestfold og Telemark,2021-05-02,2,0,110741,32330,26.2492829748603,7.66328025372024,2,143071,fhi:git
county,Vestfold og Telemark,2021-05-03,34,6,110775,32336,26.2573421003977,7.66470245234449,40,143111,fhi:git
county,Vestfold og Telemark,2021-05-04,417,442,111192,32778,26.3561849047838,7.76947108433164,859,143970,fhi:git
county,Vestfold og Telemark,2021-05-05,3375,4758,114567,37536,27.15617163093,8.89727459336971,8133,152103,fhi:git
county,Vestfold og Telemark,2021-05-06,3451,1776,118018,39312,27.9741728729834,9.31824538615063,5227,157330,fhi:git
county,Vestfold og Telemark,2021-05-07,313,326,118331,39638,28.048364234549,9.39551817806875,639,157969,fhi:git
county,Vestfold og Telemark,2021-05-08,3,0,118334,39638,28.0490753338611,9.39551817806875,3,157972,fhi:git
county,Vestfold og Telemark,2021-05-09,2,0,118336,39638,28.0495494000692,9.39551817806875,2,157974,fhi:git
county,Vestland,2020-12-27,0,0,0,0,0.0,0.0,0,0,fhi:git
county,Vestland,2020-12-28,0,0,0,0,0.0,0.0,0,0,fhi:git
county,Vestland,2020-12-29,0,0,0,0,0.0,0.0,0,0,fhi:git
county,Vestland,2020-12-30,0,0,0,0,0.0,0.0,0,0,fhi:git
county,Vestland,2020-12-31,0,0,0,0,0.0,0.0,0,0,fhi:git
county,Vestland,2021-01-01,0,0,0,0,0.0,0.0,0,0,fhi:git
county,Vestland,2021-01-02,0,0,0,0,0.0,0.0,0,0,fhi:git
county,Vestland,2021-01-03,1,0,1,0,0.0001571015394379,0.0,1,1,fhi:git
county,Vestland,2021-01-04,2,0,3,0,0.0004696151191022,0.0,2,3,fhi:git
county,Vestland,2021-01-05,416,0,419,0,0.0655895783012769,0.0,416,419,fhi:git
county,Vestland,2021-01-06,1258,0,1677,0,0.262514851578142,0.0,1258,1677,fhi:git
county,Vestland,2021-01-07,715,0,2392,0,0.374439788297504,0.0,715,2392,fhi:git
county,Vestland,2021-01-08,139,0,2531,0,0.396198622149241,0.0,139,2531,fhi:git
county,Vestland,2021-01-09,0,0,2531,0,0.396198622149241,0.0,0,2531,fhi:git
county,Vestland,2021-01-10,0,0,2531,0,0.396198622149241,0.0,0,2531,fhi:git
county,Vestland,2021-01-11,66,0,2597,0,0.406530154769489,0.0,66,2597,fhi:git
county,Vestland,2021-01-12,856,0,3453,0,0.540527002086657,0.0,856,3453,fhi:git
county,Vestland,2021-01-13,1127,0,4580,0,0.716945748496058,0.0,1127,4580,fhi:git
county,Vestland,2021-01-14,999,0,5579,0,0.873327583157097,0.0,999,5579,fhi:git
county,Vestland,2021-01-15,426,0,6005,0,0.940012930069613,0.0,426,6005,fhi:git
county,Vestland,2021-01-16,2,0,6007,0,0.940326006815681,0.0,2,6007,fhi:git
county,Vestland,2021-01-17,1,0,6008,0,0.940482545188715,0.0,1,6008,fhi:git
county,Vestland,2021-01-18,62,0,6070,0,0.950187924316827,0.0,62,6070,fhi:git
county,Vestland,2021-01-19,369,0,6439,0,1.0079505839664,0.0,369,6439,fhi:git
county,Vestland,2021-01-20,1237,0,7676,0,1.20158855140955,0.0,1237,7676,fhi:git
county,Vestland,2021-01-21,783,0,8459,0,1.32415809749523,0.0,783,8459,fhi:git
county,Vestland,2021-01-22,315,0,8774,0,1.37346768500096,0.0,315,8774,fhi:git
county,Vestland,2021-01-23,0,0,8774,0,1.37346768500096,0.0,0,8774,fhi:git
county,Vestland,2021-01-24,0,0,8774,0,1.37346768500096,0.0,0,8774,fhi:git
county,Vestland,2021-01-25,2,0,8776,0,1.37378076174703,0.0,2,8776,fhi:git
county,Vestland,2021-01-26,152,174,8928,174,1.39757459444821,0.0272376769079288,326,9102,fhi:git
county,Vestland,2021-01-27,1595,1212,10523,1386,1.64725329943756,0.216962185025226,2807,11909,fhi:git
county,Vestland,2021-01-28,1958,695,12481,2081,1.95375543383827,0.325756354283907,2653,14562,fhi:git
county,Vestland,2021-01-29,481,176,12962,2257,2.02905039126766,0.353307107937904,657,15219,fhi:git
county,Vestland,2021-01-30,3,0,12965,2257,2.02952000638677,0.353307107937904,3,15222,fhi:git
county,Vestland,2021-01-31,1,0,12966,2257,2.0296765447598,0.353307107937904,1,15223,fhi:git
county,Vestland,2021-02-01,13,59,12979,2316,2.03171154360924,0.362542871946915,72,15295,fhi:git
county,Vestland,2021-02-02,720,583,13699,2899,2.14441917219378,0.45380474342578,1303,16598,fhi:git
county,Vestland,2021-02-03,2833,1049,16532,3948,2.58789238299931,0.618013496738523,3882,20480,fhi:git
county,Vestland,2021-02-04,2591,1127,19123,5075,2.99348330753059,0.794432243147924,3718,24198,fhi:git
county,Vestland,2021-02-05,913,488,20036,5563,3.1364028421107,0.870822969188552,1401,25599,fhi:git
county,Vestland,2021-02-06,0,3,20036,5566,3.1364028421107,0.871292584307654,3,25602,fhi:git
county,Vestland,2021-02-07,2,1,20038,5567,3.13671591885677,0.871449122680689,3,25605,fhi:git
county,Vestland,2021-02-08,8,49,20046,5616,3.13796822584104,0.879119502959358,57,25662,fhi:git
county,Vestland,2021-02-09,894,307,20940,5923,3.2779135313335,0.927176783480819,1201,26863,fhi:git
county,Vestland,2021-02-10,2761,973,23701,6896,3.71011597928058,1.07948862044297,3734,30597,fhi:git
county,Vestland,2021-02-11,2705,838,26406,7734,4.13355227833775,1.21066777704553,3543,34140,fhi:git
county,Vestland,2021-02-12,631,462,27037,8196,4.23232799172225,1.28298850538727,1093,35233,fhi:git
county,Vestland,2021-02-13,0,0,27037,8196,4.23232799172225,1.28298850538727,0,35233,fhi:git
county,Vestland,2021-02-14,0,2,27037,8198,4.23232799172225,1.28330158213334,2,35235,fhi:git
county,Vestland,2021-02-15,95,1,27132,8199,4.24719913716049,1.28345812050637,96,35331,fhi:git
county,Vestland,2021-02-16,1088,55,28220,8254,4.41751288702156,1.29206773102324,1143,36474,fhi:git
county,Vestland,2021-02-17,2708,1332,30928,9586,4.84141880119783,1.50057684390463,4040,40514,fhi:git
county,Vestland,2021-02-18,2009,2002,32937,11588,5.15590439262329,1.81396666671885,4011,44525,fhi:git
county,Vestland,2021-02-19,1157,541,34094,12129,5.33701929022371,1.89865392653028,1698,46223,fhi:git
county,Vestland,2021-02-20,4,5,34098,12134,5.33764544371585,1.89943661839545,9,46232,fhi:git
county,Vestland,2021-02-21,0,1,34098,12135,5.33764544371585,1.89959315676848,1,46233,fhi:git
county,Vestland,2021-02-22,49,2,34147,12137,5.34531582399452,1.89990623351455,51,46284,fhi:git
county,Vestland,2021-02-23,543,591,34690,12728,5.43031616055202,1.99242041197769,1134,47418,fhi:git
county,Vestland,2021-02-24,1415,2403,36105,15131,5.65181795839523,2.36858212237857,3818,51236,fhi:git
county,Vestland,2021-02-25,1256,2650,37361,17781,5.84843015492603,2.78340881091886,3906,55142,fhi:git
county,Vestland,2021-02-26,1428,877,38789,18658,6.07196695161869,2.92069296406975,2305,57447,fhi:git
county,Vestland,2021-02-27,5,0,38794,18658,6.07274964348386,2.92069296406975,5,57452,fhi:git
county,Vestland,2021-02-28,1,8,38795,18666,6.07290618185689,2.92194527105402,9,57461,fhi:git
county,Vestland,2021-03-01,442,11,39237,18677,6.14209614273795,2.92366719315739,453,57914,fhi:git
county,Vestland,2021-03-02,1349,760,40586,19437,6.35326640796092,3.04263635666329,2109,60023,fhi:git
county,Vestland,2021-03-03,1744,2051,42330,21488,6.62626933053234,3.36369655975618,3795,63818,fhi:git
county,Vestland,2021-03-04,1805,2851,44135,24339,6.90882109385884,3.80998746127632,4656,68474,fhi:git
county,Vestland,2021-03-05,1249,905,45384,25244,7.1043375217784,3.95165468887216,2154,70628,fhi:git
county,Vestland,2021-03-06,1,6,45385,25250,7.10449406015144,3.95259391911036,7,70635,fhi:git
county,Vestland,2021-03-07,5,0,45390,25250,7.10527675201661,3.95259391911036,5,70640,fhi:git
county,Vestland,2021-03-08,635,15,46025,25265,7.20467861889324,3.95494199470587,650,71290,fhi:git
county,Vestland,2021-03-09,1504,528,47529,25793,7.44011233193649,4.03759425566786,2032,73322,fhi:git
county,Vestland,2021-03-10,2508,1853,50037,27646,7.83271057150595,4.3276598609,4361,77683,fhi:git
county,Vestland,2021-03-11,1406,1551,51443,29197,8.05280352399185,4.57045087747585,2957,80640,fhi:git
county,Vestland,2021-03-12,180,977,51623,30174,8.08098043113799,4.72338886793014,1157,81797,fhi:git
county,Vestland,2021-03-13,8,11,51631,30185,8.08223273812226,4.72511079003352,19,81816,fhi:git
county,Vestland,2021-03-14,0,0,51631,30185,8.08223273812226,4.72511079003352,0,81816,fhi:git
county,Vestland,2021-03-15,7,8,51638,30193,8.0833285067335,4.72636309701779,15,81831,fhi:git
county,Vestland,2021-03-16,1202,36,52840,30229,8.27148763112045,4.73199847844701,1238,83069,fhi:git
county,Vestland,2021-03-17,2440,223,55280,30452,8.6534412613236,4.76690653563361,2663,85732,fhi:git
county,Vestland,2021-03-18,2325,145,57605,30597,9.01739297862782,4.78960459972355,2470,88202,fhi:git
county,Vestland,2021-03-19,587,116,58192,30713,9.10928100359882,4.80776305099551,703,88905,fhi:git
county,Vestland,2021-03-20,1,2,58193,30715,9.10943754197185,4.80807612774157,3,88908,fhi:git
county,Vestland,2021-03-21,0,0,58193,30715,9.10943754197185,4.80807612774157,0,88908,fhi:git
county,Vestland,2021-03-22,9,13,58202,30728,9.11084638732916,4.81011112659102,22,88930,fhi:git
county,Vestland,2021-03-23,2056,342,60258,31070,9.43268928228721,4.86364725016867,2398,91328,fhi:git
county,Vestland,2021-03-24,4033,514,64291,31584,10.0640085407336,4.94410797390818,4547,95875,fhi:git
county,Vestland,2021-03-25,3168,375,67459,31959,10.5599221065056,5.00280986379596,3543,99418,fhi:git
county,Vestland,2021-03-26,998,190,68457,32149,10.7161474027936,5.03255215467244,1188,100606,fhi:git
county,Vestland,2021-03-27,2,0,68459,32149,10.7164604795397,5.03255215467244,2,100608,fhi:git
county,Vestland,2021-03-28,0,2,68459,32151,10.7164604795397,5.0328652314185,2,100610,fhi:git
county,Vestland,2021-03-29,115,2,68574,32153,10.7344623924386,5.03317830816457,117,100727,fhi:git
county,Vestland,2021-03-30,3583,573,72157,32726,11.2953393830197,5.1228747959131,4156,104883,fhi:git
county,Vestland,2021-03-31,3687,1160,75844,33886,11.8724963643963,5.30445930863262,4847,109730,fhi:git
county,Vestland,2021-04-01,951,232,76795,34118,12.0213643571517,5.34077621117653,1183,110913,fhi:git
county,Vestland,2021-04-02,53,90,76848,34208,12.0296608909225,5.35486466474959,143,111056,fhi:git
county,Vestland,2021-04-03,1,0,76849,34208,12.0298174292955,5.35486466474959,1,111057,fhi:git
county,Vestland,2021-04-04,0,2,76849,34210,12.0298174292955,5.35517774149566,2,111059,fhi:git
county,Vestland,2021-04-05,1,1,76850,34211,12.0299739676686,5.3553342798687,2,111061,fhi:git
county,Vestland,2021-04-06,3100,101,79950,34312,12.5152429240742,5.37114465554514,3201,114262,fhi:git
county,Vestland,2021-04-07,8113,157,88063,34469,13.7852387444996,5.39572118011149,8270,122532,fhi:git
county,Vestland,2021-04-08,6398,305,94461,34774,14.7867712551716,5.44346538388688,6703,129235,fhi:git
county,Vestland,2021-04-09,2028,103,96489,34877,15.1042310756847,5.45958883630939,2131,131366,fhi:git
county,Vestland,2021-04-10,42,2,96531,34879,15.1108056873522,5.45990191305546,44,131410,fhi:git
county,Vestland,2021-04-11,5,0,96536,34879,15.1115883792173,5.45990191305546,5,131415,fhi:git
county,Vestland,2021-04-12,58,10,96594,34889,15.1206676048533,5.4614672967858,68,131483,fhi:git
county,Vestland,2021-04-13,4818,66,101412,34955,15.8748694861315,5.47179882940605,4884,136367,fhi:git
county,Vestland,2021-04-14,9119,101,110531,35056,17.3023429098292,5.48760920508249,9220,145587,fhi:git
county,Vestland,2021-04-15,6846,188,117377,35244,18.3740046116205,5.51703841921289,7034,152621,fhi:git
county,Vestland,2021-04-16,1361,141,118738,35385,18.5870533373198,5.5391103298107,1502,154123,fhi:git
county,Vestland,2021-04-17,51,2,118789,35387,18.5950367943446,5.53942340655677,53,154176,fhi:git
county,Vestland,2021-04-18,1,0,118790,35387,18.5951933327176,5.53942340655677,1,154177,fhi:git
county,Vestland,2021-04-19,40,10,118830,35397,18.601454867639,5.54098879028711,50,154227,fhi:git
county,Vestland,2021-04-20,5192,68,124022,35465,19.4142021004319,5.55163339965342,5260,159487,fhi:git
county,Vestland,2021-04-21,7850,78,131872,35543,20.6430283287494,5.56384339275008,7928,167415,fhi:git
county,Vestland,2021-04-22,5172,131,137044,35674,21.4526447940816,5.58434991961755,5303,172718,fhi:git
county,Vestland,2021-04-23,1206,35,138250,35709,21.6414300719607,5.58982876267374,1241,173959,fhi:git
county,Vestland,2021-04-24,1,0,138251,35709,21.6415866103337,5.58982876267374,1,173960,fhi:git
county,Vestland,2021-04-25,7,0,138258,35709,21.642682378945,5.58982876267374,7,173967,fhi:git
county,Vestland,2021-04-26,26,2,138284,35711,21.6467523766439,5.59014183941981,28,173995,fhi:git
county,Vestland,2021-04-27,2975,1138,141259,36849,22.1124540364202,5.76828250793258,4113,178108,fhi:git
county,Vestland,2021-04-28,6765,2900,148024,39749,23.1714361299957,6.2222437897314,9665,187773,fhi:git
county,Vestland,2021-04-29,6412,2260,154436,42009,24.1751601778902,6.5760205127884,8672,196445,fhi:git
county,Vestland,2021-04-30,2135,459,156571,42468,24.509369604318,6.64787162601104,2594,199039,fhi:git
county,Vestland,2021-05-01,52,5,156623,42473,24.5175095997157,6.64865431787621,57,199096,fhi:git
county,Vestland,2021-05-02,2,0,156625,42473,24.5178226764618,6.64865431787621,2,199098,fhi:git
county,Vestland,2021-05-03,44,5,156669,42478,24.5247103648753,6.64943700974138,49,199147,fhi:git
county,Vestland,2021-05-04,1861,2185,158530,44663,24.8160282770917,6.99147335482084,4046,203193,fhi:git
county,Vestland,2021-05-05,5396,4522,163926,49185,25.6607093379836,7.69933987768092,9918,213111,fhi:git
county,Vestland,2021-05-06,3616,2621,167542,51806,26.2267520948748,8.10962695340322,6237,219348,fhi:git
county,Vestland,2021-05-07,1236,443,168778,52249,26.4202335239449,8.17897345265732,1679,221027,fhi:git
county,Vestland,2021-05-08,6,0,168784,52249,26.4211727541831,8.17897345265732,6,221033,fhi:git
county,Vestland,2021-05-09,0,0,168784,52249,26.4211727541831,8.17897345265732,0,221033,fhi:git
county,Viken,2020-12-27,0,0,0,0,0.0,0.0,0,0,fhi:git
county,Viken,2020-12-28,65,0,65,0,0.0052370152236004,0.0,65,65,fhi:git
county,Viken,2020-12-29,689,0,754,0,0.0607493765937647,0.0,689,754,fhi:git
county,Viken,2020-12-30,219,0,973,0,0.0783940894240492,0.0,219,973,fhi:git
county,Viken,2020-12-31,67,0,1040,0,0.0837922435776065,0.0,67,1040,fhi:git
county,Viken,2021-01-01,0,0,1040,0,0.0837922435776065,0.0,0,1040,fhi:git
county,Viken,2021-01-02,0,0,1040,0,0.0837922435776065,0.0,0,1040,fhi:git
county,Viken,2021-01-03,0,0,1040,0,0.0837922435776065,0.0,0,1040,fhi:git
county,Viken,2021-01-04,0,0,1040,0,0.0830416230165828,0.0,0,1040,fhi:git
county,Viken,2021-01-05,526,0,1566,0,0.125041520811508,0.0,526,1566,fhi:git
county,Viken,2021-01-06,1650,0,3216,0,0.256790249635894,0.0,1650,3216,fhi:git
county,Viken,2021-01-07,1924,0,5140,0,0.410417252216573,0.0,1924,5140,fhi:git
county,Viken,2021-01-08,282,0,5422,0,0.432934307688377,0.0,282,5422,fhi:git
county,Viken,2021-01-09,6,0,5428,0,0.433413393975011,0.0,6,5428,fhi:git
county,Viken,2021-01-10,5,0,5433,0,0.433812632547206,0.0,5,5433,fhi:git
county,Viken,2021-01-11,61,0,5494,0,0.438683343127986,0.0,61,5494,fhi:git
county,Viken,2021-01-12,789,0,6283,0,0.501683189820375,0.0,789,6283,fhi:git
county,Viken,2021-01-13,1947,0,8230,0,0.65714668983315,0.0,1947,8230,fhi:git
county,Viken,2021-01-14,1948,0,10178,0,0.812690037560365,0.0,1948,10178,fhi:git
county,Viken,2021-01-15,1052,0,11230,0,0.896689833150216,0.0,1052,11230,fhi:git
county,Viken,2021-01-16,93,0,11323,0,0.904115670593045,0.0,93,11323,fhi:git
county,Viken,2021-01-17,25,0,11348,0,0.906111863454021,0.0,25,11348,fhi:git
county,Viken,2021-01-18,146,51,11494,51,0.917769629762118,0.0040722334363901,197,11545,fhi:git
county,Viken,2021-01-19,653,384,12147,435,0.969910187290799,0.0347337557809745,1037,12582,fhi:git
county,Viken,2021-01-20,1491,342,13638,777,1.08896312951938,0.06204167411912,1833,14415,fhi:git
county,Viken,2021-01-21,1998,100,15636,877,1.24849886296855,0.0700264455630222,2098,16513,fhi:git
county,Viken,2021-01-22,824,1,16460,878,1.3142933796663,0.0701062932774612,825,17338,fhi:git
county,Viken,2021-01-23,99,0,16559,878,1.32219830339576,0.0701062932774612,99,17437,fhi:git
county,Viken,2021-01-24,0,0,16559,878,1.32219830339576,0.0701062932774612,0,17437,fhi:git
county,Viken,2021-01-25,62,0,16621,878,1.32714886169098,0.0701062932774612,62,17499,fhi:git
county,Viken,2021-01-26,564,402,17185,1280,1.37218297263459,0.102205074481948,966,18465,fhi:git
county,Viken,2021-01-27,1963,1219,19148,2499,1.52892403607839,0.199539438383116,3182,21647,fhi:git
county,Viken,2021-01-28,3107,1712,22255,4211,1.77701088484043,0.336238725502721,4819,26466,fhi:git
county,Viken,2021-01-29,1042,427,23297,4638,1.86021220328589,0.370333699568184,1469,27935,fhi:git
county,Viken,2021-01-30,12,18,23309,4656,1.86117037585916,0.371770958428086,30,27965,fhi:git
county,Viken,2021-01-31,10,3,23319,4659,1.86196885300355,0.372010501571403,13,27978,fhi:git
county,Viken,2021-02-01,37,48,23356,4707,1.8649232184378,0.375843191864476,85,28063,fhi:git
county,Viken,2021-02-02,1027,689,24383,5396,1.94692682116667,0.430858267112962,1716,29779,fhi:git
county,Viken,2021-02-03,4783,1725,29166,7121,2.32883843932851,0.568595574520275,6508,36287,fhi:git
county,Viken,2021-02-04,6650,1757,35816,8878,2.85982574034801,0.708888008789636,8407,44694,fhi:git
county,Viken,2021-02-05,3148,1102,38964,9980,3.11118634540205,0.796880190101439,4250,48944,fhi:git
county,Viken,2021-02-06,41,92,39005,10072,3.11446010169405,0.804226179829829,133,49077,fhi:git
county,Viken,2021-02-07,16,22,39021,10094,3.11573766512507,0.805982829547487,38,49115,fhi:git
county,Viken,2021-02-08,14,96,39035,10190,3.11685553312722,0.813648210133633,110,49225,fhi:git
county,Viken,2021-02-09,801,570,39836,10760,3.18081355239288,0.859161407363876,1371,50596,fhi:git
county,Viken,2021-02-10,3453,1326,43289,12086,3.45652771035082,0.965039476710019,4779,55375,fhi:git
county,Viken,2021-02-11,4854,1917,48143,14003,3.84410851623783,1.11810754528962,6771,62146,fhi:git
county,Viken,2021-02-12,2429,983,50572,14986,4.03805861461022,1.19659784858318,3412,65558,fhi:git
county,Viken,2021-02-13,26,99,50598,15085,4.04013465518563,1.20450277231265,125,65683,fhi:git
county,Viken,2021-02-14,7,1,50605,15086,4.0406935891867,1.20458262002708,8,65691,fhi:git
county,Viken,2021-02-15,367,126,50972,15212,4.06999770038582,1.2146434320464,493,66184,fhi:git
county,Viken,2021-02-16,1430,359,52402,15571,4.18417993203363,1.24330876153001,1789,67973,fhi:git
county,Viken,2021-02-17,4416,1835,56818,17406,4.53678743899635,1.38982931752562,6251,74224,fhi:git
county,Viken,2021-02-18,4899,2932,61717,20338,4.92796139203311,1.62394281626083,7831,82055,fhi:git
county,Viken,2021-02-19,3799,1284,65516,21622,5.23130285918696,1.72646728160053,5083,87138,fhi:git
county,Viken,2021-02-20,30,11,65546,21633,5.23369829062013,1.72734560645936,41,87179,fhi:git
county,Viken,2021-02-21,1,9,65547,21642,5.23377813833457,1.72806423588931,10,87189,fhi:git
county,Viken,2021-02-22,706,10,66253,21652,5.29015062472852,1.7288627130337,716,87905,fhi:git
county,Viken,2021-02-23,2132,760,68385,22412,5.46038595191251,1.78954697600736,2892,90797,fhi:git
county,Viken,2021-02-24,2546,4219,70931,26631,5.66367823287426,2.12642448322559,6765,97562,fhi:git
county,Viken,2021-02-25,2550,6280,73481,32911,5.86728990469377,2.62786812990265,8830,106392,fhi:git
county,Viken,2021-02-26,1942,2724,75423,35635,6.02235416613435,2.84537330403455,4666,111058,fhi:git
county,Viken,2021-02-27,167,91,75590,35726,6.03568873444567,2.8526394460485,258,111316,fhi:git
county,Viken,2021-02-28,416,1,76006,35727,6.0689053836523,2.85271929376294,417,111733,fhi:git
county,Viken,2021-03-01,1523,2,77529,35729,6.19051345274293,2.85287898919181,1525,113258,fhi:git
county,Viken,2021-03-02,3031,524,80560,36253,6.43253187520761,2.89471919155786,3555,116813,fhi:git
county,Viken,2021-03-03,4967,2704,85527,38957,6.82913547282623,3.11062741140098,7671,124484,fhi:git
county,Viken,2021-03-04,4397,3266,89924,42223,7.18022587321461,3.37141004675882,7663,132147,fhi:git
county,Viken,2021-03-05,2730,1782,92654,44005,7.39821013363314,3.51369867388916,4512,136659,fhi:git
county,Viken,2021-03-06,215,3,92869,44008,7.41537739223753,3.51393821703248,218,136877,fhi:git
county,Viken,2021-03-07,17,0,92886,44008,7.41673480338299,3.51393821703248,17,136894,fhi:git
county,Viken,2021-03-08,1137,22,94023,44030,7.50752165470016,3.51569486675013,1159,138053,fhi:git
county,Viken,2021-03-09,2897,720,96920,44750,7.73884048343,3.57318522114623,3617,141670,fhi:git
county,Viken,2021-03-10,5404,3218,102324,47968,8.17033753225848,3.830135166211,8622,150292,fhi:git
county,Viken,2021-03-11,3432,4773,105756,52741,8.4443748882132,4.21124830722845,8205,158497,fhi:git
county,Viken,2021-03-12,1228,3318,106984,56059,8.54242788154432,4.47618302373713,4546,163043,fhi:git
county,Viken,2021-03-13,17,8,107001,56067,8.54378529268978,4.47682180545264,25,163068,fhi:git
county,Viken,2021-03-14,2,6,107003,56073,8.54394498811866,4.47730089173928,8,163076,fhi:git
county,Viken,2021-03-15,36,48,107039,56121,8.54681950583847,4.48113358203235,84,163160,fhi:git
county,Viken,2021-03-16,784,346,107823,56467,8.60942011395866,4.50876089122825,1130,164290,fhi:git
county,Viken,2021-03-17,4001,507,111824,56974,8.92889081942919,4.54924368244883,4508,168798,fhi:git
county,Viken,2021-03-18,5956,482,117780,57456,9.404463806628,4.58773028080844,6438,175236,fhi:git
county,Viken,2021-03-19,2050,406,119830,57862,9.56815162122799,4.62014845287069,2456,177692,fhi:git
county,Viken,2021-03-20,6,2,119836,57864,9.56863070751463,4.62030814829956,8,177700,fhi:git
county,Viken,2021-03-21,6,1,119842,57865,9.56910979380126,4.620387996014,7,177707,fhi:git
county,Viken,2021-03-22,408,25,120250,57890,9.60168766129238,4.62238418887498,433,178140,fhi:git
county,Viken,2021-03-23,2498,81,122748,57971,9.80114725196106,4.62885185374454,2579,180719,fhi:git
county,Viken,2021-03-24,7409,751,130157,58722,10.3927389682398,4.68881748728824,8160,188879,fhi:git
county,Viken,2021-03-25,10252,637,140409,59359,11.2113377366686,4.7396804813859,10889,199768,fhi:git
county,Viken,2021-03-26,5941,325,146350,59684,11.6857130081509,4.76563098857858,6266,206034,fhi:git
county,Viken,2021-03-27,35,1,146385,59685,11.6885076781562,4.76571083629302,36,206070,fhi:git
county,Viken,2021-03-28,6,0,146391,59685,11.6889867644429,4.76571083629302,6,206076,fhi:git
county,Viken,2021-03-29,1334,4,147725,59689,11.7955036155045,4.76603022715078,1338,207414,fhi:git
county,Viken,2021-03-30,6126,1610,153851,61299,12.284650714158,4.8945850473976,7736,215150,fhi:git
county,Viken,2021-03-31,9935,1856,163786,63155,13.0779377571096,5.04278240539643,11791,226941,fhi:git
county,Viken,2021-04-01,3686,479,167472,63634,13.3722564325319,5.08102946061272,4165,231106,fhi:git
county,Viken,2021-04-02,2263,271,169735,63905,13.5529518103074,5.10266819122569,2534,233640,fhi:git
county,Viken,2021-04-03,4,0,169739,63905,13.5532712011651,5.10266819122569,4,233644,fhi:git
county,Viken,2021-04-04,16,0,169755,63905,13.5545487645962,5.10266819122569,16,233660,fhi:git
county,Viken,2021-04-05,56,4,169811,63909,13.5590202366047,5.10298758208345,60,233720,fhi:git
county,Viken,2021-04-06,3415,2133,173226,66042,13.831700181414,5.27330275698188,5548,239268,fhi:git
county,Viken,2021-04-07,11150,2524,184376,68566,14.7220021974091,5.47483838822598,13674,252942,fhi:git
county,Viken,2021-04-08,14968,1993,199344,70559,15.9171627871324,5.63397488310295,16961,269903,fhi:git
county,Viken,2021-04-09,8526,267,207870,70826,16.5979444004395,5.65529422285817,8793,278696,fhi:git
county,Viken,2021-04-10,249,42,208119,70868,16.6178264813348,5.6586478268646,291,278987,fhi:git
county,Viken,2021-04-11,14,0,208133,70868,16.6189443493369,5.6586478268646,14,279001,fhi:git
county,Viken,2021-04-12,1444,8,209577,70876,16.7342444489869,5.65928660858012,1452,280453,fhi:git
county,Viken,2021-04-13,7667,175,217244,71051,17.3464368755909,5.67325995860695,7842,288295,fhi:git
county,Viken,2021-04-14,14105,788,231349,71839,18.4726888877533,5.73617995758489,14893,303188,fhi:git
county,Viken,2021-04-15,18038,211,249387,72050,19.9129819608044,5.75302782533153,18249,321437,fhi:git
county,Viken,2021-04-16,9754,279,259141,72329,20.6918165674426,5.77530533766002,10033,331470,fhi:git
county,Viken,2021-04-17,289,2,259430,72331,20.7148925569155,5.77546503308889,291,331761,fhi:git
county,Viken,2021-04-18,54,2,259484,72333,20.7192043334952,5.77562472851777,56,331817,fhi:git
county,Viken,2021-04-19,1814,5,261298,72338,20.8640480874875,5.77602396708997,1819,333636,fhi:git
county,Viken,2021-04-20,2999,115,264297,72453,21.1035113830902,5.78520645425045,3114,336750,fhi:git
county,Viken,2021-04-21,12793,510,277090,72963,22.1250031939086,5.82592878861435,13303,350053,fhi:git
county,Viken,2021-04-22,10866,530,287956,73493,22.992628459003,5.86824807726704,11396,361449,fhi:git
county,Viken,2021-04-23,4393,334,292349,73827,23.3433994685336,5.89491721388967,4727,366176,fhi:git
county,Viken,2021-04-24,25,3,292374,73830,23.3453956613946,5.89515675703299,28,366204,fhi:git
county,Viken,2021-04-25,2,1,292376,73831,23.3455553568235,5.89523660474743,3,366207,fhi:git
county,Viken,2021-04-26,167,35,292543,73866,23.3588899251348,5.89803127475279,202,366409,fhi:git
county,Viken,2021-04-27,4451,715,296994,74581,23.7142921021029,5.95512239057669,5166,371575,fhi:git
county,Viken,2021-04-28,14811,4460,311805,79041,24.8969166006592,6.31124319697473,19271,390846,fhi:git
county,Viken,2021-04-29,11692,5769,323497,84810,25.8304960778803,6.77188466157345,17461,408307,fhi:git
county,Viken,2021-04-30,7085,2498,330582,87308,26.3962171346807,6.97134425224212,9583,417890,fhi:git
county,Viken,2021-05-01,340,10,330922,87318,26.42336535759,6.97214272938652,350,418240,fhi:git
county,Viken,2021-05-02,130,12,331052,87330,26.4337455604671,6.97310090195978,142,418382,fhi:git
county,Viken,2021-05-03,354,437,331406,87767,26.4620116513785,7.00799435316964,791,419173,fhi:git
county,Viken,2021-05-04,1977,2040,333383,89807,26.6198705828244,7.17088369062524,4017,423190,fhi:git
county,Viken,2021-05-05,10196,7804,343579,97611,27.4339978792447,7.79401525410737,18000,441190,fhi:git
county,Viken,2021-05-06,8733,9141,352312,106752,28.1313079694407,8.52390321179447,17874,459064,fhi:git
county,Viken,2021-05-07,4394,5359,356706,112111,28.4821588266857,8.95180711347318,9753,468817,fhi:git
county,Viken,2021-05-08,27,11,356733,112122,28.4843147149756,8.95268543833201,38,468855,fhi:git
county,Viken,2021-05-09,32,6,356765,112128,28.4868698418377,8.95316452461865,38,468893,fhi:git
nation,Norge,2020-12-27,5,0,5,0,9.31518486915891e-05,0.0,5,5,fhi:git
nation,Norge,2020-12-28,605,0,610,0,0.0113645255403739,0.0,605,610,fhi:git
nation,Norge,2020-12-29,1067,0,1677,0,0.031243130051159,0.0,1067,1677,fhi:git
nation,Norge,2020-12-30,427,0,2104,0,0.0391982979294207,0.0,427,2104,fhi:git
nation,Norge,2020-12-31,73,0,2177,0,0.0405583149203179,0.0,73,2177,fhi:git
nation,Norge,2021-01-01,6,0,2183,0,0.0406700971387478,0.0,6,2183,fhi:git
nation,Norge,2021-01-02,0,0,2183,0,0.0406700971387478,0.0,0,2183,fhi:git
nation,Norge,2021-01-03,18,0,2201,0,0.0410054437940375,0.0,18,2201,fhi:git
nation,Norge,2021-01-04,6,0,2207,0,0.040935799423115,0.0,6,2207,fhi:git
nation,Norge,2021-01-05,3387,0,5594,0,0.103758433154919,0.0,3387,5594,fhi:git
nation,Norge,2021-01-06,9070,0,14664,0,0.271990286697126,0.0,9070,14664,fhi:git
nation,Norge,2021-01-07,6558,0,21222,0,0.393629150592363,0.0,6558,21222,fhi:git
nation,Norge,2021-01-08,1616,0,22838,0,0.423602984696466,0.0,1616,22838,fhi:git
nation,Norge,2021-01-09,137,0,22975,0,0.426144083256034,0.0,137,22975,fhi:git
nation,Norge,2021-01-10,108,0,23083,0,0.428147285040219,0.0,108,23083,fhi:git
nation,Norge,2021-01-11,361,0,23444,0,0.434843172485504,0.0,361,23444,fhi:git
nation,Norge,2021-01-12,4266,0,27710,0,0.513969642960814,0.0,4266,27710,fhi:git
nation,Norge,2021-01-13,9799,0,37509,0,0.695723108546271,0.0,9799,37509,fhi:git
nation,Norge,2021-01-14,8478,0,45987,0,0.852974448604798,0.0,8478,45987,fhi:git
nation,Norge,2021-01-15,4489,0,50476,0,0.936237159801156,0.0,4489,50476,fhi:git
nation,Norge,2021-01-16,750,0,51226,0,0.950148283302441,0.0,750,51226,fhi:git
nation,Norge,2021-01-17,356,5,51582,5,0.956751429924385,9.27408233419007e-05,361,51587,fhi:git
nation,Norge,2021-01-18,1290,283,52872,288,0.980678562346595,0.0053418714244934,1573,53160,fhi:git
nation,Norge,2021-01-19,4594,772,57466,1060,1.06588883083313,0.019661054548483,5366,58526,fhi:git
nation,Norge,2021-01-20,10071,693,67537,1753,1.25268739720839,0.0325149326636704,10764,69290,fhi:git
nation,Norge,2021-01-21,8453,169,75990,1922,1.40947503315021,0.0356495724926266,8622,77912,fhi:git
nation,Norge,2021-01-22,3323,7,79313,1929,1.47111058434323,0.0357794096453053,3330,81242,fhi:git
nation,Norge,2021-01-23,360,0,79673,1929,1.47778792362385,0.0357794096453053,360,81602,fhi:git
nation,Norge,2021-01-24,69,0,79742,1929,1.47906774698597,0.0357794096453053,69,81671,fhi:git
nation,Norge,2021-01-25,581,0,80323,1929,1.4898442306583,0.0357794096453053,581,82252,fhi:git
nation,Norge,2021-01-26,2281,2150,82604,4079,1.53215259426687,0.0756579636823226,4431,86683,fhi:git
nation,Norge,2021-01-27,11509,7598,94113,11677,1.74562342143526,0.216586918832675,19107,105790,fhi:git
nation,Norge,2021-01-28,10913,6583,105026,18260,1.94803954246129,0.338689486844622,17496,123286,fhi:git
nation,Norge,2021-01-29,3819,2109,108845,20369,2.01887498332984,0.377807566130235,5928,129214,fhi:git
nation,Norge,2021-01-30,152,174,108997,20543,2.02169430435943,0.381034946782533,326,129540,fhi:git
nation,Norge,2021-01-31,109,52,109106,20595,2.02371605430828,0.381999451345289,161,129701,fhi:git
nation,Norge,2021-02-01,201,305,109307,20900,2.02744423540663,0.387656641569145,506,130207,fhi:git
nation,Norge,2021-02-02,6361,3150,115668,24050,2.1454291108622,0.446083360274543,9511,139718,fhi:git
nation,Norge,2021-02-03,25184,8386,140852,32436,2.61254608987068,0.601628269183579,33570,173288,fhi:git
nation,Norge,2021-02-04,26002,8710,166854,41146,3.0948354675779,0.76318278344517,34712,208000,fhi:git
nation,Norge,2021-02-05,10627,4885,177481,46031,3.29194681350878,0.853790567850207,15512,223512,fhi:git
nation,Norge,2021-02-06,814,741,178295,46772,3.30704501954884,0.867534757869476,1555,225067,fhi:git
nation,Norge,2021-02-07,320,304,178615,47076,3.31298043224272,0.873173399928664,624,225691,fhi:git
nation,Norge,2021-02-08,118,923,178733,47999,3.31516911567359,0.890293355917579,1041,226732,fhi:git
nation,Norge,2021-02-09,5568,3248,184301,51247,3.41844529654713,0.950537794760477,8816,235548,fhi:git
nation,Norge,2021-02-10,23029,8679,207330,59926,3.84559098069526,1.11151731591735,31708,267256,fhi:git
nation,Norge,2021-02-11,20970,8599,228300,68525,4.23454599379119,1.27101298390075,29569,296825,fhi:git
nation,Norge,2021-02-12,8062,3621,236362,72146,4.38408129734767,1.33817588816495,11683,308508,fhi:git
nation,Norge,2021-02-13,898,308,237260,72454,4.40073754921987,1.34388872288282,1206,309714,fhi:git
nation,Norge,2021-02-14,110,5,237370,72459,4.4027778473334,1.34398146370616,115,309829,fhi:git
nation,Norge,2021-02-15,830,755,238200,73214,4.41817282400815,1.35798532803078,1585,311414,fhi:git
nation,Norge,2021-02-16,6118,2181,244318,75395,4.5316504954493,1.39843887517252,8299,319713,fhi:git
nation,Norge,2021-02-17,21797,10308,266115,85703,4.93594484072598,1.58963335657418,32105,351818,fhi:git
nation,Norge,2021-02-18,18914,10853,285029,96556,5.28676482726373,1.79093658772011,29767,381585,fhi:git
nation,Norge,2021-02-19,10742,4815,295771,101371,5.48600921213147,1.88024600059836,15557,397142,fhi:git
nation,Norge,2021-02-20,504,180,296275,101551,5.49535748712433,1.88358467023867,684,397826,fhi:git
nation,Norge,2021-02-21,59,108,296334,101659,5.49645182883976,1.88558787202286,167,397993,fhi:git
nation,Norge,2021-02-22,2578,144,298912,101803,5.54426899735485,1.8882588077351,2722,400715,fhi:git
nation,Norge,2021-02-23,5756,5219,304668,107022,5.65103223318604,1.98506167913938,10975,411690,fhi:git
nation,Norge,2021-02-24,11155,22394,315823,129416,5.85793701006182,2.40042927872309,33549,445239,fhi:git
nation,Norge,2021-02-25,11176,25211,326999,154627,6.06523129839564,2.86804705817762,36387,481626,fhi:git
nation,Norge,2021-02-26,8389,9963,335388,164590,6.22083185179868,3.05284242276869,18352,499978,fhi:git
nation,Norge,2021-02-27,445,207,335833,164797,6.22908578507611,3.05668189285504,652,500630,fhi:git
nation,Norge,2021-02-28,540,160,336373,164957,6.23910179399704,3.05964959920198,700,501330,fhi:git
nation,Norge,2021-03-01,5966,63,342339,165020,6.34976014440859,3.06081813357609,6029,507359,fhi:git
nation,Norge,2021-03-02,10557,3846,352896,168866,6.54557311881268,3.13215437489068,14403,521762,fhi:git
nation,Norge,2021-03-03,17728,18124,370624,186990,6.87439498205372,3.4683213113404,35852,557614,fhi:git
nation,Norge,2021-03-04,16293,18544,386917,205534,7.17660022899564,3.81227847695085,34837,592451,fhi:git
nation,Norge,2021-03-05,11947,6561,398864,212095,7.39819515228878,3.93397298534009,18508,610959,fhi:git
nation,Norge,2021-03-06,401,483,399265,212578,7.4056329663208,3.94293174887491,884,611843,fhi:git
nation,Norge,2021-03-07,98,2,399363,212580,7.4074506864583,3.94296884520425,100,611943,fhi:git
nation,Norge,2021-03-08,4952,48,404315,212628,7.49930119789612,3.94385915710833,5000,616943,fhi:git
nation,Norge,2021-03-09,12506,4275,416821,216903,7.73126454523888,4.02315256106566,16781,633724,fhi:git
nation,Norge,2021-03-10,21160,17321,437981,234224,8.1237437096218,4.34442532128667,38481,672205,fhi:git
nation,Norge,2021-03-11,12048,16645,450029,250869,8.34721199754645,4.65315952219186,28693,700898,fhi:git
nation,Norge,2021-03-12,2335,8340,452364,259209,8.39052196204712,4.80785121552615,10675,711573,fhi:git
nation,Norge,2021-03-13,48,306,452412,259515,8.3914122739512,4.81352695391467,354,711927,fhi:git
nation,Norge,2021-03-14,8,109,452420,259624,8.39156065926855,4.81554870386353,117,712044,fhi:git
nation,Norge,2021-03-15,100,439,452520,260063,8.39341547573538,4.82369134815295,539,712583,fhi:git
nation,Norge,2021-03-16,5690,696,458210,260759,8.49895453269847,4.83660087076214,6386,718969,fhi:git
nation,Norge,2021-03-17,23121,1686,481331,262445,8.92780664799608,4.86787307639303,24807,743776,fhi:git
nation,Norge,2021-03-18,21075,1473,502406,263918,9.3187092183822,4.89519452294955,22548,766324,fhi:git
nation,Norge,2021-03-19,6825,1017,509231,264935,9.44530044224389,4.91405800641729,7842,774166,fhi:git
nation,Norge,2021-03-20,460,22,509691,264957,9.45383259799135,4.91446606604,482,774648,fhi:git
nation,Norge,2021-03-21,189,70,509880,265027,9.45733820111367,4.91576443756679,259,774907,fhi:git
nation,Norge,2021-03-22,1510,86,511390,265113,9.48534592976292,4.91735957972827,1596,776503,fhi:git
nation,Norge,2021-03-23,13145,970,524535,266083,9.72916155432878,4.93535129945659,14115,790618,fhi:git
nation,Norge,2021-03-24,39245,3692,563780,269775,10.4570842767394,5.00383112341225,42937,833555,fhi:git
nation,Norge,2021-03-25,38840,2364,602620,272139,11.1774949924592,5.04767898468831,41204,874759,fhi:git
nation,Norge,2021-03-26,17422,1170,620042,273309,11.5006411173118,5.06938033735031,18592,893351,fhi:git
nation,Norge,2021-03-27,722,6,620764,273315,11.5140328922023,5.06949162633832,728,894079,fhi:git
nation,Norge,2021-03-28,330,7,621094,273322,11.5201537865429,5.069621463491,337,894416,fhi:git
nation,Norge,2021-03-29,4769,28,625863,273350,11.6086099838464,5.07014081210171,4797,899213,fhi:git
nation,Norge,2021-03-30,32280,4046,658143,277396,12.2073447393417,5.14518668634998,36326,935539,fhi:git
nation,Norge,2021-03-31,36800,7115,694943,284511,12.8899171991381,5.2771568779655,43915,979454,fhi:git
nation,Norge,2021-04-01,9426,1481,704369,285992,13.0647521993023,5.30462670983938,10907,990361,fhi:git
nation,Norge,2021-04-02,4311,700,708680,286692,13.1447133371876,5.31761042510724,5011,995372,fhi:git
nation,Norge,2021-04-03,269,8,708949,286700,13.1497027934834,5.31775881042459,277,995649,fhi:git
nation,Norge,2021-04-04,392,43,709341,286743,13.1569736740334,5.31855638150533,435,996084,fhi:git
nation,Norge,2021-04-05,1325,66,710666,286809,13.181549992219,5.31978056037344,1391,997475,fhi:git
nation,Norge,2021-04-06,18663,2613,729329,289422,13.527714389425,5.36824691465192,21276,1018751,fhi:git
nation,Norge,2021-04-07,58524,3682,787853,293104,14.6132271784773,5.43654125696089,62206,1080957,fhi:git
nation,Norge,2021-04-08,57326,4156,845179,297260,15.6765192662569,5.51362742932268,61482,1142439,fhi:git
nation,Norge,2021-04-09,27388,653,872567,297913,16.1845164001945,5.52573938085113,28041,1170480,fhi:git
nation,Norge,2021-04-10,1057,47,873624,297960,16.2041218102489,5.52661114459055,1104,1171584,fhi:git
nation,Norge,2021-04-11,554,9,874178,297969,16.2143974934752,5.52677807807256,563,1172147,fhi:git
nation,Norge,2021-04-12,3660,85,877838,298054,16.2822837761615,5.52835467206938,3745,1175892,fhi:git
nation,Norge,2021-04-13,25521,396,903359,298450,16.7556514866632,5.53569974527806,25917,1201809,fhi:git
nation,Norge,2021-04-14,67075,1455,970434,299905,17.9997696317948,5.56268732487055,68530,1270339,fhi:git
nation,Norge,2021-04-15,65159,1239,1035593,301144,19.2083494934218,5.58566850089467,66398,1336737,fhi:git
nation,Norge,2021-04-16,28908,840,1064501,301984,19.7445398376553,5.60124895921611,29748,1366485,fhi:git
nation,Norge,2021-04-17,1965,161,1066466,302145,19.7809869812287,5.60423521372772,2126,1368611,fhi:git
nation,Norge,2021-04-18,1280,13,1067746,302158,19.8047286320042,5.60447633986841,1293,1369904,fhi:git
nation,Norge,2021-04-19,6371,145,1074117,302303,19.9228989891065,5.60716582374532,6516,1376420,fhi:git
nation,Norge,2021-04-20,19469,774,1093586,303077,20.2840132070352,5.62152210319865,20243,1396663,fhi:git
nation,Norge,2021-04-21,58774,2826,1152360,305903,21.3741630372546,5.67393921655149,61600,1458263,fhi:git
nation,Norge,2021-04-22,50684,2264,1203044,308167,22.3142582153067,5.7159322613607,52948,1511211,fhi:git
nation,Norge,2021-04-23,18151,1333,1221195,309500,22.6509259522025,5.74065696486366,19484,1530695,fhi:git
nation,Norge,2021-04-24,357,30,1221552,309530,22.6575476469891,5.74121340980371,387,1531082,fhi:git
nation,Norge,2021-04-25,284,4,1221836,309534,22.6628153257549,5.74128760246238,288,1531370,fhi:git
nation,Norge,2021-04-26,2261,472,1224097,310006,22.7047527260701,5.75004233618586,2733,1534103,fhi:git
nation,Norge,2021-04-27,19187,5905,1243284,315911,23.0606363615623,5.85956924855264,25092,1559195,fhi:git
nation,Norge,2021-04-28,58045,24438,1301329,340349,24.1372645797385,6.31284929671852,82483,1641678,fhi:git
nation,Norge,2021-04-29,53695,20745,1355024,361094,25.1332082816071,6.69763097276406,74440,1716118,fhi:git
nation,Norge,2021-04-30,25125,8107,1380149,369201,25.5992309189002,6.84800094373062,33232,1749350,fhi:git
nation,Norge,2021-05-01,1419,288,1381568,369489,25.6255507645646,6.85334281515511,1707,1751057,fhi:git
nation,Norge,2021-05-02,967,265,1382535,369754,25.643486839799,6.85825807879223,1232,1752289,fhi:git
nation,Norge,2021-05-03,3047,1403,1385582,371157,25.7000030975435,6.88428115382197,4450,1756739,fhi:git
nation,Norge,2021-05-04,9971,11829,1395553,382986,25.8849468474519,7.10368739368424,21800,1778539,fhi:git
nation,Norge,2021-05-05,40104,37913,1435657,420899,26.6288024433126,7.80690396075654,78017,1856556,fhi:git
nation,Norge,2021-05-06,34272,34874,1469929,455773,27.2644851428274,8.45375265540162,69146,1925702,fhi:git
nation,Norge,2021-05-07,15060,15740,1484989,471513,27.5438205027332,8.74570076728193,30800,1956502,fhi:git
nation,Norge,2021-05-08,444,532,1485433,472045,27.5520558878459,8.75556839088551,976,1957478,fhi:git
nation,Norge,2021-05-09,226,331,1485659,472376,27.556247773061,8.76170783339074,557,1958035,fhi:git
