granularity_geo,location_name,date,new_dose_1,new_dose_2,total_dose_1,total_dose_2,total_pr100_dose_1,total_pr100_dose_2,new_doses,total_doses,source
county,Agder,2020-12-27,0,0,0,0,0.0,0.0,0,0,fhi:git
county,Agder,2020-12-28,0,0,0,0,0.0,0.0,0,0,fhi:git
county,Agder,2020-12-29,0,0,0,0,0.0,0.0,0,0,fhi:git
county,Agder,2020-12-30,0,0,0,0,0.0,0.0,0,0,fhi:git
county,Agder,2020-12-31,0,0,0,0,0.0,0.0,0,0,fhi:git
county,Agder,2021-01-01,0,0,0,0,0.0,0.0,0,0,fhi:git
county,Agder,2021-01-02,0,0,0,0,0.0,0.0,0,0,fhi:git
county,Agder,2021-01-03,3,0,3,0,0.0009764639635974,0.0,3,3,fhi:git
county,Agder,2021-01-04,0,0,3,0,0.0009713673290312,0.0,0,3,fhi:git
county,Agder,2021-01-05,79,0,82,0,0.026550706993521,0.0,79,82,fhi:git
county,Agder,2021-01-06,794,0,876,0,0.283639260077127,0.0,794,876,fhi:git
county,Agder,2021-01-07,230,0,1106,0,0.358110755302856,0.0,230,1106,fhi:git
county,Agder,2021-01-08,49,0,1155,0,0.373976421677033,0.0,49,1155,fhi:git
county,Agder,2021-01-09,0,0,1155,0,0.373976421677033,0.0,0,1155,fhi:git
county,Agder,2021-01-10,0,0,1155,0,0.373976421677033,0.0,0,1155,fhi:git
county,Agder,2021-01-11,1,0,1156,0,0.37430021078671,0.0,1,1156,fhi:git
county,Agder,2021-01-12,226,0,1382,0,0.447476549573732,0.0,226,1382,fhi:git
county,Agder,2021-01-13,861,0,2243,0,0.726258973005702,0.0,861,2243,fhi:git
county,Agder,2021-01-14,518,0,2761,0,0.893981731818432,0.0,518,2761,fhi:git
county,Agder,2021-01-15,119,0,2880,0,0.932512635870005,0.0,119,2880,fhi:git
county,Agder,2021-01-16,1,0,2881,0,0.932836424979682,0.0,1,2881,fhi:git
county,Agder,2021-01-17,2,0,2883,0,0.933484003199036,0.0,2,2883,fhi:git
county,Agder,2021-01-18,15,0,2898,0,0.938340839844193,0.0,15,2898,fhi:git
county,Agder,2021-01-19,346,0,3244,0,1.05037187179246,0.0,346,3244,fhi:git
county,Agder,2021-01-20,460,0,3704,0,1.19931486224392,0.0,460,3704,fhi:git
county,Agder,2021-01-21,341,0,4045,0,1.30972694864381,0.0,341,4045,fhi:git
county,Agder,2021-01-22,67,0,4112,0,1.33142081899217,0.0,67,4112,fhi:git
county,Agder,2021-01-23,2,0,4114,0,1.33206839721153,0.0,2,4114,fhi:git
county,Agder,2021-01-24,0,0,4114,0,1.33206839721153,0.0,0,4114,fhi:git
county,Agder,2021-01-25,3,0,4117,0,1.33303976454056,0.0,3,4117,fhi:git
county,Agder,2021-01-26,63,66,4180,66,1.35343847845022,0.0213700812386876,129,4246,fhi:git
county,Agder,2021-01-27,567,681,4747,747,1.53702690363712,0.241870464928783,1248,5494,fhi:git
county,Agder,2021-01-28,955,251,5702,998,1.84624550337874,0.323141531457731,1206,6700,fhi:git
county,Agder,2021-01-29,204,61,5906,1059,1.91229848175286,0.342892667148033,265,6965,fhi:git
county,Agder,2021-01-30,33,0,5939,1059,1.92298352237221,0.342892667148033,33,6998,fhi:git
county,Agder,2021-01-31,26,0,5965,1059,1.93140203922381,0.342892667148033,26,7024,fhi:git
county,Agder,2021-02-01,1,2,5966,1061,1.93172582833349,0.343540245367387,3,7027,fhi:git
county,Agder,2021-02-02,203,170,6169,1231,1.99745501759794,0.398584394012492,373,7400,fhi:git
county,Agder,2021-02-03,1335,602,7504,1833,2.42971347901685,0.593505438038097,1937,9337,fhi:git
county,Agder,2021-02-04,1710,507,9214,2340,2.98339285656466,0.757666516644379,2217,11554,fhi:git
county,Agder,2021-02-05,621,135,9835,2475,3.18446589367413,0.801378046450786,756,12310,fhi:git
county,Agder,2021-02-06,511,2,10346,2477,3.34992212871912,0.80202562467014,513,12823,fhi:git
county,Agder,2021-02-07,87,2,10433,2479,3.37809178126103,0.802673202889494,89,12912,fhi:git
county,Agder,2021-02-08,13,2,10446,2481,3.38230103968683,0.803320781108848,15,12927,fhi:git
county,Agder,2021-02-09,189,255,10635,2736,3.4434971814158,0.885887004076505,444,13371,fhi:git
county,Agder,2021-02-10,1154,371,11789,3107,3.81714981398316,1.0060127637667,1525,14896,fhi:git
county,Agder,2021-02-11,1008,416,12797,3523,4.14352923653766,1.14070903339237,1424,16320,fhi:git
county,Agder,2021-02-12,358,69,13155,3592,4.25944573780205,1.16305048196009,427,16747,fhi:git
county,Agder,2021-02-13,510,3,13665,3595,4.42457818373737,1.16402184928912,513,17260,fhi:git
county,Agder,2021-02-14,0,0,13665,3595,4.42457818373737,1.16402184928912,0,17260,fhi:git
county,Agder,2021-02-15,2,1,13667,3596,4.42522576195672,1.1643456383988,3,17263,fhi:git
county,Agder,2021-02-16,142,117,13809,3713,4.47120381553087,1.20222896423102,259,17522,fhi:git
county,Agder,2021-02-17,1222,435,15031,4148,4.86687410755627,1.34307722694055,1657,19179,fhi:git
county,Agder,2021-02-18,1083,829,16114,4977,5.21753771333655,1.61149839886285,1912,21091,fhi:git
county,Agder,2021-02-19,721,343,16835,5320,5.45098966141373,1.72255806348209,1064,22155,fhi:git
county,Agder,2021-02-20,355,38,17190,5358,5.56593479534909,1.73486204964982,393,22548,fhi:git
county,Agder,2021-02-21,52,25,17242,5383,5.5827718290523,1.74295677739175,77,22625,fhi:git
county,Agder,2021-02-22,223,1,17465,5384,5.65497680051029,1.74328056650143,224,22849,fhi:git
county,Agder,2021-02-23,294,201,17759,5585,5.75017079875535,1.80836217754652,495,23344,fhi:git
county,Agder,2021-02-24,977,1113,18736,6698,6.06651275890987,2.16873945661712,2090,25434,fhi:git
county,Agder,2021-02-25,718,1569,19454,8267,6.29899333965801,2.67676456970046,2287,27721,fhi:git
county,Agder,2021-02-26,399,466,19853,8733,6.42818519441917,2.82765029480998,865,28586,fhi:git
county,Agder,2021-02-27,0,1,19853,8734,6.42818519441917,2.82797408391966,1,28587,fhi:git
county,Agder,2021-02-28,10,82,19863,8816,6.43142308551594,2.85452479091318,92,28679,fhi:git
county,Agder,2021-03-01,263,0,20126,8816,6.51657962136102,2.85452479091318,263,28942,fhi:git
county,Agder,2021-03-02,578,192,20704,9008,6.70372972675437,2.91669229997118,770,29712,fhi:git
county,Agder,2021-03-03,636,880,21340,9888,6.909659600509,3.20162671648702,1516,31228,fhi:git
county,Agder,2021-03-04,796,1070,22136,10958,7.16739573181196,3.5480810638415,1866,33094,fhi:git
county,Agder,2021-03-05,961,383,23097,11341,7.47855706621164,3.67209229284782,1344,34438,fhi:git
county,Agder,2021-03-06,36,405,23133,11746,7.49021347416001,3.80322688226704,441,34879,fhi:git
county,Agder,2021-03-07,5,1,23138,11747,7.4918324197084,3.80355067137672,6,34885,fhi:git
county,Agder,2021-03-08,226,0,23364,11747,7.56500875849542,3.80355067137672,226,35111,fhi:git
county,Agder,2021-03-09,724,141,24088,11888,7.79943207390163,3.84920493584119,865,35976,fhi:git
county,Agder,2021-03-10,1037,785,25125,12673,8.13520138063676,4.1033793869377,1822,37798,fhi:git
county,Agder,2021-03-11,647,814,25772,13487,8.34469293459784,4.36694372221485,1461,39259,fhi:git
county,Agder,2021-03-12,99,328,25871,13815,8.37674805645587,4.47314655018893,427,39686,fhi:git
county,Agder,2021-03-13,1,0,25872,13815,8.37707184556555,4.47314655018893,1,39687,fhi:git
county,Agder,2021-03-14,0,0,25872,13815,8.37707184556555,4.47314655018893,0,39687,fhi:git
county,Agder,2021-03-15,1,3,25873,13818,8.37739563467522,4.47411791751796,4,39691,fhi:git
county,Agder,2021-03-16,243,14,26116,13832,8.45607638832676,4.47865096505344,257,39948,fhi:git
county,Agder,2021-03-17,1608,48,27724,13880,8.97672927668751,4.49419284231794,1656,41604,fhi:git
county,Agder,2021-03-18,1247,94,28971,13974,9.38049429645483,4.52462901862759,1341,42945,fhi:git
county,Agder,2021-03-19,265,41,29236,14015,9.46629841051926,4.53790437212435,306,43251,fhi:git
county,Agder,2021-03-20,0,0,29236,14015,9.46629841051926,4.53790437212435,0,43251,fhi:git
county,Agder,2021-03-21,17,53,29253,14068,9.47180282538377,4.55506519493723,70,43321,fhi:git
county,Agder,2021-03-22,9,1,29262,14069,9.47471692737087,4.55538898404691,10,43331,fhi:git
county,Agder,2021-03-23,314,14,29576,14083,9.57638670780947,4.55992203158239,328,43659,fhi:git
county,Agder,2021-03-24,2268,77,31844,14160,10.3107404085571,4.58485379302753,2345,46004,fhi:git
county,Agder,2021-03-25,2039,53,33883,14213,10.9709464031887,4.60201461584041,2092,48096,fhi:git
county,Agder,2021-03-26,776,12,34659,14225,11.2222067522981,4.60590008515654,788,48884,fhi:git
county,Agder,2021-03-27,1,0,34660,14225,11.2225305414078,4.60590008515654,1,48885,fhi:git
county,Agder,2021-03-28,173,1,34833,14226,11.2785460573819,4.60622387426621,174,49059,fhi:git
county,Agder,2021-03-29,107,0,34940,14226,11.3131914921174,4.60622387426621,107,49166,fhi:git
county,Agder,2021-03-30,689,71,35629,14297,11.5362821886849,4.62921290105329,760,49926,fhi:git
county,Agder,2021-03-31,3374,403,39003,14700,12.6287466447354,4.75969991225315,3777,53703,fhi:git
county,Agder,2021-04-01,237,49,39240,14749,12.7054846637288,4.77556557862733,286,53989,fhi:git
county,Agder,2021-04-02,1,0,39241,14749,12.7058084528385,4.77556557862733,1,53990,fhi:git
county,Agder,2021-04-03,14,0,39255,14749,12.710341500374,4.77556557862733,14,54004,fhi:git
county,Agder,2021-04-04,1,5,39256,14754,12.7106652894837,4.77718452417571,6,54010,fhi:git
county,Agder,2021-04-05,0,0,39256,14754,12.7106652894837,4.77718452417571,0,54010,fhi:git
county,Agder,2021-04-06,619,1,39875,14755,12.9110907483738,4.77750831328539,620,54630,fhi:git
county,Agder,2021-04-07,3662,60,43537,14815,14.0968064680113,4.79693565986602,3722,58352,fhi:git
county,Agder,2021-04-08,3504,83,47041,14898,15.2313635083198,4.82381015596921,3587,61939,fhi:git
county,Agder,2021-04-09,899,1,47940,14899,15.5224499179195,4.82413394507889,900,62839,fhi:git
county,Agder,2021-04-10,0,1,47940,14900,15.5224499179195,4.82445773418857,1,62840,fhi:git
county,Agder,2021-04-11,164,0,48104,14900,15.5755513319065,4.82445773418857,164,63004,fhi:git
county,Agder,2021-04-12,23,2,48127,14902,15.5829984814291,4.82510531240792,25,63029,fhi:git
county,Agder,2021-04-13,763,6,48890,14908,15.8300495721127,4.82704804706598,769,63798,fhi:git
county,Agder,2021-04-14,4190,33,53080,14941,17.1867259416597,4.83773308768533,4223,68021,fhi:git
county,Agder,2021-04-15,4771,38,57851,14979,18.7315237839291,4.85003707385306,4809,72830,fhi:git
county,Agder,2021-04-16,1716,4,59567,14983,19.2871458961349,4.85133223029177,1720,74550,fhi:git
county,Agder,2021-04-17,2,0,59569,14983,19.2877934743543,4.85133223029177,2,74552,fhi:git
county,Agder,2021-04-18,216,8,59785,14991,19.3577319220445,4.85392254316918,224,74776,fhi:git
county,Agder,2021-04-19,2,0,59787,14991,19.3583795002639,4.85392254316918,2,74778,fhi:git
county,Agder,2021-04-20,446,10,60233,15001,19.5027894431799,4.85716043426595,456,75234,fhi:git
county,Agder,2021-04-21,3407,91,63640,15092,20.6059389398497,4.88662524324657,3498,78732,fhi:git
county,Agder,2021-04-22,3766,51,67406,15143,21.8253287268936,4.9031384878401,3817,82549,fhi:git
county,Agder,2021-04-23,710,17,68116,15160,22.0552189947643,4.90864290270461,727,83276,fhi:git
county,Agder,2021-04-24,2,0,68118,15160,22.0558665729837,4.90864290270461,2,83278,fhi:git
county,Agder,2021-04-25,199,3,68317,15163,22.1203006058094,4.90961427003364,202,83480,fhi:git
county,Agder,2021-04-26,3,0,68320,15163,22.1212719731385,4.90961427003364,3,83483,fhi:git
county,Agder,2021-04-27,356,166,68676,15329,22.2365408961835,4.96336326224004,522,84005,fhi:git
county,Innlandet,2020-12-27,0,0,0,0,0.0,0.0,0,0,fhi:git
county,Innlandet,2020-12-28,272,0,272,0,0.0732393607711674,0.0,272,272,fhi:git
county,Innlandet,2020-12-29,260,0,532,0,0.143247573273019,0.0,260,532,fhi:git
county,Innlandet,2020-12-30,149,0,681,0,0.183367664283695,0.0,149,681,fhi:git
county,Innlandet,2020-12-31,0,0,681,0,0.183367664283695,0.0,0,681,fhi:git
county,Innlandet,2021-01-01,0,0,681,0,0.183367664283695,0.0,0,681,fhi:git
county,Innlandet,2021-01-02,0,0,681,0,0.183367664283695,0.0,0,681,fhi:git
county,Innlandet,2021-01-03,0,0,681,0,0.183367664283695,0.0,0,681,fhi:git
county,Innlandet,2021-01-04,0,0,681,0,0.183754583745949,0.0,0,681,fhi:git
county,Innlandet,2021-01-05,270,0,951,0,0.256608823997647,0.0,270,951,fhi:git
county,Innlandet,2021-01-06,703,0,1654,0,0.446299679171512,0.0,703,1654,fhi:git
county,Innlandet,2021-01-07,695,0,2349,0,0.633831890189772,0.0,695,2349,fhi:git
county,Innlandet,2021-01-08,75,0,2424,0,0.654069179148577,0.0,75,2424,fhi:git
county,Innlandet,2021-01-09,0,0,2424,0,0.654069179148577,0.0,0,2424,fhi:git
county,Innlandet,2021-01-10,0,0,2424,0,0.654069179148577,0.0,0,2424,fhi:git
county,Innlandet,2021-01-11,50,0,2474,0,0.667560705121113,0.0,50,2474,fhi:git
county,Innlandet,2021-01-12,406,0,2880,0,0.777111896018111,0.0,406,2880,fhi:git
county,Innlandet,2021-01-13,994,0,3874,0,1.04532343235214,0.0,994,3874,fhi:git
county,Innlandet,2021-01-14,958,0,4832,0,1.30382106998594,0.0,958,4832,fhi:git
county,Innlandet,2021-01-15,281,0,5113,0,1.3796434459516,0.0,281,5113,fhi:git
county,Innlandet,2021-01-16,4,0,5117,0,1.3807227680294,0.0,4,5117,fhi:git
county,Innlandet,2021-01-17,0,0,5117,0,1.3807227680294,0.0,0,5117,fhi:git
county,Innlandet,2021-01-18,61,0,5178,0,1.3971824297159,0.0,61,5178,fhi:git
county,Innlandet,2021-01-19,331,318,5509,318,1.48649633165409,0.0858061051853331,649,5827,fhi:git
county,Innlandet,2021-01-20,663,252,6172,570,1.66539396604992,0.153803396086918,915,6742,fhi:git
county,Innlandet,2021-01-21,834,48,7006,618,1.89043261927184,0.166755261020553,882,7624,fhi:git
county,Innlandet,2021-01-22,239,0,7245,618,1.95492211342056,0.166755261020553,239,7863,fhi:git
county,Innlandet,2021-01-23,6,0,7251,618,1.95654109653727,0.166755261020553,6,7869,fhi:git
county,Innlandet,2021-01-24,0,0,7251,618,1.95654109653727,0.166755261020553,0,7869,fhi:git
county,Innlandet,2021-01-25,1,0,7252,618,1.95681092705672,0.166755261020553,1,7870,fhi:git
county,Innlandet,2021-01-26,152,130,7404,748,1.99782516601323,0.201833228549148,282,8152,fhi:git
county,Innlandet,2021-01-27,934,604,8338,1352,2.24984687118021,0.364810862297391,1538,9690,fhi:git
county,Innlandet,2021-01-28,903,707,9241,2059,2.49350383024422,0.555581039549059,1610,11300,fhi:git
county,Innlandet,2021-01-29,318,132,9559,2191,2.57930993542956,0.591198668116556,450,11750,fhi:git
county,Innlandet,2021-01-30,2,0,9561,2191,2.57984959646846,0.591198668116556,2,11752,fhi:git
county,Innlandet,2021-01-31,1,0,9562,2191,2.58011942698791,0.591198668116556,1,11753,fhi:git
county,Innlandet,2021-02-01,9,49,9571,2240,2.58254790166297,0.604420363569642,58,11811,fhi:git
county,Innlandet,2021-02-02,611,341,10182,2581,2.74741434904736,0.696432570702342,952,12763,fhi:git
county,Innlandet,2021-02-03,2312,873,12494,3454,3.37126251001746,0.931994614182832,3185,15948,fhi:git
county,Innlandet,2021-02-04,2657,1000,15151,4454,4.08820220019806,1.20182513363356,3657,19605,fhi:git
county,Innlandet,2021-02-05,814,272,15965,4726,4.30784424303095,1.27521903492416,1086,20691,fhi:git
county,Innlandet,2021-02-06,8,4,15973,4730,4.31000288718656,1.27629835700197,12,20703,fhi:git
county,Innlandet,2021-02-07,0,0,15973,4730,4.31000288718656,1.27629835700197,0,20703,fhi:git
county,Innlandet,2021-02-08,2,61,15975,4791,4.31054254822546,1.29275801868846,63,20766,fhi:git
county,Innlandet,2021-02-09,258,269,16233,5060,4.38015882224375,1.36534242842071,527,21293,fhi:git
county,Innlandet,2021-02-10,2057,591,18290,5651,4.93520020075391,1.52481226541609,2648,23941,fhi:git
county,Innlandet,2021-02-11,2240,848,20530,6499,5.53962056432355,1.75362854591031,3088,27029,fhi:git
county,Innlandet,2021-02-12,430,283,20960,6782,5.65564768768736,1.82999058291487,713,27742,fhi:git
county,Innlandet,2021-02-13,0,5,20960,6787,5.65564768768736,1.83133973551212,5,27747,fhi:git
county,Innlandet,2021-02-14,1,1,20961,6788,5.65591751820681,1.83160956603158,2,27749,fhi:git
county,Innlandet,2021-02-15,86,14,21047,6802,5.67912294287958,1.83538719330389,100,27849,fhi:git
county,Innlandet,2021-02-16,613,92,21660,6894,5.84452905130288,1.86021160109335,705,28554,fhi:git
county,Innlandet,2021-02-17,1574,783,23234,7677,6.26924228891833,2.07148889782328,2357,30911,fhi:git
county,Innlandet,2021-02-18,1464,904,24698,8581,6.6642741693942,2.31541568740674,2368,33279,fhi:git
county,Innlandet,2021-02-19,540,295,25238,8876,6.8099826498976,2.39501569064471,835,34114,fhi:git
county,Innlandet,2021-02-20,0,3,25238,8879,6.8099826498976,2.39582518220306,3,34117,fhi:git
county,Innlandet,2021-02-21,0,1,25238,8880,6.8099826498976,2.39609501272251,1,34118,fhi:git
county,Innlandet,2021-02-22,284,3,25522,8883,6.88661451742161,2.39690450428086,287,34405,fhi:git
county,Innlandet,2021-02-23,319,307,25841,9190,6.97269045312639,2.47974247375224,626,35031,fhi:git
county,Innlandet,2021-02-24,857,2320,26698,11510,7.20393520829567,3.10574927887794,3177,38208,fhi:git
county,Innlandet,2021-02-25,1752,2477,28450,13987,7.67667827837335,3.7741194755574,4229,42437,fhi:git
county,Innlandet,2021-02-26,677,814,29127,14801,7.8593535400415,3.9937615183903,1491,43928,fhi:git
county,Innlandet,2021-02-27,3,1,29130,14802,7.86016303159985,3.99403134890975,4,43932,fhi:git
county,Innlandet,2021-02-28,3,6,29133,14808,7.8609725231582,3.99565033202645,9,43941,fhi:git
county,Innlandet,2021-03-01,189,7,29322,14815,7.91197049133439,3.99753914566261,196,44137,fhi:git
county,Innlandet,2021-03-02,529,160,29851,14975,8.05471083612383,4.04071202877473,689,44826,fhi:git
county,Innlandet,2021-03-03,1600,1976,31451,16951,8.486439667245,4.57389713520938,3576,48402,fhi:git
county,Innlandet,2021-03-04,1518,2292,32969,19243,8.89604239577122,5.19234868579046,3810,52212,fhi:git
county,Innlandet,2021-03-05,549,421,33518,19664,9.04417935094967,5.30594733447921,970,53182,fhi:git
county,Innlandet,2021-03-06,7,4,33525,19668,9.04606816458582,5.30702665655702,11,53193,fhi:git
county,Innlandet,2021-03-07,0,0,33525,19668,9.04606816458582,5.30702665655702,0,53193,fhi:git
county,Innlandet,2021-03-08,111,0,33636,19668,9.07601935224485,5.30702665655702,111,53304,fhi:git
county,Innlandet,2021-03-09,938,311,34574,19979,9.32912037948964,5.39094394810619,1249,54553,fhi:git
county,Innlandet,2021-03-10,2032,1306,36606,21285,9.87741599501353,5.74334260650885,3338,57891,fhi:git
county,Innlandet,2021-03-11,1016,971,37622,22256,10.1515638027755,6.00534804089551,1987,59878,fhi:git
county,Innlandet,2021-03-12,45,180,37667,22436,10.1637061761508,6.05391753439665,225,60103,fhi:git
county,Innlandet,2021-03-13,0,0,37667,22436,10.1637061761508,6.05391753439665,0,60103,fhi:git
county,Innlandet,2021-03-14,0,7,37667,22443,10.1637061761508,6.0558063480328,7,60110,fhi:git
county,Innlandet,2021-03-15,25,3,37692,22446,10.170451939137,6.05661583959115,28,60138,fhi:git
county,Innlandet,2021-03-16,364,9,38056,22455,10.2686702482171,6.05904431426621,373,60511,fhi:git
county,Innlandet,2021-03-17,1805,158,39861,22613,10.7557143358257,6.10167753633943,1963,62474,fhi:git
county,Innlandet,2021-03-18,1650,106,41511,22719,11.2009346929194,6.1302795714012,1756,64230,fhi:git
county,Innlandet,2021-03-19,190,22,41701,22741,11.252202491615,6.13621584282912,212,64442,fhi:git
county,Innlandet,2021-03-20,0,0,41701,22741,11.252202491615,6.13621584282912,0,64442,fhi:git
county,Innlandet,2021-03-21,1,0,41702,22741,11.2524723221345,6.13621584282912,1,64443,fhi:git
county,Innlandet,2021-03-22,99,9,41801,22750,11.2791855435601,6.13864431750418,108,64551,fhi:git
county,Innlandet,2021-03-23,811,51,42612,22801,11.4980180948346,6.15240567399616,862,65413,fhi:git
county,Innlandet,2021-03-24,3249,527,45861,23328,12.3746974525301,6.2946063577467,3776,69189,fhi:git
county,Innlandet,2021-03-25,3198,321,49059,23649,13.2376154537335,6.38122195449039,3519,72708,fhi:git
county,Innlandet,2021-03-26,677,52,49736,23701,13.4202907154017,6.39525314150182,729,73437,fhi:git
county,Innlandet,2021-03-27,0,0,49736,23701,13.4202907154017,6.39525314150182,0,73437,fhi:git
county,Innlandet,2021-03-28,0,0,49736,23701,13.4202907154017,6.39525314150182,0,73437,fhi:git
county,Innlandet,2021-03-29,397,2,50133,23703,13.5274134316236,6.39579280254073,399,73836,fhi:git
county,Innlandet,2021-03-30,2887,227,53020,23930,14.3064141412779,6.45704433045604,3114,76950,fhi:git
county,Innlandet,2021-03-31,2846,566,55866,24496,15.0743517996347,6.60976840446516,3412,80362,fhi:git
county,Innlandet,2021-04-01,88,18,55954,24514,15.0980968853463,6.61462535381527,106,80468,fhi:git
county,Innlandet,2021-04-02,6,1,55960,24515,15.099715868463,6.61489518433472,7,80475,fhi:git
county,Innlandet,2021-04-03,2,6,55962,24521,15.1002555295019,6.61651416745142,8,80483,fhi:git
county,Innlandet,2021-04-04,0,0,55962,24521,15.1002555295019,6.61651416745142,0,80483,fhi:git
county,Innlandet,2021-04-05,9,2,55971,24523,15.102684004177,6.61705382849033,11,80494,fhi:git
county,Innlandet,2021-04-06,510,35,56481,24558,15.2402975690969,6.6264978966711,545,81039,fhi:git
county,Innlandet,2021-04-07,4312,91,60793,24649,16.4038067689684,6.65105247394112,4403,85442,fhi:git
county,Innlandet,2021-04-08,4576,93,65369,24742,17.638551225975,6.67614671225004,4669,90111,fhi:git
county,Innlandet,2021-04-09,1535,13,66904,24755,18.0527410733318,6.6796545090029,1548,91659,fhi:git
county,Innlandet,2021-04-10,2,0,66906,24755,18.0532807343707,6.6796545090029,2,91661,fhi:git
county,Innlandet,2021-04-11,0,0,66906,24755,18.0532807343707,6.6796545090029,0,91661,fhi:git
county,Innlandet,2021-04-12,9,11,66915,24766,18.0557092090458,6.68262264471685,20,91681,fhi:git
county,Innlandet,2021-04-13,1279,8,68194,24774,18.4008224434233,6.68478128887246,1287,92968,fhi:git
county,Innlandet,2021-04-14,4745,59,72939,24833,19.681168258217,6.70070128952005,4804,97772,fhi:git
county,Innlandet,2021-04-15,5593,111,78532,24944,21.190330353505,6.73065247717908,5704,103476,fhi:git
county,Innlandet,2021-04-16,873,33,79405,24977,21.4258923969855,6.73955688432096,906,104382,fhi:git
county,Innlandet,2021-04-17,3,0,79408,24977,21.4267018885438,6.73955688432096,3,104385,fhi:git
county,Innlandet,2021-04-18,0,0,79408,24977,21.4267018885438,6.73955688432096,0,104385,fhi:git
county,Innlandet,2021-04-19,66,7,79474,24984,21.4445107028276,6.74144569795711,73,104458,fhi:git
county,Innlandet,2021-04-20,1399,15,80873,24999,21.8220035995391,6.74549315574888,1414,105872,fhi:git
county,Innlandet,2021-04-21,4195,153,85068,25152,22.953942628635,6.78677722522484,4348,110220,fhi:git
county,Innlandet,2021-04-22,4782,54,89850,25206,24.2442721726484,6.80134807327518,4836,115056,fhi:git
county,Innlandet,2021-04-23,681,11,90531,25217,24.4280267563943,6.80431620898913,692,115748,fhi:git
county,Innlandet,2021-04-24,62,0,90593,25217,24.4447562486003,6.80431620898913,62,115810,fhi:git
county,Innlandet,2021-04-25,0,0,90593,25217,24.4447562486003,6.80431620898913,0,115810,fhi:git
county,Innlandet,2021-04-26,13,15,90606,25232,24.4482640453531,6.8083636667809,28,115838,fhi:git
county,Innlandet,2021-04-27,1408,284,92014,25516,24.8281854167398,6.8849955343049,1692,117530,fhi:git
county,Møre og Romsdal,2020-12-27,0,0,0,0,0.0,0.0,0,0,fhi:git
county,Møre og Romsdal,2020-12-28,1,0,1,0,0.0003770198840286,0.0,1,1,fhi:git
county,Møre og Romsdal,2020-12-29,0,0,1,0,0.0003770198840286,0.0,0,1,fhi:git
county,Møre og Romsdal,2020-12-30,0,0,1,0,0.0003770198840286,0.0,0,1,fhi:git
county,Møre og Romsdal,2020-12-31,0,0,1,0,0.0003770198840286,0.0,0,1,fhi:git
county,Møre og Romsdal,2021-01-01,0,0,1,0,0.0003770198840286,0.0,0,1,fhi:git
county,Møre og Romsdal,2021-01-02,0,0,1,0,0.0003770198840286,0.0,0,1,fhi:git
county,Møre og Romsdal,2021-01-03,0,0,1,0,0.0003770198840286,0.0,0,1,fhi:git
county,Møre og Romsdal,2021-01-04,0,0,1,0,0.0003765854246377,0.0,0,1,fhi:git
county,Møre og Romsdal,2021-01-05,186,0,187,0,0.0704214744072545,0.0,186,187,fhi:git
county,Møre og Romsdal,2021-01-06,496,0,683,0,0.257207845027566,0.0,496,683,fhi:git
county,Møre og Romsdal,2021-01-07,457,0,1140,0,0.429307384087006,0.0,457,1140,fhi:git
county,Møre og Romsdal,2021-01-08,36,0,1176,0,0.442864459373964,0.0,36,1176,fhi:git
county,Møre og Romsdal,2021-01-09,1,0,1177,0,0.443241044798602,0.0,1,1177,fhi:git
county,Møre og Romsdal,2021-01-10,0,0,1177,0,0.443241044798602,0.0,0,1177,fhi:git
county,Møre og Romsdal,2021-01-11,1,0,1178,0,0.44361763022324,0.0,1,1178,fhi:git
county,Møre og Romsdal,2021-01-12,225,0,1403,0,0.528349350766728,0.0,225,1403,fhi:git
county,Møre og Romsdal,2021-01-13,388,0,1791,0,0.674464495526165,0.0,388,1791,fhi:git
county,Møre og Romsdal,2021-01-14,410,0,2201,0,0.828864519627632,0.0,410,2201,fhi:git
county,Møre og Romsdal,2021-01-15,150,0,2351,0,0.885352333323291,0.0,150,2351,fhi:git
county,Møre og Romsdal,2021-01-16,1,0,2352,0,0.885728918747929,0.0,1,2352,fhi:git
county,Møre og Romsdal,2021-01-17,2,0,2354,0,0.886482089597204,0.0,2,2354,fhi:git
county,Møre og Romsdal,2021-01-18,11,0,2365,0,0.890624529268219,0.0,11,2365,fhi:git
county,Møre og Romsdal,2021-01-19,203,0,2568,0,0.967071370469677,0.0,203,2568,fhi:git
county,Møre og Romsdal,2021-01-20,500,0,3068,0,1.15536408278854,0.0,500,3068,fhi:git
county,Møre og Romsdal,2021-01-21,800,0,3868,0,1.45663242249872,0.0,800,3868,fhi:git
county,Møre og Romsdal,2021-01-22,212,0,4080,0,1.53646853252192,0.0,212,4080,fhi:git
county,Møre og Romsdal,2021-01-23,0,0,4080,0,1.53646853252192,0.0,0,4080,fhi:git
county,Møre og Romsdal,2021-01-24,0,0,4080,0,1.53646853252192,0.0,0,4080,fhi:git
county,Møre og Romsdal,2021-01-25,3,0,4083,0,1.53759828879583,0.0,3,4083,fhi:git
county,Møre og Romsdal,2021-01-26,78,129,4161,129,1.56697195191757,0.0485795197782665,207,4290,fhi:git
county,Møre og Romsdal,2021-01-27,543,358,4704,487,1.77145783749586,0.183397101798572,901,5191,fhi:git
county,Møre og Romsdal,2021-01-28,492,509,5196,996,1.95673786641762,0.375079082939174,1001,6192,fhi:git
county,Møre og Romsdal,2021-01-29,99,78,5295,1074,1.99401982345675,0.404452746060916,177,6369,fhi:git
county,Møre og Romsdal,2021-01-30,0,1,5295,1075,1.99401982345675,0.404829331485554,1,6370,fhi:git
county,Møre og Romsdal,2021-01-31,1,0,5296,1075,1.99439640888139,0.404829331485554,1,6371,fhi:git
county,Møre og Romsdal,2021-02-01,0,0,5296,1075,1.99439640888139,0.404829331485554,0,6371,fhi:git
county,Møre og Romsdal,2021-02-02,291,193,5587,1268,2.10398276745097,0.477510318440635,484,6855,fhi:git
county,Møre og Romsdal,2021-02-03,1064,312,6651,1580,2.50466965926551,0.595004970927605,1376,8231,fhi:git
county,Møre og Romsdal,2021-02-04,1546,463,8197,2043,3.08687072575543,0.769364022534872,2009,10240,fhi:git
county,Møre og Romsdal,2021-02-05,218,154,8415,2197,3.16896634832645,0.827358177929082,372,10612,fhi:git
county,Møre og Romsdal,2021-02-06,1,2,8416,2199,3.16934293375109,0.828111348778357,3,10615,fhi:git
county,Møre og Romsdal,2021-02-07,0,1,8416,2200,3.16934293375109,0.828487934202995,1,10616,fhi:git
county,Møre og Romsdal,2021-02-08,1,2,8417,2202,3.16971951917573,0.82924110505227,3,10619,fhi:git
county,Møre og Romsdal,2021-02-09,334,183,8751,2385,3.29549905100473,0.898156237760974,517,11136,fhi:git
county,Møre og Romsdal,2021-02-10,1265,435,10016,2820,3.77187961317145,1.06197089747838,1700,12836,fhi:git
county,Møre og Romsdal,2021-02-11,1255,805,11271,3625,4.2444943210918,1.36512216431175,2060,14896,fhi:git
county,Møre og Romsdal,2021-02-12,295,207,11566,3832,4.35558702135993,1.44307534721176,502,15398,fhi:git
county,Møre og Romsdal,2021-02-13,24,0,11590,3832,4.36462507155123,1.44307534721176,24,15422,fhi:git
county,Møre og Romsdal,2021-02-14,0,0,11590,3832,4.36462507155123,1.44307534721176,0,15422,fhi:git
county,Møre og Romsdal,2021-02-15,1,8,11591,3840,4.36500165697587,1.44608803060886,9,15431,fhi:git
county,Møre og Romsdal,2021-02-16,354,58,11945,3898,4.49831289729762,1.46792998523785,412,15843,fhi:git
county,Møre og Romsdal,2021-02-17,1208,427,13153,4325,4.95322809025999,1.62873196155816,1635,17478,fhi:git
county,Møre og Romsdal,2021-02-18,1165,522,14318,4847,5.39195010996294,1.82530955321905,1687,19165,fhi:git
county,Møre og Romsdal,2021-02-19,499,94,14817,4941,5.57986623685717,1.860708583135,593,19758,fhi:git
county,Møre og Romsdal,2021-02-20,11,0,14828,4941,5.58400867652818,1.860708583135,11,19769,fhi:git
county,Møre og Romsdal,2021-02-21,0,1,14828,4942,5.58400867652818,1.86108516855964,1,19770,fhi:git
county,Møre og Romsdal,2021-02-22,15,0,14843,4942,5.58965745789775,1.86108516855964,15,19785,fhi:git
county,Møre og Romsdal,2021-02-23,393,223,15236,5165,5.73765552978038,1.94506371825385,616,20401,fhi:git
county,Møre og Romsdal,2021-02-24,729,878,15965,6043,6.01218630434128,2.27570572108577,1607,22008,fhi:git
county,Møre og Romsdal,2021-02-25,704,1478,16669,7521,6.27730244328624,2.83229897870033,2182,24190,fhi:git
county,Møre og Romsdal,2021-02-26,261,201,16930,7722,6.37559123911668,2.90799264905251,462,24652,fhi:git
county,Møre og Romsdal,2021-02-27,1,1,16931,7723,6.37596782454132,2.90836923447715,2,24654,fhi:git
county,Møre og Romsdal,2021-02-28,0,0,16931,7723,6.37596782454132,2.90836923447715,0,24654,fhi:git
county,Møre og Romsdal,2021-03-01,101,1,17032,7724,6.41400295242973,2.90874581990179,102,24756,fhi:git
county,Møre og Romsdal,2021-03-02,742,259,17774,7983,6.69342933751092,3.00628144488296,1001,25757,fhi:git
county,Møre og Romsdal,2021-03-03,870,1134,18644,9117,7.02105865694574,3.43332931642214,2004,27761,fhi:git
county,Møre og Romsdal,2021-03-04,1000,1310,19644,10427,7.39764408158347,3.92665622269756,2310,30071,fhi:git
county,Møre og Romsdal,2021-03-05,813,275,20457,10702,7.70380803181394,4.03021721447293,1088,31159,fhi:git
county,Møre og Romsdal,2021-03-06,3,6,20460,10708,7.70493778808785,4.03247672702076,9,31168,fhi:git
county,Møre og Romsdal,2021-03-07,0,0,20460,10708,7.70493778808785,4.03247672702076,0,31168,fhi:git
county,Møre og Romsdal,2021-03-08,158,0,20618,10708,7.76443828518061,4.03247672702076,158,31326,fhi:git
county,Møre og Romsdal,2021-03-09,672,239,21290,10947,8.01750369053716,4.12248064350917,911,32237,fhi:git
county,Møre og Romsdal,2021-03-10,1283,950,22573,11897,8.50066279034736,4.48023679691501,2233,34470,fhi:git
county,Møre og Romsdal,2021-03-11,540,974,23113,12871,8.70401891965173,4.84703100051216,1514,35984,fhi:git
county,Møre og Romsdal,2021-03-12,66,249,23179,13120,8.72887355767782,4.94080077124695,315,36299,fhi:git
county,Møre og Romsdal,2021-03-13,1,16,23180,13136,8.72925014310246,4.94682613804115,17,36316,fhi:git
county,Møre og Romsdal,2021-03-14,0,0,23180,13136,8.72925014310246,4.94682613804115,0,36316,fhi:git
county,Møre og Romsdal,2021-03-15,0,1,23180,13137,8.72925014310246,4.94720272346579,1,36317,fhi:git
county,Møre og Romsdal,2021-03-16,335,11,23515,13148,8.8554062603561,4.95134516313681,346,36663,fhi:git
county,Møre og Romsdal,2021-03-17,1540,129,25055,13277,9.4353478142982,4.99992468291507,1669,38332,fhi:git
county,Møre og Romsdal,2021-03-18,1485,60,26540,13337,9.99457716988522,5.02251980839334,1545,39877,fhi:git
county,Møre og Romsdal,2021-03-19,208,37,26748,13374,10.0729069382099,5.03645346910493,245,40122,fhi:git
county,Møre og Romsdal,2021-03-20,18,0,26766,13374,10.0796854758533,5.03645346910493,18,40140,fhi:git
county,Møre og Romsdal,2021-03-21,0,0,26766,13374,10.0796854758533,5.03645346910493,0,40140,fhi:git
county,Møre og Romsdal,2021-03-22,1,7,26767,13381,10.080062061278,5.0390895670774,8,40148,fhi:git
county,Møre og Romsdal,2021-03-23,598,19,27365,13400,10.3052601452113,5.04624469014551,617,40765,fhi:git
county,Møre og Romsdal,2021-03-24,1811,48,29176,13448,10.9872563492303,5.06432079052812,1859,42624,fhi:git
county,Møre og Romsdal,2021-03-25,2320,71,31496,13519,11.8609345343898,5.0910583556774,2391,45015,fhi:git
county,Møre og Romsdal,2021-03-26,225,19,31721,13538,11.9456662549333,5.09821347874552,244,45259,fhi:git
county,Møre og Romsdal,2021-03-27,26,1,31747,13539,11.9554574759739,5.09859006417016,27,45286,fhi:git
county,Møre og Romsdal,2021-03-28,0,0,31747,13539,11.9554574759739,5.09859006417016,0,45286,fhi:git
county,Møre og Romsdal,2021-03-29,7,5,31754,13544,11.9580935739463,5.10047299129335,12,45298,fhi:git
county,Møre og Romsdal,2021-03-30,2233,100,33987,13644,12.7990088271624,5.13813153375712,2333,47631,fhi:git
county,Møre og Romsdal,2021-03-31,1939,214,35926,13858,13.5292079655349,5.21872081462959,2153,49784,fhi:git
county,Møre og Romsdal,2021-04-01,99,27,36025,13885,13.566489922574,5.22888862109481,126,49910,fhi:git
county,Møre og Romsdal,2021-04-02,19,3,36044,13888,13.5736450456422,5.23001837736872,22,49932,fhi:git
county,Møre og Romsdal,2021-04-03,14,0,36058,13888,13.5789172415871,5.23001837736872,14,49946,fhi:git
county,Møre og Romsdal,2021-04-04,0,0,36058,13888,13.5789172415871,5.23001837736872,0,49946,fhi:git
county,Møre og Romsdal,2021-04-05,1,0,36059,13888,13.5792938270117,5.23001837736872,1,49947,fhi:git
county,Møre og Romsdal,2021-04-06,820,49,36879,13937,13.8880938752147,5.24847106317597,869,50816,fhi:git
county,Møre og Romsdal,2021-04-07,2461,40,39340,13977,14.8148706052481,5.26353448016148,2501,53317,fhi:git
county,Møre og Romsdal,2021-04-08,3352,75,42692,14052,16.0771849486338,5.29177838700931,3427,56744,fhi:git
county,Møre og Romsdal,2021-04-09,681,27,43373,14079,16.333639622812,5.30194619347453,708,57452,fhi:git
county,Møre og Romsdal,2021-04-10,0,0,43373,14079,16.333639622812,5.30194619347453,0,57452,fhi:git
county,Møre og Romsdal,2021-04-11,0,0,43373,14079,16.333639622812,5.30194619347453,0,57452,fhi:git
county,Møre og Romsdal,2021-04-12,4,0,43377,14079,16.3351459645106,5.30194619347453,4,57456,fhi:git
county,Møre og Romsdal,2021-04-13,1334,5,44711,14084,16.8375109209773,5.30382912059772,1339,58795,fhi:git
county,Møre og Romsdal,2021-04-14,2510,14,47221,14098,17.782740336818,5.30910131654265,2524,61319,fhi:git
county,Møre og Romsdal,2021-04-15,3638,30,50859,14128,19.15275811165,5.32039887928178,3668,64987,fhi:git
county,Møre og Romsdal,2021-04-16,932,13,51791,14141,19.5037357274124,5.32529448980207,945,65932,fhi:git
county,Møre og Romsdal,2021-04-17,13,0,51804,14141,19.5086313379327,5.32529448980207,13,65945,fhi:git
county,Møre og Romsdal,2021-04-18,0,0,51804,14141,19.5086313379327,5.32529448980207,0,65945,fhi:git
county,Møre og Romsdal,2021-04-19,11,0,51815,14141,19.5127737776037,5.32529448980207,11,65956,fhi:git
county,Møre og Romsdal,2021-04-20,1354,12,53169,14153,20.0226704425632,5.32981351489772,1366,67322,fhi:git
county,Møre og Romsdal,2021-04-21,1948,24,55117,14177,20.7562588497575,5.33885156508902,1972,69294,fhi:git
county,Møre og Romsdal,2021-04-22,3232,102,58349,14279,21.9733829421866,5.37726327840207,3334,72628,fhi:git
county,Møre og Romsdal,2021-04-23,512,1,58861,14280,22.1661946796011,5.37763986382671,513,73141,fhi:git
county,Møre og Romsdal,2021-04-24,24,1,58885,14281,22.1752327297924,5.37801644925135,25,73166,fhi:git
county,Møre og Romsdal,2021-04-25,1,0,58886,14281,22.1756093152171,5.37801644925135,1,73167,fhi:git
county,Møre og Romsdal,2021-04-26,5,0,58891,14281,22.1774922423403,5.37801644925135,5,73172,fhi:git
county,Møre og Romsdal,2021-04-27,1314,324,60205,14605,22.6723254903142,5.50003012683397,1638,74810,fhi:git
county,Nordland,2020-12-27,0,0,0,0,0.0,0.0,0,0,fhi:git
county,Nordland,2020-12-28,0,0,0,0,0.0,0.0,0,0,fhi:git
county,Nordland,2020-12-29,0,0,0,0,0.0,0.0,0,0,fhi:git
county,Nordland,2020-12-30,1,0,1,0,0.0004145335461272,0.0,1,1,fhi:git
county,Nordland,2020-12-31,0,0,1,0,0.0004145335461272,0.0,0,1,fhi:git
county,Nordland,2021-01-01,0,0,1,0,0.0004145335461272,0.0,0,1,fhi:git
county,Nordland,2021-01-02,0,0,1,0,0.0004145335461272,0.0,0,1,fhi:git
county,Nordland,2021-01-03,0,0,1,0,0.0004145335461272,0.0,0,1,fhi:git
county,Nordland,2021-01-04,0,0,1,0,0.0004160685681,0.0,0,1,fhi:git
county,Nordland,2021-01-05,200,0,201,0,0.0836297821881046,0.0,200,201,fhi:git
county,Nordland,2021-01-06,686,0,887,0,0.36905281990472,0.0,686,887,fhi:git
county,Nordland,2021-01-07,238,0,1125,0,0.468077139112526,0.0,238,1125,fhi:git
county,Nordland,2021-01-08,114,0,1239,0,0.515508955875928,0.0,114,1239,fhi:git
county,Nordland,2021-01-09,0,0,1239,0,0.515508955875928,0.0,0,1239,fhi:git
county,Nordland,2021-01-10,0,0,1239,0,0.515508955875928,0.0,0,1239,fhi:git
county,Nordland,2021-01-11,0,0,1239,0,0.515508955875928,0.0,0,1239,fhi:git
county,Nordland,2021-01-12,292,0,1531,0,0.637000977761135,0.0,292,1531,fhi:git
county,Nordland,2021-01-13,625,0,2156,0,0.897043832823649,0.0,625,2156,fhi:git
county,Nordland,2021-01-14,271,0,2427,0,1.00979841477876,0.0,271,2427,fhi:git
county,Nordland,2021-01-15,69,0,2496,0,1.03850714597766,0.0,69,2496,fhi:git
county,Nordland,2021-01-16,0,0,2496,0,1.03850714597766,0.0,0,2496,fhi:git
county,Nordland,2021-01-17,1,0,2497,0,1.03892321454576,0.0,1,2497,fhi:git
county,Nordland,2021-01-18,0,0,2497,0,1.03892321454576,0.0,0,2497,fhi:git
county,Nordland,2021-01-19,313,0,2810,0,1.16915267636106,0.0,313,2810,fhi:git
county,Nordland,2021-01-20,787,0,3597,0,1.49659863945578,0.0,787,3597,fhi:git
county,Nordland,2021-01-21,618,0,4215,0,1.7537290145416,0.0,618,4215,fhi:git
county,Nordland,2021-01-22,173,0,4388,0,1.8257088768229,0.0,173,4388,fhi:git
county,Nordland,2021-01-23,4,0,4392,0,1.8273731510953,0.0,4,4392,fhi:git
county,Nordland,2021-01-24,0,0,4392,0,1.8273731510953,0.0,0,4392,fhi:git
county,Nordland,2021-01-25,51,0,4443,0,1.8485926480684,0.0,51,4443,fhi:git
county,Nordland,2021-01-26,119,90,4562,90,1.8981048076723,0.0374461711290021,209,4652,fhi:git
county,Nordland,2021-01-27,626,528,5188,618,2.15856373130292,0.257130375085814,1154,5806,fhi:git
county,Nordland,2021-01-28,472,365,5660,983,2.35494809544613,0.408995402442323,837,6643,fhi:git
county,Nordland,2021-01-29,212,144,5872,1127,2.44315463188333,0.468909276248726,356,6999,fhi:git
county,Nordland,2021-01-30,1,0,5873,1127,2.44357070045143,0.468909276248726,1,7000,fhi:git
county,Nordland,2021-01-31,0,0,5873,1127,2.44357070045143,0.468909276248726,0,7000,fhi:git
county,Nordland,2021-02-01,9,4,5882,1131,2.44731531756433,0.470573550521126,13,7013,fhi:git
county,Nordland,2021-02-02,111,200,5993,1331,2.49349892862344,0.553787264141131,311,7324,fhi:git
county,Nordland,2021-02-03,1433,458,7426,1789,3.08972518671077,0.744346668330941,1891,9215,fhi:git
county,Nordland,2021-02-04,1681,347,9107,2136,3.78913644968691,0.888722461461649,2028,11243,fhi:git
county,Nordland,2021-02-05,330,157,9437,2293,3.92643907715992,0.954045226653352,487,11730,fhi:git
county,Nordland,2021-02-06,0,0,9437,2293,3.92643907715992,0.954045226653352,0,11730,fhi:git
county,Nordland,2021-02-07,1,0,9438,2293,3.92685514572802,0.954045226653352,1,11731,fhi:git
county,Nordland,2021-02-08,7,1,9445,2294,3.92976762570472,0.954461295221452,8,11739,fhi:git
county,Nordland,2021-02-09,73,262,9518,2556,3.96014063117602,1.06347126006366,335,12074,fhi:git
county,Nordland,2021-02-10,2036,635,11554,3191,4.80725623582767,1.32767480080717,2671,14745,fhi:git
county,Nordland,2021-02-11,1224,585,12778,3776,5.31652416318209,1.57107491314569,1809,16554,fhi:git
county,Nordland,2021-02-12,286,239,13064,4015,5.4355197736587,1.67051530092159,525,17079,fhi:git
county,Nordland,2021-02-13,53,3,13117,4018,5.457571407768,1.67176350662589,56,17135,fhi:git
county,Nordland,2021-02-14,0,0,13117,4018,5.457571407768,1.67176350662589,0,17135,fhi:git
county,Nordland,2021-02-15,0,1,13117,4019,5.457571407768,1.67217957519399,1,17136,fhi:git
county,Nordland,2021-02-16,222,71,13339,4090,5.54993862988621,1.70172044352909,293,17429,fhi:git
county,Nordland,2021-02-17,1492,515,14831,4605,6.17071293349144,1.91599575610061,2007,19436,fhi:git
county,Nordland,2021-02-18,849,608,15680,5213,6.52395514780836,2.16896544550542,1457,20893,fhi:git
county,Nordland,2021-02-19,306,231,15986,5444,6.65127212964697,2.26507728473653,537,21430,fhi:git
county,Nordland,2021-02-20,1,1,15987,5445,6.65168819821507,2.26549335330462,2,21432,fhi:git
county,Nordland,2021-02-21,0,0,15987,5445,6.65168819821507,2.26549335330462,0,21432,fhi:git
county,Nordland,2021-02-22,270,0,16257,5445,6.76402671160207,2.26549335330462,270,21702,fhi:git
county,Nordland,2021-02-23,308,56,16565,5501,6.89217583057688,2.28879319311823,364,22066,fhi:git
county,Nordland,2021-02-24,976,1008,17541,6509,7.2982587530425,2.70819030976305,1984,24050,fhi:git
county,Nordland,2021-02-25,599,1870,18140,8379,7.54748382533442,3.48623853211009,2469,26519,fhi:git
county,Nordland,2021-02-26,427,398,18567,8777,7.72514510391313,3.6518338222139,825,27344,fhi:git
county,Nordland,2021-02-27,1,4,18568,8781,7.72556117248123,3.6534980964863,5,27349,fhi:git
county,Nordland,2021-02-28,0,1,18568,8782,7.72556117248123,3.6539141650544,1,27350,fhi:git
county,Nordland,2021-03-01,240,0,18808,8782,7.82541762882523,3.6539141650544,240,27590,fhi:git
county,Nordland,2021-03-02,517,50,19325,8832,8.04052507853294,3.6747175934594,567,28157,fhi:git
county,Nordland,2021-03-03,619,1585,19944,10417,8.29807152218686,4.33418627389794,2204,30361,fhi:git
county,Nordland,2021-03-04,718,1388,20662,11805,8.59680875408267,4.91168944642077,2106,32467,fhi:git
county,Nordland,2021-03-05,448,340,21110,12145,8.78320747259148,5.05315275957478,788,33255,fhi:git
county,Nordland,2021-03-06,13,51,21123,12196,8.78861636397678,5.07437225654788,64,33319,fhi:git
county,Nordland,2021-03-07,0,0,21123,12196,8.78861636397678,5.07437225654788,0,33319,fhi:git
county,Nordland,2021-03-08,362,0,21485,12196,8.93923318562899,5.07437225654788,362,33681,fhi:git
county,Nordland,2021-03-09,652,51,22137,12247,9.21050989203021,5.09559175352098,703,34384,fhi:git
county,Nordland,2021-03-10,1209,1188,23346,13435,9.71353679086313,5.58988121242381,2397,36781,fhi:git
county,Nordland,2021-03-11,729,990,24075,14425,10.0168507770081,6.00178909484283,1719,38500,fhi:git
county,Nordland,2021-03-12,71,262,24146,14687,10.0463916453432,6.11079905968504,333,38833,fhi:git
county,Nordland,2021-03-13,3,2,24149,14689,10.0476398510475,6.11163119682124,5,38838,fhi:git
county,Nordland,2021-03-14,1,0,24150,14689,10.0480559196156,6.11163119682124,1,38839,fhi:git
county,Nordland,2021-03-15,0,1,24150,14690,10.0480559196156,6.11204726538934,1,38840,fhi:git
county,Nordland,2021-03-16,120,5,24270,14695,10.0979841477876,6.11412760822984,125,38965,fhi:git
county,Nordland,2021-03-17,902,64,25172,14759,10.4732779962138,6.14075599658824,966,39931,fhi:git
county,Nordland,2021-03-18,1161,75,26333,14834,10.9563336037779,6.17196113919574,1236,41167,fhi:git
county,Nordland,2021-03-19,226,28,26559,14862,11.0503651001685,6.18361105910254,254,41421,fhi:git
county,Nordland,2021-03-20,40,0,26599,14862,11.0670078428925,6.18361105910254,40,41461,fhi:git
county,Nordland,2021-03-21,0,0,26599,14862,11.0670078428925,6.18361105910254,0,41461,fhi:git
county,Nordland,2021-03-22,36,1,26635,14863,11.0819863113441,6.18402712767064,37,41498,fhi:git
county,Nordland,2021-03-23,559,8,27194,14871,11.314568640912,6.18735567621544,567,42065,fhi:git
county,Nordland,2021-03-24,2192,49,29386,14920,12.2265909421873,6.20774303605234,2241,44306,fhi:git
county,Nordland,2021-03-25,1594,70,30980,14990,12.8898042397387,6.23686783581934,1664,45970,fhi:git
county,Nordland,2021-03-26,342,12,31322,15002,13.0320996900289,6.24186065863654,354,46324,fhi:git
county,Nordland,2021-03-27,0,0,31322,15002,13.0320996900289,6.24186065863654,0,46324,fhi:git
county,Nordland,2021-03-28,0,0,31322,15002,13.0320996900289,6.24186065863654,0,46324,fhi:git
county,Nordland,2021-03-29,9,1,31331,15003,13.0358443071418,6.24227672720464,10,46334,fhi:git
county,Nordland,2021-03-30,1572,128,32903,15131,13.6899040961951,6.29553350392145,1700,48034,fhi:git
county,Nordland,2021-03-31,1158,311,34061,15442,14.1717114980549,6.42493082860055,1469,49503,fhi:git
county,Nordland,2021-04-01,227,164,34288,15606,14.2661590630136,6.49316607376896,391,49894,fhi:git
county,Nordland,2021-04-02,99,10,34387,15616,14.3073498512555,6.49732675944996,109,50003,fhi:git
county,Nordland,2021-04-03,0,0,34387,15616,14.3073498512555,6.49732675944996,0,50003,fhi:git
county,Nordland,2021-04-04,0,0,34387,15616,14.3073498512555,6.49732675944996,0,50003,fhi:git
county,Nordland,2021-04-05,0,0,34387,15616,14.3073498512555,6.49732675944996,0,50003,fhi:git
county,Nordland,2021-04-06,469,13,34856,15629,14.5024860096944,6.50273565083526,482,50485,fhi:git
county,Nordland,2021-04-07,3184,80,38040,15709,15.8272483305249,6.53602113628326,3264,53749,fhi:git
county,Nordland,2021-04-08,2298,423,40338,16132,16.7833739000187,6.71201814058957,2721,56470,fhi:git
county,Nordland,2021-04-09,699,28,41037,16160,17.0742058291206,6.72366806049637,727,57197,fhi:git
county,Nordland,2021-04-10,0,0,41037,16160,17.0742058291206,6.72366806049637,0,57197,fhi:git
county,Nordland,2021-04-11,1,0,41038,16160,17.0746218976887,6.72366806049637,1,57198,fhi:git
county,Nordland,2021-04-12,3,27,41041,16187,17.075870103393,6.73490191183507,30,57228,fhi:git
county,Nordland,2021-04-13,955,9,41996,16196,17.4732155859286,6.73864652894797,964,58192,fhi:git
county,Nordland,2021-04-14,3831,29,45827,16225,19.0671742703197,6.75071251742287,3860,62052,fhi:git
county,Nordland,2021-04-15,2582,31,48409,16256,20.141463313154,6.76361064303397,2613,64665,fhi:git
county,Nordland,2021-04-16,798,27,49207,16283,20.4734860304978,6.77484449437267,825,65490,fhi:git
county,Nordland,2021-04-17,0,0,49207,16283,20.4734860304978,6.77484449437267,0,65490,fhi:git
county,Nordland,2021-04-18,0,0,49207,16283,20.4734860304978,6.77484449437267,0,65490,fhi:git
county,Nordland,2021-04-19,119,7,49326,16290,20.5229981901017,6.77775697434937,126,65616,fhi:git
county,Nordland,2021-04-20,863,34,50189,16324,20.8820653643721,6.79190330566477,897,66513,fhi:git
county,Nordland,2021-04-21,3840,60,54029,16384,22.4797686658761,6.81686741975078,3900,70413,fhi:git
county,Nordland,2021-04-22,2580,58,56609,16442,23.5532255715742,6.84099939670058,2638,73051,fhi:git
county,Nordland,2021-04-23,562,8,57171,16450,23.7870561068464,6.84432794524538,570,73621,fhi:git
county,Nordland,2021-04-24,0,0,57171,16450,23.7870561068464,6.84432794524538,0,73621,fhi:git
county,Nordland,2021-04-25,0,0,57171,16450,23.7870561068464,6.84432794524538,0,73621,fhi:git
county,Nordland,2021-04-26,47,160,57218,16610,23.8066113295471,6.91089891614138,207,73828,fhi:git
county,Nordland,2021-04-27,248,48,57466,16658,23.9097963344359,6.93087020741018,296,74124,fhi:git
county,Oslo,2020-12-27,5,0,5,0,0.0007209867713347,0.0,5,5,fhi:git
county,Oslo,2020-12-28,264,0,269,0,0.0387890882978079,0.0,264,269,fhi:git
county,Oslo,2020-12-29,118,0,387,0,0.0558043761013073,0.0,118,387,fhi:git
county,Oslo,2020-12-30,58,0,445,0,0.06416782264879,0.0,58,445,fhi:git
county,Oslo,2020-12-31,6,0,451,0,0.0650330067743917,0.0,6,451,fhi:git
county,Oslo,2021-01-01,6,0,457,0,0.0658981908999934,0.0,6,457,fhi:git
county,Oslo,2021-01-02,0,0,457,0,0.0658981908999934,0.0,0,457,fhi:git
county,Oslo,2021-01-03,0,0,457,0,0.0658981908999934,0.0,0,457,fhi:git
county,Oslo,2021-01-04,0,0,457,0,0.0655657738052539,0.0,0,457,fhi:git
county,Oslo,2021-01-05,482,0,939,0,0.134718296724581,0.0,482,939,fhi:git
county,Oslo,2021-01-06,603,0,1542,0,0.221230685356021,0.0,603,1542,fhi:git
county,Oslo,2021-01-07,967,0,2509,0,0.359966141088363,0.0,967,2509,fhi:git
county,Oslo,2021-01-08,450,0,2959,0,0.424527625141677,0.0,450,2959,fhi:git
county,Oslo,2021-01-09,129,0,3088,0,0.443035250570293,0.0,129,3088,fhi:git
county,Oslo,2021-01-10,100,0,3188,0,0.457382247026585,0.0,100,3188,fhi:git
county,Oslo,2021-01-11,78,0,3266,0,0.468572904262493,0.0,78,3266,fhi:git
county,Oslo,2021-01-12,241,0,3507,0,0.503149165722156,0.0,241,3507,fhi:git
county,Oslo,2021-01-13,491,0,3998,0,0.573592918322549,0.0,491,3998,fhi:git
county,Oslo,2021-01-14,1239,0,5237,0,0.751352204416006,0.0,1239,5237,fhi:git
county,Oslo,2021-01-15,1636,0,6873,0,0.986069066440941,0.0,1636,6873,fhi:git
county,Oslo,2021-01-16,643,0,7516,0,1.0783202536549,0.0,643,7516,fhi:git
county,Oslo,2021-01-17,276,5,7792,5,1.11791796387426,0.0007173498228145,281,7797,fhi:git
county,Oslo,2021-01-18,761,231,8553,236,1.22709860690664,0.0338589116368488,992,8789,fhi:git
county,Oslo,2021-01-19,810,70,9363,306,1.34330927820261,0.0439018091562531,880,9669,fhi:git
county,Oslo,2021-01-20,993,99,10356,405,1.48577495301359,0.0581053356479821,1092,10761,fhi:git
county,Oslo,2021-01-21,1019,21,11375,426,1.6319708469032,0.0611182049038034,1040,11801,fhi:git
county,Oslo,2021-01-22,671,6,12046,432,1.72823919312492,0.0619790246911809,677,12478,fhi:git
county,Oslo,2021-01-23,232,0,12278,432,1.76152422490352,0.0619790246911809,232,12710,fhi:git
county,Oslo,2021-01-24,67,0,12345,432,1.77113671252923,0.0619790246911809,67,12777,fhi:git
county,Oslo,2021-01-25,258,0,12603,432,1.80815196338647,0.0619790246911809,258,13035,fhi:git
county,Oslo,2021-01-26,312,406,12915,838,1.8529145923301,0.120227830303726,718,13753,fhi:git
county,Oslo,2021-01-27,1100,528,14015,1366,2.01073155334931,0.195979971592947,1628,15381,fhi:git
county,Oslo,2021-01-28,870,846,14885,2212,2.13555042251905,0.317355561613176,1716,17097,fhi:git
county,Oslo,2021-01-29,431,504,15316,2716,2.19738597724566,0.389664423752887,935,18032,fhi:git
county,Oslo,2021-01-30,93,154,15409,2870,2.21072868395001,0.411758798295577,247,18279,fhi:git
county,Oslo,2021-01-31,63,46,15472,2916,2.21976729171748,0.418358416665471,109,18388,fhi:git
county,Oslo,2021-02-01,53,48,15525,2964,2.22737119983931,0.425244974964491,101,18489,fhi:git
county,Oslo,2021-02-02,1521,150,17046,3114,2.44558901593951,0.446765469648929,1671,20160,fhi:git
county,Oslo,2021-02-03,2456,458,19502,3572,2.79795124890604,0.512474713418746,2914,23074,fhi:git
county,Oslo,2021-02-04,2051,1234,21553,4806,3.09220814622459,0.689516649689388,3285,26359,fhi:git
county,Oslo,2021-02-05,1383,1570,22936,6376,3.2906271072151,0.91476449405317,2953,29312,fhi:git
county,Oslo,2021-02-06,244,631,23180,7007,3.32563377856846,1.00529404169237,875,30187,fhi:git
county,Oslo,2021-02-07,215,271,23395,7278,3.35647982094948,1.04417440208892,486,30673,fhi:git
county,Oslo,2021-02-08,45,444,23440,7722,3.36293596935482,1.10787506635486,489,31162,fhi:git
county,Oslo,2021-02-09,1162,245,24602,7967,3.52964806817693,1.14302520767277,1407,32569,fhi:git
county,Oslo,2021-02-10,1830,813,26432,8780,3.79219810332707,1.25966628886243,2643,35212,fhi:git
county,Oslo,2021-02-11,1585,744,28017,9524,4.0195979971593,1.36640794249724,2329,37541,fhi:git
county,Oslo,2021-02-12,1359,425,29376,9949,4.2145736790003,1.42738267743648,1784,39325,fhi:git
county,Oslo,2021-02-13,274,193,29650,10142,4.25388444929054,1.45507238059712,467,39792,fhi:git
county,Oslo,2021-02-14,102,0,29752,10142,4.26851838567596,1.45507238059712,102,39894,fhi:git
county,Oslo,2021-02-15,277,445,30029,10587,4.30825956585989,1.51891651482762,722,40616,fhi:git
county,Oslo,2021-02-16,725,774,30754,11361,4.412275290168,1.62996226739932,1499,42115,fhi:git
county,Oslo,2021-02-17,1423,1149,32177,12510,4.61643304974104,1.79480925668211,2572,44687,fhi:git
county,Oslo,2021-02-18,1074,919,33251,13429,4.77051979168161,1.92665815411544,1993,46680,fhi:git
county,Oslo,2021-02-19,1494,974,34745,14403,4.98486391873861,2.06639789959972,2468,49148,fhi:git
county,Oslo,2021-02-20,101,115,34846,14518,4.99935438515947,2.08289694552445,216,49364,fhi:git
county,Oslo,2021-02-21,4,63,34850,14581,4.99992826501772,2.09193555329192,67,49431,fhi:git
county,Oslo,2021-02-22,602,112,35452,14693,5.0862971836846,2.10800418932297,714,50145,fhi:git
county,Oslo,2021-02-23,341,1528,35793,16221,5.13522044160055,2.32722629517511,1869,52014,fhi:git
county,Oslo,2021-02-24,707,2342,36500,18563,5.23665370654654,2.66323295218146,3049,55063,fhi:git
county,Oslo,2021-02-25,603,1978,37103,20541,5.32316609517797,2.94701654208691,2581,57644,fhi:git
county,Oslo,2021-02-26,782,1377,37885,21918,5.43535960746618,3.14457468329005,2159,59803,fhi:git
county,Oslo,2021-02-27,260,104,38145,22022,5.47266179825254,3.1594955596046,364,60167,fhi:git
county,Oslo,2021-02-28,102,62,38247,22084,5.48729573463795,3.1683906974075,164,60331,fhi:git
county,Oslo,2021-03-01,1045,39,39292,22123,5.6372218476062,3.17398602602545,1084,61415,fhi:git
county,Oslo,2021-03-02,772,136,40064,22259,5.74798066024878,3.19349794120601,908,62323,fhi:git
county,Oslo,2021-03-03,1355,172,41419,22431,5.94238246223153,3.21817477511083,1527,63850,fhi:git
county,Oslo,2021-03-04,1185,204,42604,22635,6.11239437023859,3.24744264788167,1389,65239,fhi:git
county,Oslo,2021-03-05,1307,69,43911,22704,6.29990961392233,3.25734207543651,1376,66615,fhi:git
county,Oslo,2021-03-06,114,3,44025,22707,6.3162651898825,3.2577724853302,117,66732,fhi:git
county,Oslo,2021-03-07,69,0,44094,22707,6.32616461743734,3.2577724853302,69,66801,fhi:git
county,Oslo,2021-03-08,668,11,44762,22718,6.42200255376537,3.25935065494039,679,67480,fhi:git
county,Oslo,2021-03-09,778,1326,45540,24044,6.53362218619532,3.44959182795082,2104,69584,fhi:git
county,Oslo,2021-03-10,1198,2419,46738,26463,6.7054992037417,3.79664567222852,3617,73201,fhi:git
county,Oslo,2021-03-11,885,2388,47623,28851,6.83247012237988,4.13925194760477,3273,76474,fhi:git
county,Oslo,2021-03-12,278,1639,47901,30490,6.87235477252837,4.37439921952339,1917,78391,fhi:git
county,Oslo,2021-03-13,16,266,47917,30756,6.87465029196138,4.41256223009713,282,78673,fhi:git
county,Oslo,2021-03-14,3,96,47920,30852,6.87508070185507,4.42633534669517,99,78772,fhi:git
county,Oslo,2021-03-15,24,361,47944,31213,6.87852398100458,4.47812800390238,385,79157,fhi:git
county,Oslo,2021-03-16,1003,138,48947,31351,7.02242435546119,4.49792685901207,1141,80298,fhi:git
county,Oslo,2021-03-17,2744,116,51691,31467,7.41610593822183,4.51456937490136,2860,83158,fhi:git
county,Oslo,2021-03-18,2029,125,53720,31592,7.70720649632,4.53250312047173,2154,85312,fhi:git
county,Oslo,2021-03-19,2026,187,55746,31779,7.99787664452447,4.559332003845,2213,87525,fhi:git
county,Oslo,2021-03-20,394,18,56140,31797,8.05440381056226,4.56191446320713,412,87937,fhi:git
county,Oslo,2021-03-21,163,15,56303,31812,8.07778941478602,4.56406651267557,178,88115,fhi:git
county,Oslo,2021-03-22,935,11,57238,31823,8.21193383165234,4.56564468228576,946,89061,fhi:git
county,Oslo,2021-03-23,3326,104,60564,31927,8.68911493378861,4.58056555860031,3430,92491,fhi:git
county,Oslo,2021-03-24,5132,211,65696,32138,9.42540279192551,4.61083772112308,5343,97834,fhi:git
county,Oslo,2021-03-25,5142,52,70838,32190,10.163125349708,4.61829815928035,5194,103028,fhi:git
county,Oslo,2021-03-26,4181,86,75019,32276,10.7629732715456,4.63063657623277,4267,107295,fhi:git
county,Oslo,2021-03-27,647,1,75666,32277,10.8557983386178,4.63078004619733,648,107943,fhi:git
county,Oslo,2021-03-28,151,0,75817,32277,10.8774623032668,4.63078004619733,151,108094,fhi:git
county,Oslo,2021-03-29,2189,10,78006,32287,11.191518055695,4.63221474584296,2199,110293,fhi:git
county,Oslo,2021-03-30,4364,212,82370,32499,11.8176209810476,4.6626303783303,4576,114869,fhi:git
county,Oslo,2021-03-31,4211,765,86581,33264,12.4217730018221,4.77238490122093,4976,119845,fhi:git
county,Oslo,2021-04-01,2808,294,89389,33558,12.8246366623147,4.81456507080243,3102,122947,fhi:git
county,Oslo,2021-04-02,1667,167,91056,33725,13.0638010932411,4.83852455488444,1834,124781,fhi:git
county,Oslo,2021-04-03,229,1,91285,33726,13.096655715126,4.838668024849,230,125011,fhi:git
county,Oslo,2021-04-04,373,36,91658,33762,13.150170011908,4.84383294357326,409,125420,fhi:git
county,Oslo,2021-04-05,1253,53,92911,33815,13.3299378775053,4.8514368516951,1306,126726,fhi:git
county,Oslo,2021-04-06,4552,110,97463,33925,13.9830131561958,4.86721854779702,4662,131388,fhi:git
county,Oslo,2021-04-07,6213,163,103676,34088,14.8743920460252,4.89060415202077,6376,137764,fhi:git
county,Oslo,2021-04-08,6076,146,109752,34234,15.7461155507095,4.91155076684696,6222,143986,fhi:git
county,Oslo,2021-04-09,5157,60,114909,34294,16.4859901579604,4.92015896472074,5217,149203,fhi:git
county,Oslo,2021-04-10,744,0,115653,34294,16.5927318115952,4.92015896472074,744,149947,fhi:git
county,Oslo,2021-04-11,368,7,116021,34301,16.6455287585544,4.92116325447268,375,150322,fhi:git
county,Oslo,2021-04-12,1775,4,117796,34305,16.9001879456536,4.92173713433093,1779,152101,fhi:git
county,Oslo,2021-04-13,3126,46,120922,34351,17.3486750548773,4.92833675270082,3172,155273,fhi:git
county,Oslo,2021-04-14,5581,51,126503,34402,18.1493809271029,4.93565372089353,5632,160905,fhi:git
county,Oslo,2021-04-15,5576,158,132079,34560,18.9493694495057,4.95832197529447,5734,166639,fhi:git
county,Oslo,2021-04-16,5021,271,137100,34831,19.6697321415762,4.99720233569102,5292,171931,fhi:git
county,Oslo,2021-04-17,1598,155,138698,34986,19.8989971449477,5.01944018019828,1753,173684,fhi:git
county,Oslo,2021-04-18,977,3,139675,34989,20.0391673003257,5.01987059009196,980,174664,fhi:git
county,Oslo,2021-04-19,3158,112,142833,35101,20.4922454484154,5.03593922612301,3270,177934,fhi:git
county,Oslo,2021-04-20,3173,415,146006,35516,20.9474756459735,5.09547926141662,3588,181522,fhi:git
county,Oslo,2021-04-21,4439,447,150445,35963,21.5843388186683,5.15961033557625,4886,186408,fhi:git
county,Oslo,2021-04-22,4602,401,155047,36364,22.2445875955869,5.21714179136598,5003,191411,fhi:git
county,Oslo,2021-04-23,3129,503,158176,36867,22.6935051147042,5.28930718354113,3632,195043,fhi:git
county,Oslo,2021-04-24,210,25,158386,36892,22.7236338072625,5.2928939326552,235,195278,fhi:git
county,Oslo,2021-04-25,74,0,158460,36892,22.7342505846401,5.2928939326552,74,195352,fhi:git
county,Oslo,2021-04-26,926,241,159386,37133,22.8671037718254,5.32747019411486,1167,196519,fhi:git
county,Oslo,2021-04-27,3439,1342,162825,38475,23.3604969799573,5.5200068865583,4781,201300,fhi:git
county,Rogaland,2020-12-27,0,0,0,0,0.0,0.0,0,0,fhi:git
county,Rogaland,2020-12-28,1,0,1,0,0.0002083802188825,0.0,1,1,fhi:git
county,Rogaland,2020-12-29,0,0,1,0,0.0002083802188825,0.0,0,1,fhi:git
county,Rogaland,2020-12-30,0,0,1,0,0.0002083802188825,0.0,0,1,fhi:git
county,Rogaland,2020-12-31,0,0,1,0,0.0002083802188825,0.0,0,1,fhi:git
county,Rogaland,2021-01-01,0,0,1,0,0.0002083802188825,0.0,0,1,fhi:git
county,Rogaland,2021-01-02,0,0,1,0,0.0002083802188825,0.0,0,1,fhi:git
county,Rogaland,2021-01-03,0,0,1,0,0.0002083802188825,0.0,0,1,fhi:git
county,Rogaland,2021-01-04,0,0,1,0,0.0002071916211708,0.0,0,1,fhi:git
county,Rogaland,2021-01-05,547,0,548,0,0.11354100840162,0.0,547,548,fhi:git
county,Rogaland,2021-01-06,641,0,1189,0,0.246350837572129,0.0,641,1189,fhi:git
county,Rogaland,2021-01-07,212,0,1401,0,0.290275461260347,0.0,212,1401,fhi:git
county,Rogaland,2021-01-08,20,0,1421,0,0.294419293683763,0.0,20,1421,fhi:git
county,Rogaland,2021-01-09,1,0,1422,0,0.294626485304934,0.0,1,1422,fhi:git
county,Rogaland,2021-01-10,0,0,1422,0,0.294626485304934,0.0,0,1422,fhi:git
county,Rogaland,2021-01-11,4,0,1426,0,0.295455251789618,0.0,4,1426,fhi:git
county,Rogaland,2021-01-12,117,0,1543,0,0.319696671466606,0.0,117,1543,fhi:git
county,Rogaland,2021-01-13,763,0,2306,0,0.477783878419957,0.0,763,2306,fhi:git
county,Rogaland,2021-01-14,535,0,2841,0,0.588631395746356,0.0,535,2841,fhi:git
county,Rogaland,2021-01-15,292,0,3133,0,0.649131349128241,0.0,292,3133,fhi:git
county,Rogaland,2021-01-16,0,0,3133,0,0.649131349128241,0.0,0,3133,fhi:git
county,Rogaland,2021-01-17,2,0,3135,0,0.649545732370583,0.0,2,3135,fhi:git
county,Rogaland,2021-01-18,71,0,3206,0,0.664256337473713,0.0,71,3206,fhi:git
county,Rogaland,2021-01-19,512,0,3718,0,0.770338447513183,0.0,512,3718,fhi:git
county,Rogaland,2021-01-20,659,0,4377,0,0.906877725864766,0.0,659,4377,fhi:git
county,Rogaland,2021-01-21,431,0,4808,0,0.996177314589398,0.0,431,4808,fhi:git
county,Rogaland,2021-01-22,272,0,5080,0,1.05253343554787,0.0,272,5080,fhi:git
county,Rogaland,2021-01-23,0,0,5080,0,1.05253343554787,0.0,0,5080,fhi:git
county,Rogaland,2021-01-24,0,0,5080,0,1.05253343554787,0.0,0,5080,fhi:git
county,Rogaland,2021-01-25,150,0,5230,0,1.08361217872349,0.0,150,5230,fhi:git
county,Rogaland,2021-01-26,339,380,5569,380,1.15385013830041,0.0787328160449192,719,5949,fhi:git
county,Rogaland,2021-01-27,865,603,6434,983,1.33307089061318,0.203669363610936,1468,7417,fhi:git
county,Rogaland,2021-01-28,524,283,6958,1266,1.4416393001067,0.262304592402283,807,8224,fhi:git
county,Rogaland,2021-01-29,410,22,7368,1288,1.52658786478675,0.266862808068042,432,8656,fhi:git
county,Rogaland,2021-01-30,5,1,7373,1289,1.5276238228926,0.267069999689213,6,8662,fhi:git
county,Rogaland,2021-01-31,2,0,7375,1289,1.52803820613494,0.267069999689213,2,8664,fhi:git
county,Rogaland,2021-02-01,13,6,7388,1295,1.53073169721016,0.268313149416238,19,8683,fhi:git
county,Rogaland,2021-02-02,450,78,7838,1373,1.62396792673704,0.284474095867563,528,9211,fhi:git
county,Rogaland,2021-02-03,2432,638,10270,2011,2.12785794942453,0.416662350174559,3070,12281,fhi:git
county,Rogaland,2021-02-04,1888,561,12158,2572,2.51903573019507,0.5328968496514,2449,14730,fhi:git
county,Rogaland,2021-02-05,654,282,12812,2854,2.6545390504408,0.591324886821577,936,15666,fhi:git
county,Rogaland,2021-02-06,0,0,12812,2854,2.6545390504408,0.591324886821577,0,15666,fhi:git
county,Rogaland,2021-02-07,0,1,12812,2855,2.6545390504408,0.591532078442748,1,15667,fhi:git
county,Rogaland,2021-02-08,7,71,12819,2926,2.655989391789,0.606242683545877,78,15745,fhi:git
county,Rogaland,2021-02-09,588,395,13407,3321,2.77781806503745,0.688083373908359,983,16728,fhi:git
county,Rogaland,2021-02-10,1923,685,15330,4006,3.17624755254897,0.830009634410384,2608,19336,fhi:git
county,Rogaland,2021-02-11,1182,496,16512,4502,3.42114804877291,0.932776678511121,1678,21014,fhi:git
county,Rogaland,2021-02-12,481,268,16993,4770,3.52080721855608,0.988304032984906,749,21763,fhi:git
county,Rogaland,2021-02-13,2,0,16995,4770,3.52122160179842,0.988304032984906,2,21765,fhi:git
county,Rogaland,2021-02-14,0,0,16995,4770,3.52122160179842,0.988304032984906,0,21765,fhi:git
county,Rogaland,2021-02-15,0,147,16995,4917,3.52122160179842,1.01876120129702,147,21912,fhi:git
county,Rogaland,2021-02-16,480,315,17475,5232,3.62067357996043,1.08402656196583,795,22707,fhi:git
county,Rogaland,2021-02-17,1489,783,18964,6015,3.92918190388381,1.2462576013426,2272,24979,fhi:git
county,Rogaland,2021-02-18,1102,476,20066,6491,4.15750707041407,1.34488081301992,1578,26557,fhi:git
county,Rogaland,2021-02-19,443,412,20509,6903,4.24929295859276,1.43024376094231,855,27412,fhi:git
county,Rogaland,2021-02-20,1,3,20510,6906,4.24950015021393,1.43086533580582,4,27416,fhi:git
county,Rogaland,2021-02-21,0,2,20510,6908,4.24950015021393,1.43127971904816,2,27418,fhi:git
county,Rogaland,2021-02-22,252,13,20762,6921,4.30171243874898,1.43397321012338,265,27683,fhi:git
county,Rogaland,2021-02-23,379,407,21141,7328,4.38023806317273,1.51830019993991,786,28469,fhi:git
county,Rogaland,2021-02-24,822,2171,21963,9499,4.55054957577516,1.96811320950181,2993,31462,fhi:git
county,Rogaland,2021-02-25,1231,1813,23194,11312,4.80560246143646,2.34375161868454,3044,34506,fhi:git
county,Rogaland,2021-02-26,999,677,24193,11989,5.01258689098613,2.4840203462172,1676,36182,fhi:git
county,Rogaland,2021-02-27,1,1,24194,11990,5.0127940826073,2.48422753783837,2,36184,fhi:git
county,Rogaland,2021-02-28,4,0,24198,11990,5.01362284909198,2.48422753783837,4,36188,fhi:git
county,Rogaland,2021-03-01,648,2,24846,11992,5.14788301961069,2.48464192108071,650,36838,fhi:git
county,Rogaland,2021-03-02,794,545,25640,12537,5.31239316682033,2.59756135461882,1339,38177,fhi:git
county,Rogaland,2021-03-03,1269,1460,26909,13997,5.57531933408613,2.90006112152825,2729,40906,fhi:git
county,Rogaland,2021-03-04,1090,1479,27999,15476,5.80115820116235,3.20649752923992,2569,43475,fhi:git
county,Rogaland,2021-03-05,603,424,28602,15900,5.92609474872836,3.29434677661635,1027,44502,fhi:git
county,Rogaland,2021-03-06,4,2,28606,15902,5.92692351521305,3.2947611598587,6,44508,fhi:git
county,Rogaland,2021-03-07,0,0,28606,15902,5.92692351521305,3.2947611598587,0,44508,fhi:git
county,Rogaland,2021-03-08,543,0,29149,15902,6.03942856550881,3.2947611598587,543,45051,fhi:git
county,Rogaland,2021-03-09,1575,466,30724,16368,6.36575536885288,3.39131245532431,2041,47092,fhi:git
county,Rogaland,2021-03-10,2204,1080,32928,17448,6.82240570191341,3.61507940618881,3284,50376,fhi:git
county,Rogaland,2021-03-11,1446,1059,34374,18507,7.12200478612645,3.83449533300873,2505,52881,fhi:git
county,Rogaland,2021-03-12,117,545,34491,19052,7.14624620580344,3.94741476654684,662,53543,fhi:git
county,Rogaland,2021-03-13,0,0,34491,19052,7.14624620580344,3.94741476654684,0,53543,fhi:git
county,Rogaland,2021-03-14,0,0,34491,19052,7.14624620580344,3.94741476654684,0,53543,fhi:git
county,Rogaland,2021-03-15,0,1,34491,19053,7.14624620580344,3.94762195816801,1,53544,fhi:git
county,Rogaland,2021-03-16,586,94,35077,19147,7.26766049580955,3.96709797055807,680,54224,fhi:git
county,Rogaland,2021-03-17,2396,95,37473,19242,7.76409162013488,3.9867811745693,2491,56715,fhi:git
county,Rogaland,2021-03-18,1676,83,39149,19325,8.11134477721721,4.00397807912648,1759,58474,fhi:git
county,Rogaland,2021-03-19,272,26,39421,19351,8.16770089817568,4.00936506127692,298,58772,fhi:git
county,Rogaland,2021-03-20,0,0,39421,19351,8.16770089817568,4.00936506127692,0,58772,fhi:git
county,Rogaland,2021-03-21,0,0,39421,19351,8.16770089817568,4.00936506127692,0,58772,fhi:git
county,Rogaland,2021-03-22,14,17,39435,19368,8.17060158087207,4.01288731883683,31,58803,fhi:git
county,Rogaland,2021-03-23,830,48,40265,19416,8.34257062644387,4.02283251665303,878,59681,fhi:git
county,Rogaland,2021-03-24,3406,81,43671,19497,9.04826528815175,4.03961503796787,3487,63168,fhi:git
county,Rogaland,2021-03-25,3235,166,46906,19663,9.71853018263941,4.07400884708222,3401,66569,fhi:git
county,Rogaland,2021-03-26,816,77,47722,19740,9.88759854551482,4.08996260191238,893,67462,fhi:git
county,Rogaland,2021-03-27,0,0,47722,19740,9.88759854551482,4.08996260191238,0,67462,fhi:git
county,Rogaland,2021-03-28,1,2,47723,19742,9.88780573713599,4.09037698515472,3,67465,fhi:git
county,Rogaland,2021-03-29,233,0,47956,19742,9.9360813848688,4.09037698515472,233,67698,fhi:git
county,Rogaland,2021-03-30,4268,356,52224,20098,10.8203752240259,4.16413720229154,4624,72322,fhi:git
county,Rogaland,2021-03-31,2185,621,54409,20719,11.2730889162842,4.29280319903863,2806,75128,fhi:git
county,Rogaland,2021-04-01,569,1,54978,20720,11.3909809487304,4.2930103906598,570,75698,fhi:git
county,Rogaland,2021-04-02,8,21,54986,20741,11.3926384816998,4.29736141470439,29,75727,fhi:git
county,Rogaland,2021-04-03,0,0,54986,20741,11.3926384816998,4.29736141470439,0,75727,fhi:git
county,Rogaland,2021-04-04,0,0,54986,20741,11.3926384816998,4.29736141470439,0,75727,fhi:git
county,Rogaland,2021-04-05,0,1,54986,20742,11.3926384816998,4.29756860632556,1,75728,fhi:git
county,Rogaland,2021-04-06,1374,77,56360,20819,11.6773197691885,4.31352236115572,1451,77179,fhi:git
county,Rogaland,2021-04-07,5911,118,62271,20937,12.9020294419294,4.33797097245387,6029,83208,fhi:git
county,Rogaland,2021-04-08,5155,532,67426,21469,13.970102249065,4.44819691491676,5687,88895,fhi:git
county,Rogaland,2021-04-09,1881,35,69307,21504,14.3598296884874,4.45544862165774,1916,90811,fhi:git
county,Rogaland,2021-04-10,5,1,69312,21505,14.3608656465933,4.45565581327891,6,90817,fhi:git
county,Rogaland,2021-04-11,0,0,69312,21505,14.3608656465933,4.45565581327891,0,90817,fhi:git
county,Rogaland,2021-04-12,16,13,69328,21518,14.364180712532,4.45834930435413,29,90846,fhi:git
county,Rogaland,2021-04-13,1621,35,70949,21553,14.7000383304499,4.46560101109511,1656,92502,fhi:git
county,Rogaland,2021-04-14,7568,38,78517,21591,16.2680645194708,4.4734742926996,7606,100108,fhi:git
county,Rogaland,2021-04-15,5152,81,83669,21672,17.335515751743,4.49025681401444,5233,105341,fhi:git
county,Rogaland,2021-04-16,2140,20,85809,21692,17.7789058210486,4.49440064643786,2160,107501,fhi:git
county,Rogaland,2021-04-17,1,0,85810,21692,17.7791130126698,4.49440064643786,1,107502,fhi:git
county,Rogaland,2021-04-18,0,0,85810,21692,17.7791130126698,4.49440064643786,0,107502,fhi:git
county,Rogaland,2021-04-19,28,0,85838,21692,17.7849143780626,4.49440064643786,28,107530,fhi:git
county,Rogaland,2021-04-20,1073,38,86911,21730,18.0072309875789,4.50227392804235,1111,108641,fhi:git
county,Rogaland,2021-04-21,6598,354,93509,22084,19.3742813040641,4.57561976193683,6952,115593,fhi:git
county,Rogaland,2021-04-22,5094,166,98603,22250,20.4297154223083,4.61001357105119,5260,120853,fhi:git
county,Rogaland,2021-04-23,1675,66,100278,22316,20.7767613877695,4.62368821804846,1741,122594,fhi:git
county,Rogaland,2021-04-24,0,0,100278,22316,20.7767613877695,4.62368821804846,0,122594,fhi:git
county,Rogaland,2021-04-25,0,0,100278,22316,20.7767613877695,4.62368821804846,0,122594,fhi:git
county,Rogaland,2021-04-26,10,2,100288,22318,20.7788333039812,4.6241026012908,12,122606,fhi:git
county,Rogaland,2021-04-27,989,636,101277,22954,20.9837458173191,4.75587647235546,1625,124231,fhi:git
county,Troms og Finnmark,2020-12-27,0,0,0,0,0.0,0.0,0,0,fhi:git
county,Troms og Finnmark,2020-12-28,1,0,1,0,0.0004109966257177,0.0,1,1,fhi:git
county,Troms og Finnmark,2020-12-29,0,0,1,0,0.0004109966257177,0.0,0,1,fhi:git
county,Troms og Finnmark,2020-12-30,0,0,1,0,0.0004109966257177,0.0,0,1,fhi:git
county,Troms og Finnmark,2020-12-31,0,0,1,0,0.0004109966257177,0.0,0,1,fhi:git
county,Troms og Finnmark,2021-01-01,0,0,1,0,0.0004109966257177,0.0,0,1,fhi:git
county,Troms og Finnmark,2021-01-02,0,0,1,0,0.0004109966257177,0.0,0,1,fhi:git
county,Troms og Finnmark,2021-01-03,0,0,1,0,0.0004109966257177,0.0,0,1,fhi:git
county,Troms og Finnmark,2021-01-04,0,0,1,0,0.0004129364738528,0.0,0,1,fhi:git
county,Troms og Finnmark,2021-01-05,53,0,54,0,0.0222985695880546,0.0,53,54,fhi:git
county,Troms og Finnmark,2021-01-06,530,0,584,0,0.241154900730072,0.0,530,584,fhi:git
county,Troms og Finnmark,2021-01-07,188,0,772,0,0.31878695781441,0.0,188,772,fhi:git
county,Troms og Finnmark,2021-01-08,247,0,1019,0,0.420782266856067,0.0,247,1019,fhi:git
county,Troms og Finnmark,2021-01-09,0,0,1019,0,0.420782266856067,0.0,0,1019,fhi:git
county,Troms og Finnmark,2021-01-10,0,0,1019,0,0.420782266856067,0.0,0,1019,fhi:git
county,Troms og Finnmark,2021-01-11,0,0,1019,0,0.420782266856067,0.0,0,1019,fhi:git
county,Troms og Finnmark,2021-01-12,191,0,1210,0,0.499653133361964,0.0,191,1210,fhi:git
county,Troms og Finnmark,2021-01-13,570,0,1780,0,0.735026923458095,0.0,570,1780,fhi:git
county,Troms og Finnmark,2021-01-14,331,0,2111,0,0.871708896303393,0.0,331,2111,fhi:git
county,Troms og Finnmark,2021-01-15,38,0,2149,0,0.887400482309802,0.0,38,2149,fhi:git
county,Troms og Finnmark,2021-01-16,2,0,2151,0,0.888226355257507,0.0,2,2151,fhi:git
county,Troms og Finnmark,2021-01-17,0,0,2151,0,0.888226355257507,0.0,0,2151,fhi:git
county,Troms og Finnmark,2021-01-18,0,1,2151,1,0.888226355257507,0.0004129364738528,1,2152,fhi:git
county,Troms og Finnmark,2021-01-19,251,0,2402,1,0.991873410194576,0.0004129364738528,251,2403,fhi:git
county,Troms og Finnmark,2021-01-20,923,0,3325,1,1.37301377556077,0.0004129364738528,923,3326,fhi:git
county,Troms og Finnmark,2021-01-21,248,0,3573,1,1.47542202107628,0.0004129364738528,248,3574,fhi:git
county,Troms og Finnmark,2021-01-22,82,0,3655,1,1.50928281193221,0.0004129364738528,82,3656,fhi:git
county,Troms og Finnmark,2021-01-23,12,0,3667,1,1.51423804961845,0.0004129364738528,12,3668,fhi:git
county,Troms og Finnmark,2021-01-24,0,0,3667,1,1.51423804961845,0.0004129364738528,0,3668,fhi:git
county,Troms og Finnmark,2021-01-25,6,0,3673,1,1.51671566846156,0.0004129364738528,6,3674,fhi:git
county,Troms og Finnmark,2021-01-26,85,0,3758,1,1.55181526873906,0.0004129364738528,85,3759,fhi:git
county,Troms og Finnmark,2021-01-27,668,357,4426,358,1.82765683327277,0.147831257639325,1025,4784,fhi:git
county,Troms og Finnmark,2021-01-28,234,276,4660,634,1.92428396815434,0.261801724422715,510,5294,fhi:git
county,Troms og Finnmark,2021-01-29,104,243,4764,877,1.96722936143504,0.36214528756896,347,5641,fhi:git
county,Troms og Finnmark,2021-01-30,0,0,4764,877,1.96722936143504,0.36214528756896,0,5641,fhi:git
county,Troms og Finnmark,2021-01-31,0,0,4764,877,1.96722936143504,0.36214528756896,0,5641,fhi:git
county,Troms og Finnmark,2021-02-01,0,1,4764,878,1.96722936143504,0.362558224042813,1,5642,fhi:git
county,Troms og Finnmark,2021-02-02,119,24,4883,902,2.01636880182353,0.372468699415282,143,5785,fhi:git
county,Troms og Finnmark,2021-02-03,1159,563,6042,1465,2.494962175019,0.604951934194444,1722,7507,fhi:git
county,Troms og Finnmark,2021-02-04,1149,381,7191,1846,2.96942618347593,0.762280730732384,1530,9037,fhi:git
county,Troms og Finnmark,2021-02-05,287,141,7478,1987,3.08793895147171,0.820504773545638,428,9465,fhi:git
county,Troms og Finnmark,2021-02-06,1,1,7479,1988,3.08835188794556,0.820917710019491,2,9467,fhi:git
county,Troms og Finnmark,2021-02-07,0,0,7479,1988,3.08835188794556,0.820917710019491,0,9467,fhi:git
county,Troms og Finnmark,2021-02-08,0,0,7479,1988,3.08835188794556,0.820917710019491,0,9467,fhi:git
county,Troms og Finnmark,2021-02-09,71,29,7550,2017,3.11767037758911,0.832892867761224,100,9567,fhi:git
county,Troms og Finnmark,2021-02-10,1408,812,8958,2829,3.69908493277394,1.16819728452975,2220,11787,fhi:git
county,Troms og Finnmark,2021-02-11,996,467,9954,3296,4.11036966073139,1.36103861781903,1463,13250,fhi:git
county,Troms og Finnmark,2021-02-12,293,114,10247,3410,4.23136004757028,1.40811337583826,407,13657,fhi:git
county,Troms og Finnmark,2021-02-13,5,2,10252,3412,4.23342472993955,1.40893924878597,7,13664,fhi:git
county,Troms og Finnmark,2021-02-14,0,0,10252,3412,4.23342472993955,1.40893924878597,0,13664,fhi:git
county,Troms og Finnmark,2021-02-15,0,6,10252,3418,4.23342472993955,1.41141686762908,6,13670,fhi:git
county,Troms og Finnmark,2021-02-16,133,52,10385,3470,4.28834528096198,1.43288956426943,185,13855,fhi:git
county,Troms og Finnmark,2021-02-17,968,583,11353,4053,4.68806778765155,1.67363152852565,1551,15406,fhi:git
county,Troms og Finnmark,2021-02-18,1299,261,12652,4314,5.22447226718642,1.78140794820125,1560,16966,fhi:git
county,Troms og Finnmark,2021-02-19,232,134,12884,4448,5.32027352912028,1.83674143569753,366,17332,fhi:git
county,Troms og Finnmark,2021-02-20,0,0,12884,4448,5.32027352912028,1.83674143569753,0,17332,fhi:git
county,Troms og Finnmark,2021-02-21,1,0,12885,4448,5.32068646559413,1.83674143569753,1,17333,fhi:git
county,Troms og Finnmark,2021-02-22,107,0,12992,4448,5.36487066829639,1.83674143569753,107,17440,fhi:git
county,Troms og Finnmark,2021-02-23,79,78,13071,4526,5.39749264973077,1.86895048065806,157,17597,fhi:git
county,Troms og Finnmark,2021-02-24,431,992,13502,5518,5.57546826996135,2.2785834627201,1423,19020,fhi:git
county,Troms og Finnmark,2021-02-25,568,1055,14070,6573,5.81001618710978,2.71423144263487,1623,20643,fhi:git
county,Troms og Finnmark,2021-02-26,282,405,14352,6978,5.92646427273628,2.88147071454527,687,21330,fhi:git
county,Troms og Finnmark,2021-02-27,0,0,14352,6978,5.92646427273628,2.88147071454527,0,21330,fhi:git
county,Troms og Finnmark,2021-02-28,3,0,14355,6978,5.92770308215784,2.88147071454527,3,21333,fhi:git
county,Troms og Finnmark,2021-03-01,341,0,14696,6978,6.06851441974167,2.88147071454527,341,21674,fhi:git
county,Troms og Finnmark,2021-03-02,554,72,15250,7050,6.29728122625615,2.91120214066268,626,22300,fhi:git
county,Troms og Finnmark,2021-03-03,599,1180,15849,8230,6.54463017409402,3.39846717980906,1779,24079,fhi:git
county,Troms og Finnmark,2021-03-04,882,935,16731,9165,6.90884014403224,3.78456278286148,1817,25896,fhi:git
county,Troms og Finnmark,2021-03-05,725,374,17456,9539,7.20821908757557,3.93900102408246,1099,26995,fhi:git
county,Troms og Finnmark,2021-03-06,0,1,17456,9540,7.20821908757557,3.93941396055631,1,26996,fhi:git
county,Troms og Finnmark,2021-03-07,0,0,17456,9540,7.20821908757557,3.93941396055631,0,26996,fhi:git
county,Troms og Finnmark,2021-03-08,425,0,17881,9540,7.38371708896303,3.93941396055631,425,27421,fhi:git
county,Troms og Finnmark,2021-03-09,623,51,18504,9591,7.64097651217337,3.9604737207228,674,28095,fhi:git
county,Troms og Finnmark,2021-03-10,940,701,19444,10292,8.02913679759506,4.24994218889366,1641,29736,fhi:git
county,Troms og Finnmark,2021-03-11,812,1041,20256,11333,8.36444121436358,4.67980905817449,1853,31589,fhi:git
county,Troms og Finnmark,2021-03-12,68,210,20324,11543,8.39252089458558,4.76652571768359,278,31867,fhi:git
county,Troms og Finnmark,2021-03-13,0,0,20324,11543,8.39252089458558,4.76652571768359,0,31867,fhi:git
county,Troms og Finnmark,2021-03-14,0,0,20324,11543,8.39252089458558,4.76652571768359,0,31867,fhi:git
county,Troms og Finnmark,2021-03-15,3,5,20327,11548,8.39375970400714,4.76859040005286,8,31875,fhi:git
county,Troms og Finnmark,2021-03-16,21,2,20348,11550,8.40243136995805,4.76941627300056,23,31898,fhi:git
county,Troms og Finnmark,2021-03-17,547,46,20895,11596,8.62830762115556,4.78841135079779,593,32491,fhi:git
county,Troms og Finnmark,2021-03-18,1110,122,22005,11718,9.08666710713224,4.83878960060784,1232,33723,fhi:git
county,Troms og Finnmark,2021-03-19,407,33,22412,11751,9.25473225199035,4.85241650424499,440,34163,fhi:git
county,Troms og Finnmark,2021-03-20,0,0,22412,11751,9.25473225199035,4.85241650424499,0,34163,fhi:git
county,Troms og Finnmark,2021-03-21,1,0,22413,11751,9.25514518846421,4.85241650424499,1,34164,fhi:git
county,Troms og Finnmark,2021-03-22,3,0,22416,11751,9.25638399788577,4.85241650424499,3,34167,fhi:git
county,Troms og Finnmark,2021-03-23,428,14,22844,11765,9.43312080869479,4.85819761487893,442,34609,fhi:git
county,Troms og Finnmark,2021-03-24,1876,42,24720,11807,10.2077896336428,4.87554094678075,1918,36527,fhi:git
county,Troms og Finnmark,2021-03-25,1993,38,26713,11845,11.0307720260315,4.89123253278716,2031,38558,fhi:git
county,Troms og Finnmark,2021-03-26,558,15,27271,11860,11.2611905784414,4.89742657989495,573,39131,fhi:git
county,Troms og Finnmark,2021-03-27,1,0,27272,11860,11.2616035149153,4.89742657989495,1,39132,fhi:git
county,Troms og Finnmark,2021-03-28,0,0,27272,11860,11.2616035149153,4.89742657989495,0,39132,fhi:git
county,Troms og Finnmark,2021-03-29,176,0,27448,11860,11.3342803343134,4.89742657989495,176,39308,fhi:git
county,Troms og Finnmark,2021-03-30,1621,149,29069,12009,12.0036503584289,4.95895411449903,1770,41078,fhi:git
county,Troms og Finnmark,2021-03-31,1430,291,30499,12300,12.5941495160385,5.07911862839021,1721,42799,fhi:git
county,Troms og Finnmark,2021-04-01,165,35,30664,12335,12.6622840342242,5.09357140497506,200,42999,fhi:git
county,Troms og Finnmark,2021-04-02,27,14,30691,12349,12.6734333190182,5.099352515609,41,43040,fhi:git
county,Troms og Finnmark,2021-04-03,1,0,30692,12349,12.6738462554921,5.099352515609,1,43041,fhi:git
county,Troms og Finnmark,2021-04-04,0,0,30692,12349,12.6738462554921,5.099352515609,0,43041,fhi:git
county,Troms og Finnmark,2021-04-05,0,0,30692,12349,12.6738462554921,5.099352515609,0,43041,fhi:git
county,Troms og Finnmark,2021-04-06,722,13,31414,12362,12.9719863896138,5.10472068976909,735,43776,fhi:git
county,Troms og Finnmark,2021-04-07,2672,60,34086,12422,14.0753526477487,5.12949687820026,2732,46508,fhi:git
county,Troms og Finnmark,2021-04-08,2505,320,36591,12742,15.1097585147501,5.26163654983317,2825,49333,fhi:git
county,Troms og Finnmark,2021-04-09,1994,63,38585,12805,15.9331538436127,5.2876515476859,2057,51390,fhi:git
county,Troms og Finnmark,2021-04-10,4,1,38589,12806,15.9348055895081,5.28806448415976,5,51395,fhi:git
county,Troms og Finnmark,2021-04-11,1,0,38590,12806,15.935218525982,5.28806448415976,1,51396,fhi:git
county,Troms og Finnmark,2021-04-12,4,4,38594,12810,15.9368702718774,5.28971623005517,8,51404,fhi:git
county,Troms og Finnmark,2021-04-13,505,17,39099,12827,16.1454031911731,5.29673615011067,522,51926,fhi:git
county,Troms og Finnmark,2021-04-14,3074,38,42173,12865,17.4147699117968,5.31242773611708,3112,55038,fhi:git
county,Troms og Finnmark,2021-04-15,3181,116,45354,12981,18.7283208351227,5.36032836708401,3297,58335,fhi:git
county,Troms og Finnmark,2021-04-16,1618,8,46972,12989,19.3964520498167,5.36363185887483,1626,59961,fhi:git
county,Troms og Finnmark,2021-04-17,2,0,46974,12989,19.3972779227644,5.36363185887483,2,59963,fhi:git
county,Troms og Finnmark,2021-04-18,0,0,46974,12989,19.3972779227644,5.36363185887483,0,59963,fhi:git
county,Troms og Finnmark,2021-04-19,6,0,46980,12989,19.3997555416075,5.36363185887483,6,59969,fhi:git
county,Troms og Finnmark,2021-04-20,547,1,47527,12990,19.625631792805,5.36404479534868,548,60517,fhi:git
county,Troms og Finnmark,2021-04-21,2462,161,49989,13151,20.6422813914307,5.43052756763899,2623,63140,fhi:git
county,Troms og Finnmark,2021-04-22,2532,36,52521,13187,21.6878365432262,5.4453932806977,2568,65708,fhi:git
county,Troms og Finnmark,2021-04-23,1633,20,54154,13207,22.3621618050279,5.45365201017475,1653,67361,fhi:git
county,Troms og Finnmark,2021-04-24,0,0,54154,13207,22.3621618050279,5.45365201017475,0,67361,fhi:git
county,Troms og Finnmark,2021-04-25,0,0,54154,13207,22.3621618050279,5.45365201017475,0,67361,fhi:git
county,Troms og Finnmark,2021-04-26,10,0,54164,13207,22.3662911697664,5.45365201017475,10,67371,fhi:git
county,Troms og Finnmark,2021-04-27,506,10,54670,13217,22.575237025536,5.45778137491328,516,67887,fhi:git
county,Trøndelag,2020-12-27,0,0,0,0,0.0,0.0,0,0,fhi:git
county,Trøndelag,2020-12-28,0,0,0,0,0.0,0.0,0,0,fhi:git
county,Trøndelag,2020-12-29,0,0,0,0,0.0,0.0,0,0,fhi:git
county,Trøndelag,2020-12-30,0,0,0,0,0.0,0.0,0,0,fhi:git
county,Trøndelag,2020-12-31,0,0,0,0,0.0,0.0,0,0,fhi:git
county,Trøndelag,2021-01-01,0,0,0,0,0.0,0.0,0,0,fhi:git
county,Trøndelag,2021-01-02,0,0,0,0,0.0,0.0,0,0,fhi:git
county,Trøndelag,2021-01-03,0,0,0,0,0.0,0.0,0,0,fhi:git
county,Trøndelag,2021-01-04,3,0,3,0,0.0006367750316264,0.0,3,3,fhi:git
county,Trøndelag,2021-01-05,407,0,410,0,0.0870259209889541,0.0,407,410,fhi:git
county,Trøndelag,2021-01-06,675,0,1085,0,0.230300303104915,0.0,675,1085,fhi:git
county,Trøndelag,2021-01-07,483,0,1568,0,0.332821083196781,0.0,483,1568,fhi:git
county,Trøndelag,2021-01-08,141,0,1709,0,0.362749509683226,0.0,141,1709,fhi:git
county,Trøndelag,2021-01-09,0,0,1709,0,0.362749509683226,0.0,0,1709,fhi:git
county,Trøndelag,2021-01-10,0,0,1709,0,0.362749509683226,0.0,0,1709,fhi:git
county,Trøndelag,2021-01-11,96,0,1805,0,0.383126310695273,0.0,96,1805,fhi:git
county,Trøndelag,2021-01-12,500,0,2305,0,0.489255482633022,0.0,500,2305,fhi:git
county,Trøndelag,2021-01-13,861,0,3166,0,0.672009916709826,0.0,861,3166,fhi:git
county,Trøndelag,2021-01-14,671,0,3837,0,0.814435265450285,0.0,671,3837,fhi:git
county,Trøndelag,2021-01-15,253,0,4090,0,0.868136626450786,0.0,253,4090,fhi:git
county,Trøndelag,2021-01-16,0,0,4090,0,0.868136626450786,0.0,0,4090,fhi:git
county,Trøndelag,2021-01-17,0,0,4090,0,0.868136626450786,0.0,0,4090,fhi:git
county,Trøndelag,2021-01-18,152,0,4242,0,0.900399894719861,0.0,152,4242,fhi:git
county,Trøndelag,2021-01-19,568,0,4810,0,1.02096263404114,0.0,568,4810,fhi:git
county,Trøndelag,2021-01-20,739,0,5549,0,1.17782155016514,0.0,739,5549,fhi:git
county,Trøndelag,2021-01-21,536,0,6085,0,1.2915920224824,0.0,536,6085,fhi:git
county,Trøndelag,2021-01-22,283,0,6368,0,1.35166113379917,0.0,283,6368,fhi:git
county,Trøndelag,2021-01-23,1,0,6369,0,1.35187339214305,0.0,1,6369,fhi:git
county,Trøndelag,2021-01-24,0,0,6369,0,1.35187339214305,0.0,0,6369,fhi:git
county,Trøndelag,2021-01-25,1,0,6370,0,1.35208565048692,0.0,1,6370,fhi:git
county,Trøndelag,2021-01-26,313,184,6683,184,1.41852251211995,0.0390555352730916,497,6867,fhi:git
county,Trøndelag,2021-01-27,1013,605,7696,789,1.63354021446583,0.167471833317768,1618,8485,fhi:git
county,Trøndelag,2021-01-28,727,483,8423,1272,1.78785203046332,0.269992613409633,1210,9695,fhi:git
county,Trøndelag,2021-01-29,423,229,8846,1501,1.87763730992265,0.318599774157122,652,10347,fhi:git
county,Trøndelag,2021-01-30,1,0,8847,1501,1.87784956826653,0.318599774157122,1,10348,fhi:git
county,Trøndelag,2021-01-31,2,1,8849,1502,1.87827408495428,0.318812032500998,3,10351,fhi:git
county,Trøndelag,2021-02-01,15,86,8864,1588,1.88145796011241,0.33706625007429,101,10452,fhi:git
county,Trøndelag,2021-02-02,836,392,9700,1980,2.05890593559233,0.420271520873485,1228,11680,fhi:git
county,Trøndelag,2021-02-03,2124,811,11824,2791,2.50974265798389,0.592413037756514,2935,14615,fhi:git
county,Trøndelag,2021-02-04,2145,607,13969,3398,2.96503680559683,0.721253852488941,2752,17367,fhi:git
county,Trøndelag,2021-02-05,1290,320,15259,3718,3.23885006919622,0.789176522529101,1610,18977,fhi:git
county,Trøndelag,2021-02-06,7,0,15266,3718,3.24033587760335,0.789176522529101,7,18984,fhi:git
county,Trøndelag,2021-02-07,1,0,15267,3718,3.24054813594722,0.789176522529101,1,18985,fhi:git
county,Trøndelag,2021-02-08,3,150,15270,3868,3.24118491097885,0.821015274110425,153,19138,fhi:git
county,Trøndelag,2021-02-09,836,523,16106,4391,3.41863288645877,0.932026387957311,1359,20497,fhi:git
county,Trøndelag,2021-02-10,2234,631,18340,5022,3.89281802667663,1.06596140294275,2865,23362,fhi:git
county,Trøndelag,2021-02-11,2362,587,20702,5609,4.39417223491055,1.19055705079767,2949,26311,fhi:git
county,Trøndelag,2021-02-12,889,353,21591,5962,4.58286990261587,1.26548424618572,1242,27553,fhi:git
county,Trøndelag,2021-02-13,2,0,21593,5962,4.58329441930362,1.26548424618572,2,27555,fhi:git
county,Trøndelag,2021-02-14,0,0,21593,5962,4.58329441930362,1.26548424618572,0,27555,fhi:git
county,Trøndelag,2021-02-15,0,2,21593,5964,4.58329441930362,1.26590876287347,2,27557,fhi:git
county,Trøndelag,2021-02-16,345,210,21938,6174,4.65652354794067,1.31048301508732,555,28112,fhi:git
county,Trøndelag,2021-02-17,2225,922,24163,7096,5.12879836306365,1.50618520814053,3147,31259,fhi:git
county,Trøndelag,2021-02-18,2124,752,26287,7848,5.57963508545521,1.66580348273491,2876,34135,fhi:git
county,Trøndelag,2021-02-19,1262,414,27549,8262,5.84750511542609,1.75367843709936,1676,35811,fhi:git
county,Trøndelag,2021-02-20,1,1,27550,8263,5.84771737376996,1.75389069544324,2,35813,fhi:git
county,Trøndelag,2021-02-21,0,4,27550,8267,5.84771737376996,1.75473972881874,4,35817,fhi:git
county,Trøndelag,2021-02-22,17,3,27567,8270,5.85132576561585,1.75537650385037,20,35837,fhi:git
county,Trøndelag,2021-02-23,334,674,27901,8944,5.92222005247026,1.89843862762245,1008,36845,fhi:git
county,Trøndelag,2021-02-24,1010,2047,28911,10991,6.13660097978452,2.3329314575356,3057,39902,fhi:git
county,Trøndelag,2021-02-25,472,1984,29383,12975,6.23678691809375,2.75405201178458,2456,42358,fhi:git
county,Trøndelag,2021-02-26,620,1153,30003,14128,6.36838709129656,2.99878588227303,1773,44131,fhi:git
county,Trøndelag,2021-02-27,4,1,30007,14129,6.36923612467206,2.99899814061691,5,44136,fhi:git
county,Trøndelag,2021-02-28,0,0,30007,14129,6.36923612467206,2.99899814061691,0,44136,fhi:git
county,Trøndelag,2021-03-01,526,0,30533,14129,6.48088401355057,2.99899814061691,526,44662,fhi:git
county,Trøndelag,2021-03-02,819,785,31352,14914,6.65472359718461,3.16562094055917,1604,46266,fhi:git
county,Trøndelag,2021-03-03,2047,2145,33399,17059,7.08921642709775,3.62091508817212,4192,50458,fhi:git
county,Trøndelag,2021-03-04,1874,2283,35273,19342,7.48698856352043,4.10550088723988,4157,54615,fhi:git
county,Trøndelag,2021-03-05,1048,983,36321,20325,7.70943530790195,4.31415083926949,2031,56646,fhi:git
county,Trøndelag,2021-03-06,3,0,36324,20325,7.71007208293358,4.31415083926949,3,56649,fhi:git
county,Trøndelag,2021-03-07,0,1,36324,20326,7.71007208293358,4.31436309761337,1,56650,fhi:git
county,Trøndelag,2021-03-08,434,0,36758,20326,7.80219220417555,4.31436309761337,434,57084,fhi:git
county,Trøndelag,2021-03-09,1172,301,37930,20627,8.05095898319763,4.37825285911989,1473,58557,fhi:git
county,Trøndelag,2021-03-10,1687,1501,39617,22128,8.4090388093156,4.69685263327701,3188,61745,fhi:git
county,Trøndelag,2021-03-11,820,1211,40437,23339,8.5830906512935,4.95389748771024,2031,63776,fhi:git
county,Trøndelag,2021-03-12,122,504,40559,23843,8.60898616924631,5.06087569302349,626,64402,fhi:git
county,Trøndelag,2021-03-13,1,1,40560,23844,8.60919842759019,5.06108795136737,2,64404,fhi:git
county,Trøndelag,2021-03-14,0,0,40560,23844,8.60919842759019,5.06108795136737,0,64404,fhi:git
county,Trøndelag,2021-03-15,3,6,40563,23850,8.60983520262182,5.06236150143062,9,64413,fhi:git
county,Trøndelag,2021-03-16,607,12,41170,23862,8.73867601735424,5.06490860155713,619,65032,fhi:git
county,Trøndelag,2021-03-17,1980,122,43150,23984,9.15894753822773,5.09080411950994,2102,67134,fhi:git
county,Trøndelag,2021-03-18,1500,123,44650,24107,9.47733505404097,5.11691189580662,1623,68757,fhi:git
county,Trøndelag,2021-03-19,543,87,45193,24194,9.59259133476537,5.13537837172379,630,69387,fhi:git
county,Trøndelag,2021-03-20,0,0,45193,24194,9.59259133476537,5.13537837172379,0,69387,fhi:git
county,Trøndelag,2021-03-21,0,0,45193,24194,9.59259133476537,5.13537837172379,0,69387,fhi:git
county,Trøndelag,2021-03-22,1,0,45194,24194,9.59280359310925,5.13537837172379,1,69388,fhi:git
county,Trøndelag,2021-03-23,1046,216,46240,24410,9.81482582080302,5.1812261740009,1262,70650,fhi:git
county,Trøndelag,2021-03-24,3150,569,49390,24979,10.4834396040108,5.30200117166606,3719,74369,fhi:git
county,Trøndelag,2021-03-25,2888,304,52278,25283,11.0964417011233,5.36652770820421,3192,77561,fhi:git
county,Trøndelag,2021-03-26,1986,227,54264,25510,11.51798677206,5.41471035226395,2213,79774,fhi:git
county,Trøndelag,2021-03-27,0,3,54264,25513,11.51798677206,5.41534712729558,3,79777,fhi:git
county,Trøndelag,2021-03-28,0,0,54264,25513,11.51798677206,5.41534712729558,0,79777,fhi:git
county,Trøndelag,2021-03-29,3,0,54267,25513,11.5186235470916,5.41534712729558,3,79780,fhi:git
county,Trøndelag,2021-03-30,1874,535,56141,26048,11.9163956835143,5.52890534126897,2409,82189,fhi:git
county,Trøndelag,2021-03-31,2569,422,58710,26470,12.4616873689305,5.61847836238443,2991,85180,fhi:git
county,Trøndelag,2021-04-01,163,156,58873,26626,12.4962854789822,5.651590664029,319,85499,fhi:git
county,Trøndelag,2021-04-02,159,95,59032,26721,12.5300345556584,5.67175520669718,254,85753,fhi:git
county,Trøndelag,2021-04-03,0,0,59032,26721,12.5300345556584,5.67175520669718,0,85753,fhi:git
county,Trøndelag,2021-04-04,0,0,59032,26721,12.5300345556584,5.67175520669718,0,85753,fhi:git
county,Trøndelag,2021-04-05,1,0,59033,26721,12.5302468140023,5.67175520669718,1,85754,fhi:git
county,Trøndelag,2021-04-06,2098,41,61131,26762,12.9755648194531,5.68045779879607,2139,87893,fhi:git
county,Trøndelag,2021-04-07,4458,229,65589,26991,13.92181251645,5.72906495954356,4687,92580,fhi:git
county,Trøndelag,2021-04-08,4737,116,70326,27107,14.9272802913883,5.75368692743312,4853,97433,fhi:git
county,Trøndelag,2021-04-09,2679,33,73005,27140,15.4959203946307,5.76069145278101,2712,100145,fhi:git
county,Trøndelag,2021-04-10,0,0,73005,27140,15.4959203946307,5.76069145278101,0,100145,fhi:git
county,Trøndelag,2021-04-11,0,0,73005,27140,15.4959203946307,5.76069145278101,0,100145,fhi:git
county,Trøndelag,2021-04-12,278,4,73283,27144,15.5549282142281,5.76154048615651,282,100427,fhi:git
county,Trøndelag,2021-04-13,2136,11,75419,27155,16.0083120367462,5.76387532793914,2147,102574,fhi:git
county,Trøndelag,2021-04-14,5347,217,80766,27372,17.1432574014485,5.80993538856013,5564,108138,fhi:git
county,Trøndelag,2021-04-15,5039,178,85805,27550,18.2128271962371,5.84771737376996,5217,113355,fhi:git
county,Trøndelag,2021-04-16,2759,28,88564,27578,18.7984479669896,5.85366060739848,2787,116142,fhi:git
county,Trøndelag,2021-04-17,2,0,88566,27578,18.7988724836773,5.85366060739848,2,116144,fhi:git
county,Trøndelag,2021-04-18,0,0,88566,27578,18.7988724836773,5.85366060739848,0,116144,fhi:git
county,Trøndelag,2021-04-19,1078,1,89644,27579,19.0276869783751,5.85387286574235,1079,117223,fhi:git
county,Trøndelag,2021-04-20,1639,34,91283,27613,19.3755784039871,5.86108964943412,1673,118896,fhi:git
county,Trøndelag,2021-04-21,4551,120,95834,27733,20.3415661269645,5.88656065069918,4671,123567,fhi:git
county,Trøndelag,2021-04-22,4042,229,99876,27962,21.1995143529092,5.93516781144667,4271,127838,fhi:git
county,Trøndelag,2021-04-23,2556,16,102432,27978,21.742046679855,5.93856394494868,2572,130410,fhi:git
county,Trøndelag,2021-04-24,0,0,102432,27978,21.742046679855,5.93856394494868,0,130410,fhi:git
county,Trøndelag,2021-04-25,0,0,102432,27978,21.742046679855,5.93856394494868,0,130410,fhi:git
county,Trøndelag,2021-04-26,1030,5,103462,27983,21.9606727740467,5.93962523666805,1035,131445,fhi:git
county,Trøndelag,2021-04-27,1124,355,104586,28338,22.1992511525628,6.01497694874386,1479,132924,fhi:git
county,Vestfold og Telemark,2020-12-27,0,0,0,0,0.0,0.0,0,0,fhi:git
county,Vestfold og Telemark,2020-12-28,0,0,0,0,0.0,0.0,0,0,fhi:git
county,Vestfold og Telemark,2020-12-29,0,0,0,0,0.0,0.0,0,0,fhi:git
county,Vestfold og Telemark,2020-12-30,0,0,0,0,0.0,0.0,0,0,fhi:git
county,Vestfold og Telemark,2020-12-31,0,0,0,0,0.0,0.0,0,0,fhi:git
county,Vestfold og Telemark,2021-01-01,0,0,0,0,0.0,0.0,0,0,fhi:git
county,Vestfold og Telemark,2021-01-02,0,0,0,0,0.0,0.0,0,0,fhi:git
county,Vestfold og Telemark,2021-01-03,0,0,0,0,0.0,0.0,0,0,fhi:git
county,Vestfold og Telemark,2021-01-04,1,0,1,0,0.0002370331040433,0.0,1,1,fhi:git
county,Vestfold og Telemark,2021-01-05,218,0,219,0,0.051910249785485,0.0,218,219,fhi:git
county,Vestfold og Telemark,2021-01-06,1025,0,1244,0,0.294869181429879,0.0,1025,1244,fhi:git
county,Vestfold og Telemark,2021-01-07,443,0,1687,0,0.399874846521065,0.0,443,1687,fhi:git
county,Vestfold og Telemark,2021-01-08,63,0,1750,0,0.414807932075794,0.0,63,1750,fhi:git
county,Vestfold og Telemark,2021-01-09,0,0,1750,0,0.414807932075794,0.0,0,1750,fhi:git
county,Vestfold og Telemark,2021-01-10,3,0,1753,0,0.415519031387924,0.0,3,1753,fhi:git
county,Vestfold og Telemark,2021-01-11,3,0,1756,0,0.416230130700054,0.0,3,1756,fhi:git
county,Vestfold og Telemark,2021-01-12,421,0,2177,0,0.516021067502287,0.0,421,2177,fhi:git
county,Vestfold og Telemark,2021-01-13,1165,0,3342,0,0.792164633712744,0.0,1165,3342,fhi:git
county,Vestfold og Telemark,2021-01-14,582,0,3924,0,0.930117900265951,0.0,582,3924,fhi:git
county,Vestfold og Telemark,2021-01-15,158,0,4082,0,0.967569130704794,0.0,158,4082,fhi:git
county,Vestfold og Telemark,2021-01-16,4,0,4086,0,0.968517263120967,0.0,4,4086,fhi:git
county,Vestfold og Telemark,2021-01-17,42,0,4128,0,0.978472653490786,0.0,42,4128,fhi:git
county,Vestfold og Telemark,2021-01-18,7,0,4135,0,0.98013188521909,0.0,7,4135,fhi:git
county,Vestfold og Telemark,2021-01-19,232,0,4367,0,1.03512356535714,0.0,232,4367,fhi:git
county,Vestfold og Telemark,2021-01-20,1605,0,5972,0,1.41556169734665,0.0,1605,5972,fhi:git
county,Vestfold og Telemark,2021-01-21,833,0,6805,0,1.61301027301473,0.0,833,6805,fhi:git
county,Vestfold og Telemark,2021-01-22,181,0,6986,0,1.65591326484657,0.0,181,6986,fhi:git
county,Vestfold og Telemark,2021-01-23,3,0,6989,0,1.6566243641587,0.0,3,6989,fhi:git
county,Vestfold og Telemark,2021-01-24,0,0,6989,0,1.6566243641587,0.0,0,6989,fhi:git
county,Vestfold og Telemark,2021-01-25,44,0,7033,0,1.6670538207366,0.0,44,7033,fhi:git
county,Vestfold og Telemark,2021-01-26,103,179,7136,179,1.69146823045307,0.0424289256237526,282,7315,fhi:git
county,Vestfold og Telemark,2021-01-27,1625,898,8761,1077,2.07664702452345,0.255284653054646,2523,9838,fhi:git
county,Vestfold og Telemark,2021-01-28,655,450,9416,1527,2.23190370767181,0.361949549874135,1105,10943,fhi:git
county,Vestfold og Telemark,2021-01-29,86,91,9502,1618,2.25228855461954,0.383519562342077,177,11120,fhi:git
county,Vestfold og Telemark,2021-01-30,0,0,9502,1618,2.25228855461954,0.383519562342077,0,11120,fhi:git
county,Vestfold og Telemark,2021-01-31,1,2,9503,1620,2.25252558772358,0.383993628550163,3,11123,fhi:git
county,Vestfold og Telemark,2021-02-01,50,1,9553,1621,2.26437724292575,0.384230661654207,51,11174,fhi:git
county,Vestfold og Telemark,2021-02-02,464,328,10017,1949,2.37436060320184,0.461977519780413,792,11966,fhi:git
county,Vestfold og Telemark,2021-02-03,3214,893,13231,2842,3.13618499959704,0.673648081691089,4107,16073,fhi:git
county,Vestfold og Telemark,2021-02-04,1902,709,15133,3551,3.58702196348742,0.841704552457796,2611,18684,fhi:git
county,Vestfold og Telemark,2021-02-05,965,245,16098,3796,3.81575890888922,0.899777662948407,1210,19894,fhi:git
county,Vestfold og Telemark,2021-02-06,0,3,16098,3799,3.81575890888922,0.900488762260537,3,19897,fhi:git
county,Vestfold og Telemark,2021-02-07,2,1,16100,3800,3.8162329750973,0.900725795364581,3,19900,fhi:git
county,Vestfold og Telemark,2021-02-08,17,46,16117,3846,3.82026253786604,0.911629318150573,63,19963,fhi:git
county,Vestfold og Telemark,2021-02-09,356,208,16473,4054,3.90464632290546,0.960932203791582,564,20527,fhi:git
county,Vestfold og Telemark,2021-02-10,2891,1395,19364,5449,4.58990902669467,1.291593383932,4286,24813,fhi:git
county,Vestfold og Telemark,2021-02-11,1540,882,20904,6331,4.95494000692137,1.5006565816982,2422,27235,fhi:git
county,Vestfold og Telemark,2021-02-12,602,214,21506,6545,5.09763393555544,1.55138166596347,816,28051,fhi:git
county,Vestfold og Telemark,2021-02-13,2,2,21508,6547,5.09810800176353,1.55185573217156,4,28055,fhi:git
county,Vestfold og Telemark,2021-02-14,0,0,21508,6547,5.09810800176353,1.55185573217156,0,28055,fhi:git
county,Vestfold og Telemark,2021-02-15,4,2,21512,6549,5.0990561341797,1.55232979837964,6,28061,fhi:git
county,Vestfold og Telemark,2021-02-16,579,75,22091,6624,5.23629830142078,1.57010728118289,654,28715,fhi:git
county,Vestfold og Telemark,2021-02-17,3044,1534,25135,8158,5.95782707012861,1.93371606278533,4578,33293,fhi:git
county,Vestfold og Telemark,2021-02-18,1824,636,26959,8794,6.39017545190361,2.08446911695687,2460,35753,fhi:git
county,Vestfold og Telemark,2021-02-19,284,84,27243,8878,6.45749285345191,2.10437989769651,368,36121,fhi:git
county,Vestfold og Telemark,2021-02-20,0,1,27243,8879,6.45749285345191,2.10461693080056,1,36122,fhi:git
county,Vestfold og Telemark,2021-02-21,1,1,27244,8880,6.45772988655596,2.1048539639046,2,36124,fhi:git
county,Vestfold og Telemark,2021-02-22,51,0,27295,8880,6.46981857486217,2.1048539639046,51,36175,fhi:git
county,Vestfold og Telemark,2021-02-23,626,385,27921,9265,6.61820129799328,2.19611170896127,1011,37186,fhi:git
county,Vestfold og Telemark,2021-02-24,669,2871,28590,12136,6.77677644459825,2.87663375066962,3540,40726,fhi:git
county,Vestfold og Telemark,2021-02-25,702,2003,29292,14139,6.94317368363666,3.35141105806837,2705,43431,fhi:git
county,Vestfold og Telemark,2021-02-26,541,847,29833,14986,7.07140859292409,3.55217809719305,1388,44819,fhi:git
county,Vestfold og Telemark,2021-02-27,3,2,29836,14988,7.07211969223622,3.55265216340114,5,44824,fhi:git
county,Vestfold og Telemark,2021-02-28,1,0,29837,14988,7.07235672534026,3.55265216340114,1,44825,fhi:git
county,Vestfold og Telemark,2021-03-01,604,0,30441,14988,7.21552472018242,3.55265216340114,604,45429,fhi:git
county,Vestfold og Telemark,2021-03-02,845,354,31286,15342,7.41581769309902,3.63656188223247,1199,46628,fhi:git
county,Vestfold og Telemark,2021-03-03,1976,2814,33262,18156,7.8841951066886,4.30357303701035,4790,51418,fhi:git
county,Vestfold og Telemark,2021-03-04,1011,1433,34273,19589,8.12383557487639,4.64324147510441,2444,53862,fhi:git
county,Vestfold og Telemark,2021-03-05,1476,591,35749,20180,8.47369643644431,4.78332803959401,2067,55929,fhi:git
county,Vestfold og Telemark,2021-03-06,3,1,35752,20181,8.47440753575644,4.78356507269805,4,55933,fhi:git
county,Vestfold og Telemark,2021-03-07,1,0,35753,20181,8.47464456886049,4.78356507269805,1,55934,fhi:git
county,Vestfold og Telemark,2021-03-08,235,0,35988,20181,8.53034734831067,4.78356507269805,235,56169,fhi:git
county,Vestfold og Telemark,2021-03-09,933,142,36921,20323,8.75149923438307,4.8172237734722,1075,57244,fhi:git
county,Vestfold og Telemark,2021-03-10,1592,2262,38513,22585,9.12885593602003,5.35339265481817,3854,61098,fhi:git
county,Vestfold og Telemark,2021-03-11,304,839,38817,23424,9.20091399964919,5.55226342911051,1143,62241,fhi:git
county,Vestfold og Telemark,2021-03-12,36,126,38853,23550,9.20944719139475,5.58212960021997,162,62403,fhi:git
county,Vestfold og Telemark,2021-03-13,1,2,38854,23552,9.20968422449879,5.58260366642805,3,62406,fhi:git
county,Vestfold og Telemark,2021-03-14,0,0,38854,23552,9.20968422449879,5.58260366642805,0,62406,fhi:git
county,Vestfold og Telemark,2021-03-15,2,3,38856,23555,9.21015829070688,5.58331476574018,5,62411,fhi:git
county,Vestfold og Telemark,2021-03-16,403,26,39259,23581,9.30568263163634,5.58947762644531,429,62840,fhi:git
county,Vestfold og Telemark,2021-03-17,3106,169,42365,23750,10.0419074527949,5.62953622102863,3275,66115,fhi:git
county,Vestfold og Telemark,2021-03-18,913,53,43278,23803,10.2583186767864,5.64209897554292,966,67081,fhi:git
county,Vestfold og Telemark,2021-03-19,27,32,43305,23835,10.2647185705956,5.64968403487231,59,67140,fhi:git
county,Vestfold og Telemark,2021-03-20,1,0,43306,23835,10.2649556036996,5.64968403487231,1,67141,fhi:git
county,Vestfold og Telemark,2021-03-21,0,1,43306,23836,10.2649556036996,5.64992106797635,1,67142,fhi:git
county,Vestfold og Telemark,2021-03-22,0,1,43306,23837,10.2649556036996,5.6501581010804,1,67143,fhi:git
county,Vestfold og Telemark,2021-03-23,662,58,43968,23895,10.4218715185763,5.66390602111491,720,67863,fhi:git
county,Vestfold og Telemark,2021-03-24,4609,816,48577,24711,11.5143570951119,5.85732503401425,5425,73288,fhi:git
county,Vestfold og Telemark,2021-03-25,2946,272,51523,24983,12.2126566196235,5.92179803831403,3218,76506,fhi:git
county,Vestfold og Telemark,2021-03-26,899,152,52422,25135,12.4257493801584,5.95782707012861,1051,77557,fhi:git
county,Vestfold og Telemark,2021-03-27,0,0,52422,25135,12.4257493801584,5.95782707012861,0,77557,fhi:git
county,Vestfold og Telemark,2021-03-28,0,0,52422,25135,12.4257493801584,5.95782707012861,0,77557,fhi:git
county,Vestfold og Telemark,2021-03-29,184,3,52606,25138,12.4693634713024,5.95853816944074,187,77744,fhi:git
county,Vestfold og Telemark,2021-03-30,3017,80,55623,25218,13.1844923462011,5.97750081776421,3097,80841,fhi:git
county,Vestfold og Telemark,2021-03-31,3401,490,59024,25708,13.9906419330524,6.09364703874543,3891,84732,fhi:git
county,Vestfold og Telemark,2021-04-01,426,17,59450,25725,14.0916180353748,6.09767660151417,443,85175,fhi:git
county,Vestfold og Telemark,2021-04-02,2,3,59452,25728,14.0920921015829,6.0983877008263,5,85180,fhi:git
county,Vestfold og Telemark,2021-04-03,2,0,59454,25728,14.092566167791,6.0983877008263,2,85182,fhi:git
county,Vestfold og Telemark,2021-04-04,0,0,59454,25728,14.092566167791,6.0983877008263,0,85182,fhi:git
county,Vestfold og Telemark,2021-04-05,1,1,59455,25729,14.092803200895,6.09862473393034,2,85184,fhi:git
county,Vestfold og Telemark,2021-04-06,968,40,60423,25769,14.322251245609,6.10810605809207,1008,86192,fhi:git
county,Vestfold og Telemark,2021-04-07,6308,152,66731,25921,15.8174560659142,6.14413508990666,6460,92652,fhi:git
county,Vestfold og Telemark,2021-04-08,3681,61,70412,25982,16.6899749218976,6.1585941092533,3742,96394,fhi:git
county,Vestfold og Telemark,2021-04-09,1262,14,71674,25996,16.9891106992003,6.1619125727099,1276,97670,fhi:git
county,Vestfold og Telemark,2021-04-10,2,0,71676,25996,16.9895847654083,6.1619125727099,2,97672,fhi:git
county,Vestfold og Telemark,2021-04-11,1,0,71677,25996,16.9898217985124,6.1619125727099,1,97673,fhi:git
county,Vestfold og Telemark,2021-04-12,10,0,71687,25996,16.9921921295528,6.1619125727099,10,97683,fhi:git
county,Vestfold og Telemark,2021-04-13,1276,14,72963,26010,17.2946463703121,6.16523103616651,1290,98973,fhi:git
county,Vestfold og Telemark,2021-04-14,6843,80,79806,26090,18.9166639012805,6.18419368448998,6923,105896,fhi:git
county,Vestfold og Telemark,2021-04-15,4548,89,84354,26179,19.9946904584694,6.20528963074983,4637,110533,fhi:git
county,Vestfold og Telemark,2021-04-16,1733,13,86087,26192,20.4054688277765,6.20837106110239,1746,112279,fhi:git
county,Vestfold og Telemark,2021-04-17,5,0,86092,26192,20.4066539932967,6.20837106110239,5,112284,fhi:git
county,Vestfold og Telemark,2021-04-18,0,0,86092,26192,20.4066539932967,6.20837106110239,0,112284,fhi:git
county,Vestfold og Telemark,2021-04-19,26,1,86118,26193,20.4128168540018,6.20860809420644,27,112311,fhi:git
county,Vestfold og Telemark,2021-04-20,701,20,86819,26213,20.5789770599362,6.2133487562873,721,113032,fhi:git
county,Vestfold og Telemark,2021-04-21,6469,784,93288,26997,22.1123442099924,6.39918270985726,7253,120285,fhi:git
county,Vestfold og Telemark,2021-04-22,3886,510,97174,27507,23.0334548523047,6.52006959291935,4396,124681,fhi:git
county,Vestfold og Telemark,2021-04-23,905,307,98079,27814,23.2479698114639,6.59283875586064,1212,125893,fhi:git
county,Vestfold og Telemark,2021-04-24,1,0,98080,27814,23.2482068445679,6.59283875586064,1,125894,fhi:git
county,Vestfold og Telemark,2021-04-25,0,0,98080,27814,23.2482068445679,6.59283875586064,0,125894,fhi:git
county,Vestfold og Telemark,2021-04-26,8,2,98088,27816,23.2501031094003,6.59331282206873,10,125904,fhi:git
county,Vestfold og Telemark,2021-04-27,1059,345,99147,28161,23.5011211665821,6.67508924296367,1404,127308,fhi:git
county,Vestland,2020-12-27,0,0,0,0,0.0,0.0,0,0,fhi:git
county,Vestland,2020-12-28,0,0,0,0,0.0,0.0,0,0,fhi:git
county,Vestland,2020-12-29,0,0,0,0,0.0,0.0,0,0,fhi:git
county,Vestland,2020-12-30,0,0,0,0,0.0,0.0,0,0,fhi:git
county,Vestland,2020-12-31,0,0,0,0,0.0,0.0,0,0,fhi:git
county,Vestland,2021-01-01,0,0,0,0,0.0,0.0,0,0,fhi:git
county,Vestland,2021-01-02,0,0,0,0,0.0,0.0,0,0,fhi:git
county,Vestland,2021-01-03,1,0,1,0,0.0001571015394379,0.0,1,1,fhi:git
county,Vestland,2021-01-04,2,0,3,0,0.0004696151191022,0.0,2,3,fhi:git
county,Vestland,2021-01-05,416,0,419,0,0.0655895783012769,0.0,416,419,fhi:git
county,Vestland,2021-01-06,1257,0,1676,0,0.262358313205108,0.0,1257,1676,fhi:git
county,Vestland,2021-01-07,715,0,2391,0,0.37428324992447,0.0,715,2391,fhi:git
county,Vestland,2021-01-08,139,0,2530,0,0.396042083776206,0.0,139,2530,fhi:git
county,Vestland,2021-01-09,0,0,2530,0,0.396042083776206,0.0,0,2530,fhi:git
county,Vestland,2021-01-10,0,0,2530,0,0.396042083776206,0.0,0,2530,fhi:git
county,Vestland,2021-01-11,65,0,2595,0,0.406217078023421,0.0,65,2595,fhi:git
county,Vestland,2021-01-12,856,0,3451,0,0.540213925340588,0.0,856,3451,fhi:git
county,Vestland,2021-01-13,1126,0,4577,0,0.716476133376955,0.0,1126,4577,fhi:git
county,Vestland,2021-01-14,999,0,5576,0,0.872857968037995,0.0,999,5576,fhi:git
county,Vestland,2021-01-15,426,0,6002,0,0.93954331495051,0.0,426,6002,fhi:git
county,Vestland,2021-01-16,2,0,6004,0,0.939856391696578,0.0,2,6004,fhi:git
county,Vestland,2021-01-17,1,0,6005,0,0.940012930069613,0.0,1,6005,fhi:git
county,Vestland,2021-01-18,62,0,6067,0,0.949718309197725,0.0,62,6067,fhi:git
county,Vestland,2021-01-19,368,0,6435,0,1.00732443047426,0.0,368,6435,fhi:git
county,Vestland,2021-01-20,1236,0,7671,0,1.20080585954438,0.0,1236,7671,fhi:git
county,Vestland,2021-01-21,783,0,8454,0,1.32337540563006,0.0,783,8454,fhi:git
county,Vestland,2021-01-22,313,0,8767,0,1.37237191638972,0.0,313,8767,fhi:git
county,Vestland,2021-01-23,0,0,8767,0,1.37237191638972,0.0,0,8767,fhi:git
county,Vestland,2021-01-24,0,0,8767,0,1.37237191638972,0.0,0,8767,fhi:git
county,Vestland,2021-01-25,2,0,8769,0,1.37268499313579,0.0,2,8769,fhi:git
county,Vestland,2021-01-26,152,174,8921,174,1.39647882583697,0.0272376769079288,326,9095,fhi:git
county,Vestland,2021-01-27,1592,1212,10513,1386,1.64568791570722,0.216962185025226,2804,11899,fhi:git
county,Vestland,2021-01-28,1958,695,12471,2081,1.95219005010793,0.325756354283907,2653,14552,fhi:git
county,Vestland,2021-01-29,481,176,12952,2257,2.02748500753732,0.353307107937904,657,15209,fhi:git
county,Vestland,2021-01-30,3,0,12955,2257,2.02795462265643,0.353307107937904,3,15212,fhi:git
county,Vestland,2021-01-31,1,0,12956,2257,2.02811116102946,0.353307107937904,1,15213,fhi:git
county,Vestland,2021-02-01,13,59,12969,2316,2.0301461598789,0.362542871946915,72,15285,fhi:git
county,Vestland,2021-02-02,720,582,13689,2898,2.14285378846344,0.453648205052746,1302,16587,fhi:git
county,Vestland,2021-02-03,2831,1048,16520,3946,2.5860139225229,0.617700419992455,3879,20466,fhi:git
county,Vestland,2021-02-04,2591,1127,19111,5073,2.99160484705418,0.794119166401856,3718,24184,fhi:git
county,Vestland,2021-02-05,912,488,20023,5561,3.13436784326126,0.870509892442484,1400,25584,fhi:git
county,Vestland,2021-02-06,0,2,20023,5563,3.13436784326126,0.870822969188552,2,25586,fhi:git
county,Vestland,2021-02-07,2,1,20025,5564,3.13468092000733,0.870979507561586,3,25589,fhi:git
county,Vestland,2021-02-08,8,49,20033,5613,3.1359332269916,0.878649887840256,57,25646,fhi:git
county,Vestland,2021-02-09,893,307,20926,5920,3.27572199411103,0.926707168361716,1200,26846,fhi:git
county,Vestland,2021-02-10,2760,971,23686,6891,3.70776790368507,1.0787059285778,3731,30577,fhi:git
county,Vestland,2021-02-11,2705,837,26391,7728,4.13120420274224,1.20972854680732,3542,34119,fhi:git
county,Vestland,2021-02-12,630,459,27021,8187,4.22982337775371,1.28157966002996,1089,35208,fhi:git
county,Vestland,2021-02-13,0,0,27021,8187,4.22982337775371,1.28157966002996,0,35208,fhi:git
county,Vestland,2021-02-14,0,2,27021,8189,4.22982337775371,1.28189273677603,2,35210,fhi:git
county,Vestland,2021-02-15,94,1,27115,8190,4.24453798481891,1.28204927514906,95,35305,fhi:git
county,Vestland,2021-02-16,1088,55,28203,8245,4.41485173467998,1.29065888566594,1143,36448,fhi:git
county,Vestland,2021-02-17,2707,1330,30910,9575,4.83860111048322,1.49885492180126,4037,40485,fhi:git
county,Vestland,2021-02-18,2008,2001,32918,11576,5.15293016353564,1.81208820624244,4009,44494,fhi:git
county,Vestland,2021-02-19,1157,541,34075,12117,5.33404506113606,1.89677546605387,1698,46192,fhi:git
county,Vestland,2021-02-20,3,5,34078,12122,5.33451467625516,1.89755815791904,8,46200,fhi:git
county,Vestland,2021-02-21,0,1,34078,12123,5.33451467625516,1.89771469629208,1,46201,fhi:git
county,Vestland,2021-02-22,49,2,34127,12125,5.34218505653383,1.89802777303814,51,46252,fhi:git
county,Vestland,2021-02-23,542,591,34669,12716,5.4270288547183,1.99054195150128,1133,47385,fhi:git
county,Vestland,2021-02-24,1414,2402,36083,15118,5.64837411418848,2.36654712352913,3816,51201,fhi:git
county,Vestland,2021-02-25,1257,2647,37340,17765,5.84514284909231,2.78090419695032,3904,55105,fhi:git
county,Vestland,2021-02-26,1428,876,38768,18641,6.06867964578497,2.91803181172817,2304,57409,fhi:git
county,Vestland,2021-02-27,5,0,38773,18641,6.06946233765014,2.91803181172817,5,57414,fhi:git
county,Vestland,2021-02-28,0,8,38773,18649,6.06946233765014,2.91928411871244,8,57422,fhi:git
county,Vestland,2021-03-01,440,11,39213,18660,6.13833922178513,2.92100604081582,451,57873,fhi:git
county,Vestland,2021-03-02,1349,759,40562,19419,6.3495094870081,3.03981866594868,2108,59981,fhi:git
county,Vestland,2021-03-03,1743,2047,42305,21466,6.62235587120649,3.36025271554943,3790,63771,fhi:git
county,Vestland,2021-03-04,1803,2850,44108,24316,6.90459455778692,3.80638707869654,4653,68424,fhi:git
county,Vestland,2021-03-05,1246,903,45354,25219,7.09964137058738,3.94774122954631,2149,70573,fhi:git
county,Vestland,2021-03-06,1,6,45355,25225,7.09979790896041,3.94868045978451,7,70580,fhi:git
county,Vestland,2021-03-07,4,0,45359,25225,7.10042406245255,3.94868045978451,4,70584,fhi:git
county,Vestland,2021-03-08,635,15,45994,25240,7.19982592932919,3.95102853538002,650,71234,fhi:git
county,Vestland,2021-03-09,1500,528,47494,25768,7.4346334888803,4.03368079634201,2028,73262,fhi:git
county,Vestland,2021-03-10,2498,1851,49992,27619,7.82566634471941,4.32343332482808,4349,77611,fhi:git
county,Vestland,2021-03-11,1402,1550,51394,29169,8.04513314371319,4.5660678030309,2952,80563,fhi:git
county,Vestland,2021-03-12,180,976,51574,30145,8.07331005085932,4.71884925511215,1156,81719,fhi:git
county,Vestland,2021-03-13,8,10,51582,30155,8.07456235784359,4.72041463884249,18,81737,fhi:git
county,Vestland,2021-03-14,0,0,51582,30155,8.07456235784359,4.72041463884249,0,81737,fhi:git
county,Vestland,2021-03-15,7,8,51589,30163,8.07565812645483,4.72166694582677,15,81752,fhi:git
county,Vestland,2021-03-16,1199,36,52788,30199,8.26334763572268,4.72730232725599,1235,82987,fhi:git
county,Vestland,2021-03-17,2433,222,55221,30421,8.64420549731459,4.76205384606956,2655,85642,fhi:git
county,Vestland,2021-03-18,2318,145,57539,30566,9.00706144600757,4.7847519101595,2463,88105,fhi:git
county,Vestland,2021-03-19,587,115,58126,30681,9.09894947097857,4.80275382305842,702,88807,fhi:git
county,Vestland,2021-03-20,1,2,58127,30683,9.0991060093516,4.80306689980448,3,88810,fhi:git
county,Vestland,2021-03-21,0,0,58127,30683,9.0991060093516,4.80306689980448,0,88810,fhi:git
county,Vestland,2021-03-22,9,13,58136,30696,9.10051485470891,4.80510189865393,22,88832,fhi:git
county,Vestland,2021-03-23,2052,341,60188,31037,9.42173159617483,4.85848148385855,2393,91225,fhi:git
county,Vestland,2021-03-24,4025,514,64213,31551,10.051798547637,4.93894220759806,4539,95764,fhi:git
county,Vestland,2021-03-25,3164,375,67377,31926,10.5470859599168,4.99764409748584,3539,99303,fhi:git
county,Vestland,2021-03-26,997,188,68374,32114,10.7031547178318,5.02707331161624,1185,100488,fhi:git
county,Vestland,2021-03-27,2,0,68376,32114,10.7034677945778,5.02707331161624,2,100490,fhi:git
county,Vestland,2021-03-28,0,2,68376,32116,10.7034677945778,5.02738638836231,2,100492,fhi:git
county,Vestland,2021-03-29,115,2,68491,32118,10.7214697074767,5.02769946510838,117,100609,fhi:git
county,Vestland,2021-03-30,3580,571,72071,32689,11.2818770829387,5.11708287611084,4151,104760,fhi:git
county,Vestland,2021-03-31,3688,1159,75759,33848,11.8591906026884,5.29851085045733,4847,109607,fhi:git
county,Vestland,2021-04-01,950,231,76709,34079,12.0079020570708,5.3346712146282,1181,110788,fhi:git
county,Vestland,2021-04-02,53,90,76762,34169,12.0161985908416,5.34875966820126,143,110931,fhi:git
county,Vestland,2021-04-03,1,0,76763,34169,12.0163551292146,5.34875966820126,1,110932,fhi:git
county,Vestland,2021-04-04,0,2,76763,34171,12.0163551292146,5.34907274494733,2,110934,fhi:git
county,Vestland,2021-04-05,1,1,76764,34172,12.0165116675876,5.34922928332037,2,110936,fhi:git
county,Vestland,2021-04-06,3095,101,79859,34273,12.5009979321281,5.36503965899681,3196,114132,fhi:git
county,Vestland,2021-04-07,8104,155,87963,34428,13.7695849071962,5.38930310681709,8259,122391,fhi:git
county,Vestland,2021-04-08,6396,303,94359,34731,14.7708043411222,5.43673423384641,6699,129090,fhi:git
county,Vestland,2021-04-09,2025,103,96384,34834,15.0877945465162,5.45285768626892,2128,131218,fhi:git
county,Vestland,2021-04-10,42,2,96426,34836,15.0943691581836,5.45317076301499,44,131262,fhi:git
county,Vestland,2021-04-11,5,0,96431,34836,15.0951518500488,5.45317076301499,5,131267,fhi:git
county,Vestland,2021-04-12,57,10,96488,34846,15.1040745373117,5.45473614674533,67,131334,fhi:git
county,Vestland,2021-04-13,4817,66,101305,34912,15.8581198802168,5.46506767936558,4883,136217,fhi:git
county,Vestland,2021-04-14,9034,97,110339,35009,17.2722875422067,5.48025190154989,9131,145348,fhi:git
county,Vestland,2021-04-15,6782,187,117121,35196,18.3339307881238,5.50952457730726,6969,152317,fhi:git
county,Vestland,2021-04-16,1361,140,118482,35336,18.5469795138231,5.53143994953203,1501,153818,fhi:git
county,Vestland,2021-04-17,51,2,118533,35338,18.5549629708479,5.5317530262781,53,153871,fhi:git
county,Vestland,2021-04-18,1,0,118534,35338,18.5551195092209,5.5317530262781,1,153872,fhi:git
county,Vestland,2021-04-19,40,10,118574,35348,18.5613810441423,5.53331841000844,50,153922,fhi:git
county,Vestland,2021-04-20,5188,66,123762,35414,19.373502123443,5.54364994262869,5254,159176,fhi:git
county,Vestland,2021-04-21,7792,74,131554,35488,20.5932491261245,5.55523378223321,7866,167042,fhi:git
county,Vestland,2021-04-22,5071,117,136625,35605,21.3870552157803,5.57354877187819,5188,172230,fhi:git
county,Vestland,2021-04-23,1204,34,137829,35639,21.5755274169133,5.57887107656135,1238,173468,fhi:git
county,Vestland,2021-04-24,1,0,137830,35639,21.5756839552864,5.57887107656135,1,173469,fhi:git
county,Vestland,2021-04-25,8,0,137838,35639,21.5769362622707,5.57887107656135,8,173477,fhi:git
county,Vestland,2021-04-26,26,2,137864,35641,21.5810062599695,5.57918415330742,28,173505,fhi:git
county,Vestland,2021-04-27,2831,1126,140695,36767,22.024166394029,5.75544636134379,3957,177462,fhi:git
county,Viken,2020-12-27,0,0,0,0,0.0,0.0,0,0,fhi:git
county,Viken,2020-12-28,65,0,65,0,0.0052370152236004,0.0,65,65,fhi:git
county,Viken,2020-12-29,689,0,754,0,0.0607493765937647,0.0,689,754,fhi:git
county,Viken,2020-12-30,219,0,973,0,0.0783940894240492,0.0,219,973,fhi:git
county,Viken,2020-12-31,67,0,1040,0,0.0837922435776065,0.0,67,1040,fhi:git
county,Viken,2021-01-01,0,0,1040,0,0.0837922435776065,0.0,0,1040,fhi:git
county,Viken,2021-01-02,0,0,1040,0,0.0837922435776065,0.0,0,1040,fhi:git
county,Viken,2021-01-03,0,0,1040,0,0.0837922435776065,0.0,0,1040,fhi:git
county,Viken,2021-01-04,0,0,1040,0,0.0830416230165828,0.0,0,1040,fhi:git
county,Viken,2021-01-05,526,0,1566,0,0.125041520811508,0.0,526,1566,fhi:git
county,Viken,2021-01-06,1650,0,3216,0,0.256790249635894,0.0,1650,3216,fhi:git
county,Viken,2021-01-07,1925,0,5141,0,0.410497099931012,0.0,1925,5141,fhi:git
county,Viken,2021-01-08,282,0,5423,0,0.433014155402816,0.0,282,5423,fhi:git
county,Viken,2021-01-09,6,0,5429,0,0.43349324168945,0.0,6,5429,fhi:git
county,Viken,2021-01-10,5,0,5434,0,0.433892480261645,0.0,5,5434,fhi:git
county,Viken,2021-01-11,60,0,5494,0,0.438683343127986,0.0,60,5494,fhi:git
county,Viken,2021-01-12,787,0,6281,0,0.501523494391497,0.0,787,6281,fhi:git
county,Viken,2021-01-13,1944,0,8225,0,0.656747451260955,0.0,1944,8225,fhi:git
county,Viken,2021-01-14,1950,0,10175,0,0.812450494417048,0.0,1950,10175,fhi:git
county,Viken,2021-01-15,1051,0,11226,0,0.89637044229246,0.0,1051,11226,fhi:git
county,Viken,2021-01-16,93,0,11319,0,0.903796279735289,0.0,93,11319,fhi:git
county,Viken,2021-01-17,23,0,11342,0,0.905632777167386,0.0,23,11342,fhi:git
county,Viken,2021-01-18,144,51,11486,51,0.917130848046605,0.0040722334363901,195,11537,fhi:git
county,Viken,2021-01-19,651,384,12137,435,0.969111710146409,0.0347337557809745,1035,12572,fhi:git
county,Viken,2021-01-20,1493,342,13630,777,1.08832434780387,0.06204167411912,1835,14407,fhi:git
county,Viken,2021-01-21,1997,100,15627,877,1.2477802335386,0.0700264455630222,2097,16504,fhi:git
county,Viken,2021-01-22,821,1,16448,878,1.31333520709303,0.0701062932774612,822,17326,fhi:git
county,Viken,2021-01-23,98,0,16546,878,1.32116028310806,0.0701062932774612,98,17424,fhi:git
county,Viken,2021-01-24,0,0,16546,878,1.32116028310806,0.0701062932774612,0,17424,fhi:git
county,Viken,2021-01-25,62,0,16608,878,1.32611084140328,0.0701062932774612,62,17486,fhi:git
county,Viken,2021-01-26,564,402,17172,1280,1.37114495234688,0.102205074481948,966,18452,fhi:git
county,Viken,2021-01-27,1949,1219,19121,2499,1.52676814778854,0.199539438383116,3168,21620,fhi:git
county,Viken,2021-01-28,3105,1713,22226,4212,1.7746953011217,0.33631857321716,4818,26438,fhi:git
county,Viken,2021-01-29,1041,427,23267,4639,1.85781677185272,0.370413547282623,1468,27906,fhi:git
county,Viken,2021-01-30,11,18,23278,4657,1.85869509671155,0.371850806142525,29,27935,fhi:git
county,Viken,2021-01-31,10,3,23288,4660,1.85949357385594,0.372090349285842,13,27948,fhi:git
county,Viken,2021-02-01,37,47,23325,4707,1.86244793929019,0.375843191864476,84,28032,fhi:git
county,Viken,2021-02-02,1025,687,24350,5394,1.94429184659018,0.430698571684084,1712,29744,fhi:git
county,Viken,2021-02-03,4777,1722,29127,7116,2.32572437846539,0.56819633594808,6499,36243,fhi:git
county,Viken,2021-02-04,6645,1751,35772,8867,2.85631244091269,0.708009683930807,8396,44639,fhi:git
county,Viken,2021-02-05,3148,1101,38920,9968,3.10767304596673,0.79592201752817,4249,48888,fhi:git
county,Viken,2021-02-06,39,92,38959,10060,3.11078710682985,0.80326800725656,131,49019,fhi:git
county,Viken,2021-02-07,16,20,38975,10080,3.11206467026088,0.804864961545341,36,49055,fhi:git
county,Viken,2021-02-08,14,96,38989,10176,3.11318253826303,0.812530342131487,110,49165,fhi:git
county,Viken,2021-02-09,799,568,39788,10744,3.1769808620998,0.857883843932851,1367,50532,fhi:git
county,Viken,2021-02-10,3450,1326,43238,12070,3.45245547691443,0.963761913278994,4776,55308,fhi:git
county,Viken,2021-02-11,4851,1916,48089,13986,3.83979673965812,1.11675013414416,6767,62075,fhi:git
county,Viken,2021-02-12,2428,980,50517,14966,4.03366699031607,1.1950008942944,3408,65483,fhi:git
county,Viken,2021-02-13,26,98,50543,15064,4.03574303089148,1.20282597030943,124,65607,fhi:git
county,Viken,2021-02-14,7,1,50550,15065,4.03630196489256,1.20290581802387,8,65615,fhi:git
county,Viken,2021-02-15,367,124,50917,15189,4.06560607609168,1.2128069346143,491,66106,fhi:git
county,Viken,2021-02-16,1429,359,52346,15548,4.17970846002504,1.24147226409791,1788,67894,fhi:git
county,Viken,2021-02-17,4428,1821,56774,17369,4.53327413956103,1.38687495209137,6249,74143,fhi:git
county,Viken,2021-02-18,4900,2930,61674,20299,4.92452794031224,1.62082875539771,7830,81973,fhi:git
county,Viken,2021-02-19,3797,1282,65471,21581,5.2277097120372,1.72319352530853,5079,87052,fhi:git
county,Viken,2021-02-20,30,10,65501,21591,5.23010514347037,1.72399200245292,40,87092,fhi:git
county,Viken,2021-02-21,1,9,65502,21600,5.23018499118481,1.72471063188287,10,87102,fhi:git
county,Viken,2021-02-22,704,9,66206,21609,5.28639778214988,1.72542926131282,713,87815,fhi:git
county,Viken,2021-02-23,2128,758,68334,22367,5.45631371847612,1.7859538288576,2886,90701,fhi:git
county,Viken,2021-02-24,2521,4212,70855,26579,5.6576098065769,2.12227240207476,6733,97434,fhi:git
county,Viken,2021-02-25,2545,6274,73400,32853,5.86082223982421,2.62323696246519,8819,106253,fhi:git
county,Viken,2021-02-26,1941,2723,75341,35576,6.01580665355035,2.84066228888264,4664,110917,fhi:git
county,Viken,2021-02-27,165,89,75506,35665,6.02898152643279,2.84776873546772,254,111171,fhi:git
county,Viken,2021-02-28,416,1,75922,35666,6.06219817563942,2.84784858318216,417,111588,fhi:git
county,Viken,2021-03-01,1522,2,77444,35668,6.18372639701561,2.84800827861103,1524,113112,fhi:git
county,Viken,2021-03-02,3021,520,80465,36188,6.4249463423359,2.88952909011932,3541,116653,fhi:git
county,Viken,2021-03-03,4961,2702,85426,38890,6.82107085366789,3.10527761453356,7663,124316,fhi:git
county,Viken,2021-03-04,4395,3261,89821,42151,7.17200155862739,3.36566101131921,7656,131972,fhi:git
county,Viken,2021-03-05,2725,1782,92546,43933,7.38958658047372,3.50794963844955,4507,136479,fhi:git
county,Viken,2021-03-06,215,3,92761,43936,7.40675383907811,3.50818918159287,218,136697,fhi:git
county,Viken,2021-03-07,17,0,92778,43936,7.40811125022357,3.50818918159287,17,136714,fhi:git
county,Viken,2021-03-08,1135,22,93913,43958,7.49873840611186,3.50994583131052,1157,137871,fhi:git
county,Viken,2021-03-09,2899,718,96812,44676,7.73021693027059,3.56727649027774,3617,141488,fhi:git
county,Viken,2021-03-10,5403,3214,102215,47890,8.16163413138462,3.82390704448476,8617,150105,fhi:git
county,Viken,2021-03-11,3430,4772,105645,52662,8.43551179191047,4.20494033778777,8202,158307,fhi:git
county,Viken,2021-03-12,1226,3311,106871,55973,8.53340508981271,4.46931612029537,4537,162844,fhi:git
county,Viken,2021-03-13,17,8,106888,55981,8.53476250095817,4.46995490201089,25,162869,fhi:git
county,Viken,2021-03-14,2,6,106890,55987,8.53492219638705,4.47043398829752,8,162877,fhi:git
county,Viken,2021-03-15,36,47,106926,56034,8.53779671410686,4.47418683087615,83,162960,fhi:git
county,Viken,2021-03-16,783,346,107709,56380,8.60031747451261,4.50181414007206,1129,164089,fhi:git
county,Viken,2021-03-17,3989,507,111698,56887,8.91883000740987,4.54229693129264,4496,168585,fhi:git
county,Viken,2021-03-18,5918,480,117616,57367,9.39136878146,4.58062383422337,6398,174983,fhi:git
county,Viken,2021-03-19,2047,406,119663,57773,9.55481705291668,4.61304200628561,2453,177436,fhi:git
county,Viken,2021-03-20,6,2,119669,57775,9.55529613920331,4.61320170171449,8,177444,fhi:git
county,Viken,2021-03-21,6,1,119675,57776,9.55577522548995,4.61328154942893,7,177451,fhi:git
county,Viken,2021-03-22,405,24,120080,57800,9.58811354983775,4.61519789457547,429,177880,fhi:git
county,Viken,2021-03-23,2475,81,122555,57881,9.78573664307433,4.62166555944503,2556,180436,fhi:git
county,Viken,2021-03-24,7382,748,129937,58629,10.3751724710632,4.68139164984542,8130,188566,fhi:git
county,Viken,2021-03-25,10225,624,140162,59253,11.1916153512022,4.73121662365537,10849,199415,fhi:git
county,Viken,2021-03-26,5922,316,146084,59569,11.6644735161101,4.7564485014181,6238,205653,fhi:git
county,Viken,2021-03-27,32,1,146116,59570,11.6670286429721,4.75652834913253,33,205686,fhi:git
county,Viken,2021-03-28,5,0,146121,59570,11.6674278815443,4.75652834913253,5,205691,fhi:git
county,Viken,2021-03-29,1332,4,147453,59574,11.7737850371771,4.75684773999029,1336,207027,fhi:git
county,Viken,2021-03-30,6096,1610,153549,61184,12.2605367043974,4.88540256023712,7706,214733,fhi:git
county,Viken,2021-03-31,9919,1840,163468,63024,13.052546183918,5.03232235480492,11759,226492,fhi:git
county,Viken,2021-04-01,3680,478,167148,63502,13.3463857730536,5.07048956230677,4158,230650,fhi:git
county,Viken,2021-04-02,2260,269,169408,63771,13.5268416076858,5.09196859749087,2529,233179,fhi:git
county,Viken,2021-04-03,4,0,169412,63771,13.5271609985436,5.09196859749087,4,233183,fhi:git
county,Viken,2021-04-04,14,0,169426,63771,13.5282788665457,5.09196859749087,14,233197,fhi:git
county,Viken,2021-04-05,51,1,169477,63772,13.5323510999821,5.0920484452053,52,233249,fhi:git
county,Viken,2021-04-06,3403,2133,172880,65905,13.8040728722181,5.26236362010374,5536,238785,fhi:git
county,Viken,2021-04-07,11146,2522,184026,68427,14.6940554973554,5.46373955591895,13668,252453,fhi:git
county,Viken,2021-04-08,14957,1992,198983,70419,15.8883377622199,5.62279620308148,16949,269402,fhi:git
county,Viken,2021-04-09,8525,267,207508,70686,16.5690395278126,5.6441155428367,8792,278194,fhi:git
county,Viken,2021-04-10,244,42,207752,70728,16.5885223701357,5.64746914684314,286,278480,fhi:git
county,Viken,2021-04-11,13,0,207765,70728,16.5895603904234,5.64746914684314,13,278493,fhi:git
county,Viken,2021-04-12,1438,8,209203,70736,16.7043814037867,5.64810792855865,1446,279939,fhi:git
county,Viken,2021-04-13,7662,173,216865,70909,17.3161745918185,5.6619215831566,7835,287774,fhi:git
county,Viken,2021-04-14,14097,786,230962,71695,18.4417878222654,5.72468188670568,14883,302657,fhi:git
county,Viken,2021-04-15,18038,209,249000,71904,19.8820808953165,5.74137005902343,18247,320904,fhi:git
county,Viken,2021-04-16,9710,279,258710,72183,20.6574022025194,5.76364757135192,9989,330893,fhi:git
county,Viken,2021-04-17,287,2,258997,72185,20.6803184965634,5.7638072667808,289,331182,fhi:git
county,Viken,2021-04-18,54,2,259051,72187,20.6846302731431,5.76396696220967,56,331238,fhi:git
county,Viken,2021-04-19,1798,5,260849,72192,20.8281964637044,5.76436620078187,1803,333041,fhi:git
county,Viken,2021-04-20,2976,90,263825,72282,21.065823261875,5.77155249508138,3066,336107,fhi:git
county,Viken,2021-04-21,12779,503,276604,72785,22.0861972046912,5.81171589544421,13282,349389,fhi:git
county,Viken,2021-04-22,10860,528,287464,73313,22.953343383499,5.85387548866801,11388,360777,fhi:git
county,Viken,2021-04-23,4352,330,291816,73643,23.3008406367376,5.88022523443289,4682,365459,fhi:git
county,Viken,2021-04-24,14,3,291830,73646,23.3019585047398,5.88046477757621,17,365476,fhi:git
county,Viken,2021-04-25,2,1,291832,73647,23.3021182001686,5.88054462529065,3,365479,fhi:git
county,Viken,2021-04-26,157,33,291989,73680,23.3146542913356,5.88317959986713,190,365669,fhi:git
county,Viken,2021-04-27,4332,679,296321,74359,23.6605545902854,5.93739619797123,5011,370680,fhi:git
nation,Norge,2020-12-27,5,0,5,0,9.31518486915891e-05,0.0,5,5,fhi:git
nation,Norge,2020-12-28,604,0,609,0,0.0113458951706356,0.0,604,609,fhi:git
nation,Norge,2020-12-29,1067,0,1676,0,0.0312244996814207,0.0,1067,1676,fhi:git
nation,Norge,2020-12-30,427,0,2103,0,0.0391796675596824,0.0,427,2103,fhi:git
nation,Norge,2020-12-31,73,0,2176,0,0.0405396845505796,0.0,73,2176,fhi:git
nation,Norge,2021-01-01,6,0,2182,0,0.0406514667690095,0.0,6,2182,fhi:git
nation,Norge,2021-01-02,0,0,2182,0,0.0406514667690095,0.0,0,2182,fhi:git
nation,Norge,2021-01-03,4,0,2186,0,0.0407259882479628,0.0,4,2186,fhi:git
nation,Norge,2021-01-04,6,0,2192,0,0.0406575769530893,0.0,6,2192,fhi:git
nation,Norge,2021-01-05,3387,0,5579,0,0.103480210684893,0.0,3387,5579,fhi:git
nation,Norge,2021-01-06,9069,0,14648,0,0.271693516062432,0.0,9069,14648,fhi:git
nation,Norge,2021-01-07,6556,0,21204,0,0.393295283628333,0.0,6556,21204,fhi:git
nation,Norge,2021-01-08,1616,0,22820,0,0.423269117732435,0.0,1616,22820,fhi:git
nation,Norge,2021-01-09,137,0,22957,0,0.425810216292003,0.0,137,22957,fhi:git
nation,Norge,2021-01-10,108,0,23065,0,0.427813418076188,0.0,108,23065,fhi:git
nation,Norge,2021-01-11,359,0,23424,0,0.434472209192137,0.0,359,23424,fhi:git
nation,Norge,2021-01-12,4263,0,27687,0,0.513543035173441,0.0,4263,27687,fhi:git
nation,Norge,2021-01-13,9794,0,37481,0,0.695203759935556,0.0,9794,37481,fhi:git
nation,Norge,2021-01-14,8478,0,45959,0,0.852455099994083,0.0,8478,45959,fhi:git
nation,Norge,2021-01-15,4483,0,50442,0,0.935606522202431,0.0,4483,50442,fhi:git
nation,Norge,2021-01-16,750,0,51192,0,0.949517645703716,0.0,750,51192,fhi:git
nation,Norge,2021-01-17,349,5,51541,5,0.955990955172981,9.27408233419007e-05,354,51546,fhi:git
nation,Norge,2021-01-18,1285,283,52826,288,0.97982534677185,0.0053418714244934,1568,53114,fhi:git
nation,Norge,2021-01-19,4591,772,57417,1060,1.06497997076438,0.019661054548483,5363,58477,fhi:git
nation,Norge,2021-01-20,10069,693,67486,1753,1.2517414408103,0.0325149326636704,10762,69239,fhi:git
nation,Norge,2021-01-21,8448,169,75934,1922,1.40843633592878,0.0356495724926266,8617,77856,fhi:git
nation,Norge,2021-01-22,3320,7,79254,1929,1.4700162426278,0.0357794096453053,3327,81183,fhi:git
nation,Norge,2021-01-23,359,0,79613,1929,1.47667503374375,0.0357794096453053,359,81542,fhi:git
nation,Norge,2021-01-24,67,0,79680,1929,1.47791776077653,0.0357794096453053,67,81609,fhi:git
nation,Norge,2021-01-25,581,0,80261,1929,1.48869424444886,0.0357794096453053,581,82190,fhi:git
nation,Norge,2021-01-26,2280,2143,82541,4072,1.53098405989277,0.075528126529644,4423,86613,fhi:git
nation,Norge,2021-01-27,11492,7598,94033,11670,1.74413956826179,0.216457081679996,19090,105703,fhi:git
nation,Norge,2021-01-28,10903,6582,104936,18252,1.94637020764114,0.338541101527274,17485,123188,fhi:git
nation,Norge,2021-01-29,3815,2108,108751,20360,2.01713145585101,0.37764063264822,5923,129111,fhi:git
nation,Norge,2021-01-30,149,174,108900,20534,2.0198951323866,0.380868013300518,323,129434,fhi:git
nation,Norge,2021-01-31,107,52,109007,20586,2.02187978600611,0.381832517863274,159,129593,fhi:git
nation,Norge,2021-02-01,200,304,109207,20890,2.02558941893979,0.387471159922461,504,130097,fhi:git
nation,Norge,2021-02-02,6355,3145,115562,24035,2.14346300540735,0.445805137804517,9500,139597,fhi:git
nation,Norge,2021-02-03,25154,8383,140716,32418,2.61002353947578,0.601294402219548,33537,173134,fhi:git
nation,Norge,2021-02-04,25991,8699,166707,41117,3.09210888737165,0.762644886669786,34690,207824,fhi:git
nation,Norge,2021-02-05,10629,4876,177336,45993,3.28925732963186,0.853085737592808,15505,223329,fhi:git
nation,Norge,2021-02-06,811,738,178147,46731,3.30429989117792,0.866774283118073,1549,224878,fhi:git
nation,Norge,2021-02-07,325,297,178472,47028,3.31032804469514,0.872283088024581,622,225500,fhi:git
nation,Norge,2021-02-08,118,923,178590,47951,3.31251672812601,0.889403044013496,1041,226541,fhi:git
nation,Norge,2021-02-09,5560,3245,184150,51196,3.4156445236822,0.94959183836239,8805,235346,fhi:git
nation,Norge,2021-02-10,23020,8674,207170,59870,3.84262327434832,1.11047861869592,31694,267040,fhi:git
nation,Norge,2021-02-11,20956,8592,228126,68462,4.23131861313889,1.26984444952664,29548,296588,fhi:git
nation,Norge,2021-02-12,8053,3618,236179,72080,4.38068698321336,1.33695170929684,11671,308259,fhi:git
nation,Norge,2021-02-13,898,307,237077,72387,4.39734323508556,1.34264599585003,1205,309464,fhi:git
nation,Norge,2021-02-14,110,4,237187,72391,4.39938353319908,1.34272018850871,114,309578,fhi:git
nation,Norge,2021-02-15,832,751,238019,73142,4.41481560620317,1.35664986017466,1583,311161,fhi:git
nation,Norge,2021-02-16,6117,2179,244136,75321,4.52827472947966,1.39706631098706,8296,319457,fhi:git
nation,Norge,2021-02-17,21804,10290,265940,85611,4.93269891190902,1.58792692542469,32094,351551,fhi:git
nation,Norge,2021-02-18,18914,10843,284854,96454,5.28351889844676,1.78904467492394,29757,381308,fhi:git
nation,Norge,2021-02-19,10737,4808,295591,101262,5.48267054249116,1.87822425064951,15545,396853,fhi:git
nation,Norge,2021-02-20,503,177,296094,101439,5.49200026931935,1.88150727579581,680,397533,fhi:git
nation,Norge,2021-02-21,59,107,296153,101546,5.49309461103479,1.88349192941533,166,397699,fhi:git
nation,Norge,2021-02-22,2576,143,298729,101689,5.54087468322053,1.88614431696291,2719,400418,fhi:git
nation,Norge,2021-02-23,5752,5210,304481,106899,5.64756372639306,1.98278025488517,10962,411380,fhi:git
nation,Norge,2021-02-24,11132,22364,315613,129263,5.85404189548146,2.39759140952882,33496,444876,fhi:git
nation,Norge,2021-02-25,11166,25165,326779,154428,6.0611507021686,2.86435597340861,36331,481207,fhi:git
nation,Norge,2021-02-26,8370,9944,335149,164372,6.21639884044294,3.04879892287098,18314,499521,fhi:git
nation,Norge,2021-02-27,444,204,335593,164576,6.2246342255557,3.05258274846333,648,500169,fhi:git
nation,Norge,2021-02-28,539,160,336132,164736,6.23463168631196,3.05555045481027,699,500868,fhi:git
nation,Norge,2021-03-01,5926,63,342058,164799,6.34454811013678,3.05671898918438,5989,506857,fhi:git
nation,Norge,2021-03-02,10534,3834,352592,168633,6.53993447675349,3.12783265252295,14368,521225,fhi:git
nation,Norge,2021-03-03,17692,18105,370284,186738,6.86808860606647,3.46364717384397,35797,557022,fhi:git
nation,Norge,2021-03-04,16278,18515,386562,205253,7.17001563053837,3.80706644267903,34793,591815,fhi:git
nation,Norge,2021-03-05,11940,6548,398502,211801,7.39148071667883,3.92851982492758,18488,610303,fhi:git
nation,Norge,2021-03-06,400,482,398902,212283,7.39889998254618,3.93746004029774,882,611185,fhi:git
nation,Norge,2021-03-07,96,2,398998,212285,7.40068060635434,3.93749713662708,98,611283,fhi:git
nation,Norge,2021-03-08,4937,48,403935,212333,7.49225289532213,3.93838744853116,4985,616268,fhi:git
nation,Norge,2021-03-09,12481,4276,416416,216609,7.72375253854819,4.01769940065316,16757,633025,fhi:git
nation,Norge,2021-03-10,21124,17276,437540,233885,8.11556396900305,4.33813749346409,38400,671425,fhi:git
nation,Norge,2021-03-11,12042,16629,449582,250514,8.33892096793968,4.64657492373458,28671,700096,fhi:git
nation,Norge,2021-03-12,2327,8332,451909,258846,8.382082547123,4.80111823175153,10659,710755,fhi:git
nation,Norge,2021-03-13,48,305,451957,259151,8.38297285902709,4.80677542197538,353,711108,fhi:git
nation,Norge,2021-03-14,6,109,451963,259260,8.3830841480151,4.80879717192424,115,711223,fhi:git
nation,Norge,2021-03-15,102,439,452065,259699,8.38497606081127,4.81693981621366,541,711764,fhi:git
nation,Norge,2021-03-16,5670,693,457735,260392,8.49014415448099,4.82979369432884,6363,718127,fhi:git
nation,Norge,2021-03-17,23066,1681,480801,262073,8.91797612072184,4.86097315913639,24747,742874,fhi:git
nation,Norge,2021-03-18,21015,1469,501816,263542,9.30776580122785,4.88822041303424,22484,765358,fhi:git
nation,Norge,2021-03-19,6805,1014,508621,264556,9.43398606179618,4.90702825200798,7819,773177,fhi:git
nation,Norge,2021-03-20,460,22,509081,264578,9.44251821754363,4.90743631163068,482,773659,fhi:git
nation,Norge,2021-03-21,188,70,509269,264648,9.44600527250129,4.90873468315747,258,773917,fhi:git
nation,Norge,2021-03-22,1513,85,510782,264733,9.47406864564455,4.91031127715428,1598,775515,fhi:git
nation,Norge,2021-03-23,13116,955,523898,265688,9.71734637343502,4.92802477441258,14071,789586,fhi:git
nation,Norge,2021-03-24,39130,3684,563028,269372,10.4431360569087,4.9963562130509,42814,832400,fhi:git
nation,Norge,2021-03-25,38757,2347,601785,271719,11.1620072749611,5.03988875552759,41104,873504,fhi:git
nation,Norge,2021-03-26,17394,1156,619179,272875,11.484634051203,5.06133043388423,18550,892054,fhi:git
nation,Norge,2021-03-27,711,6,619890,272881,11.4978217962822,5.06144172287224,717,892771,fhi:git
nation,Norge,2021-03-28,330,5,620220,272886,11.5039426906227,5.06153446369559,335,893106,fhi:git
nation,Norge,2021-03-29,4753,27,624973,272913,11.5921021172915,5.06203526414163,4780,897886,fhi:git
nation,Norge,2021-03-30,32207,4039,657180,276952,12.1894828567661,5.13695130123722,36246,934132,fhi:git
nation,Norge,2021-03-31,36729,7083,693909,284035,12.870738396871,5.26832795158336,43812,977944,fhi:git
nation,Norge,2021-04-01,9416,1473,703325,285508,13.0453879153885,5.29564939813988,10889,988833,fhi:git
nation,Norge,2021-04-02,4306,692,707631,286200,13.1252563124505,5.3084847280904,4998,993831,fhi:git
nation,Norge,2021-04-03,267,7,707898,286207,13.130208672417,5.30861456524308,274,994105,fhi:git
nation,Norge,2021-04-04,388,43,708286,286250,13.1374053603083,5.30941213632382,431,994536,fhi:git
nation,Norge,2021-04-05,1317,59,709603,286309,13.1618332931766,5.31050647803925,1376,995912,fhi:git
nation,Norge,2021-04-06,18636,2614,728239,288923,13.5074968899365,5.3589913804824,21250,1017162,fhi:git
nation,Norge,2021-04-07,58453,3677,786692,292600,14.5916927592973,5.42719298196803,62130,1079292,fhi:git
nation,Norge,2021-04-08,57295,4149,843987,296749,15.6544098539722,5.50414931717714,61444,1140736,fhi:git
nation,Norge,2021-04-09,27348,646,871335,297395,16.161665061323,5.51613143155291,27994,1168730,fhi:git
nation,Norge,2021-04-10,1043,47,872378,297442,16.1810107970721,5.51700319529233,1090,1169820,fhi:git
nation,Norge,2021-04-11,554,7,872932,297449,16.1912864802984,5.51713303244501,561,1170381,fhi:git
nation,Norge,2021-04-12,3620,84,876552,297533,16.258430836398,5.51869107827715,3704,1174085,fhi:git
nation,Norge,2021-04-13,25489,391,902041,297924,16.7312050056303,5.52594341066249,25880,1199965,fhi:git
nation,Norge,2021-04-14,66870,1444,968911,299368,17.9715207770049,5.55272696044363,68314,1268279,fhi:git
nation,Norge,2021-04-15,64943,1231,1033854,300599,19.1760942350635,5.5755597511504,66174,1334453,fhi:git
nation,Norge,2021-04-16,28712,837,1062566,301436,19.708649139022,5.59108456497784,29549,1364002,fhi:git
nation,Norge,2021-04-17,1964,159,1064530,301595,19.7450777344307,5.59403372316011,2123,1366125,fhi:git
nation,Norge,2021-04-18,1248,13,1065778,301608,19.7682258439369,5.5942748493008,1261,1367386,fhi:git
nation,Norge,2021-04-19,6337,143,1072115,301751,19.8857655634404,5.59692723684838,6480,1373866,fhi:git
nation,Norge,2021-04-20,19366,737,1091481,302488,20.2449693204082,5.61059723420897,20103,1393969,fhi:git
nation,Norge,2021-04-21,58529,2771,1150010,305259,21.3305748502839,5.66199419850506,61300,1455269,fhi:git
nation,Norge,2021-04-22,50471,2253,1200481,307512,22.2667192692617,5.70378321350292,52724,1507993,fhi:git
nation,Norge,2021-04-23,17922,1316,1218403,308828,22.5991394764484,5.7281925982065,19238,1527231,fhi:git
nation,Norge,2021-04-24,314,29,1218717,308857,22.6049636001543,5.72873049498189,343,1527574,fhi:git
nation,Norge,2021-04-25,284,4,1219001,308861,22.6102312789201,5.72880468764056,288,1527862,fhi:git
nation,Norge,2021-04-26,2242,461,1221243,309322,22.6518162641066,5.73735539155268,2703,1530565,fhi:git
nation,Norge,2021-04-27,17615,5318,1238858,314640,22.9785421847401,5.83599453125913,22933,1553498,fhi:git
