granularity_geo,location_name,date,new_dose_1,new_dose_2,total_dose_1,total_dose_2,total_pr100_dose_1,total_pr100_dose_2,new_doses,total_doses,source
county,Agder,2020-12-27,0,0,0,0,0.0,0.0,0,0,fhi:git
county,Agder,2020-12-28,0,0,0,0,0.0,0.0,0,0,fhi:git
county,Agder,2020-12-29,0,0,0,0,0.0,0.0,0,0,fhi:git
county,Agder,2020-12-30,0,0,0,0,0.0,0.0,0,0,fhi:git
county,Agder,2020-12-31,0,0,0,0,0.0,0.0,0,0,fhi:git
county,Agder,2021-01-01,0,0,0,0,0.0,0.0,0,0,fhi:git
county,Agder,2021-01-02,0,0,0,0,0.0,0.0,0,0,fhi:git
county,Agder,2021-01-03,3,0,3,0,0.0009764639635974,0.0,3,3,fhi:git
county,Agder,2021-01-04,0,0,3,0,0.0009713673290312,0.0,0,3,fhi:git
county,Agder,2021-01-05,79,0,82,0,0.026550706993521,0.0,79,82,fhi:git
county,Agder,2021-01-06,794,0,876,0,0.283639260077127,0.0,794,876,fhi:git
county,Agder,2021-01-07,230,0,1106,0,0.358110755302856,0.0,230,1106,fhi:git
county,Agder,2021-01-08,49,0,1155,0,0.373976421677033,0.0,49,1155,fhi:git
county,Agder,2021-01-09,0,0,1155,0,0.373976421677033,0.0,0,1155,fhi:git
county,Agder,2021-01-10,0,0,1155,0,0.373976421677033,0.0,0,1155,fhi:git
county,Agder,2021-01-11,1,0,1156,0,0.37430021078671,0.0,1,1156,fhi:git
county,Agder,2021-01-12,226,0,1382,0,0.447476549573732,0.0,226,1382,fhi:git
county,Agder,2021-01-13,861,0,2243,0,0.726258973005702,0.0,861,2243,fhi:git
county,Agder,2021-01-14,517,0,2760,0,0.893657942708755,0.0,517,2760,fhi:git
county,Agder,2021-01-15,119,0,2879,0,0.932188846760328,0.0,119,2879,fhi:git
county,Agder,2021-01-16,1,0,2880,0,0.932512635870005,0.0,1,2880,fhi:git
county,Agder,2021-01-17,2,0,2882,0,0.933160214089359,0.0,2,2882,fhi:git
county,Agder,2021-01-18,15,0,2897,0,0.938017050734516,0.0,15,2897,fhi:git
county,Agder,2021-01-19,346,0,3243,0,1.05004808268279,0.0,346,3243,fhi:git
county,Agder,2021-01-20,461,0,3704,0,1.19931486224392,0.0,461,3704,fhi:git
county,Agder,2021-01-21,341,0,4045,0,1.30972694864381,0.0,341,4045,fhi:git
county,Agder,2021-01-22,67,0,4112,0,1.33142081899217,0.0,67,4112,fhi:git
county,Agder,2021-01-23,1,0,4113,0,1.33174460810185,0.0,1,4113,fhi:git
county,Agder,2021-01-24,0,0,4113,0,1.33174460810185,0.0,0,4113,fhi:git
county,Agder,2021-01-25,3,0,4116,0,1.33271597543088,0.0,3,4116,fhi:git
county,Agder,2021-01-26,63,66,4179,66,1.35311468934054,0.0213700812386876,129,4245,fhi:git
county,Agder,2021-01-27,567,681,4746,747,1.53670311452745,0.241870464928783,1248,5493,fhi:git
county,Agder,2021-01-28,956,251,5702,998,1.84624550337874,0.323141531457731,1207,6700,fhi:git
county,Agder,2021-01-29,204,61,5906,1059,1.91229848175286,0.342892667148033,265,6965,fhi:git
county,Agder,2021-01-30,33,0,5939,1059,1.92298352237221,0.342892667148033,33,6998,fhi:git
county,Agder,2021-01-31,26,0,5965,1059,1.93140203922381,0.342892667148033,26,7024,fhi:git
county,Agder,2021-02-01,1,2,5966,1061,1.93172582833349,0.343540245367387,3,7027,fhi:git
county,Agder,2021-02-02,203,170,6169,1231,1.99745501759794,0.398584394012492,373,7400,fhi:git
county,Agder,2021-02-03,1335,602,7504,1833,2.42971347901685,0.593505438038097,1937,9337,fhi:git
county,Agder,2021-02-04,1710,507,9214,2340,2.98339285656466,0.757666516644379,2217,11554,fhi:git
county,Agder,2021-02-05,621,135,9835,2475,3.18446589367413,0.801378046450786,756,12310,fhi:git
county,Agder,2021-02-06,511,2,10346,2477,3.34992212871912,0.80202562467014,513,12823,fhi:git
county,Agder,2021-02-07,87,2,10433,2479,3.37809178126103,0.802673202889494,89,12912,fhi:git
county,Agder,2021-02-08,13,2,10446,2481,3.38230103968683,0.803320781108848,15,12927,fhi:git
county,Agder,2021-02-09,189,255,10635,2736,3.4434971814158,0.885887004076505,444,13371,fhi:git
county,Agder,2021-02-10,1154,371,11789,3107,3.81714981398316,1.0060127637667,1525,14896,fhi:git
county,Agder,2021-02-11,1008,416,12797,3523,4.14352923653766,1.14070903339237,1424,16320,fhi:git
county,Agder,2021-02-12,358,70,13155,3593,4.25944573780205,1.16337427106977,428,16748,fhi:git
county,Agder,2021-02-13,510,2,13665,3595,4.42457818373737,1.16402184928912,512,17260,fhi:git
county,Agder,2021-02-14,0,0,13665,3595,4.42457818373737,1.16402184928912,0,17260,fhi:git
county,Agder,2021-02-15,2,1,13667,3596,4.42522576195672,1.1643456383988,3,17263,fhi:git
county,Agder,2021-02-16,142,117,13809,3713,4.47120381553087,1.20222896423102,259,17522,fhi:git
county,Agder,2021-02-17,1222,435,15031,4148,4.86687410755627,1.34307722694055,1657,19179,fhi:git
county,Agder,2021-02-18,1083,829,16114,4977,5.21753771333655,1.61149839886285,1912,21091,fhi:git
county,Agder,2021-02-19,720,343,16834,5320,5.45066587230405,1.72255806348209,1063,22154,fhi:git
county,Agder,2021-02-20,355,38,17189,5358,5.56561100623942,1.73486204964982,393,22547,fhi:git
county,Agder,2021-02-21,52,25,17241,5383,5.58244803994263,1.74295677739175,77,22624,fhi:git
county,Agder,2021-02-22,223,1,17464,5384,5.65465301140061,1.74328056650143,224,22848,fhi:git
county,Agder,2021-02-23,294,201,17758,5585,5.74984700964568,1.80836217754652,495,23343,fhi:git
county,Agder,2021-02-24,977,1113,18735,6698,6.06618896980019,2.16873945661712,2090,25433,fhi:git
county,Agder,2021-02-25,719,1569,19454,8267,6.29899333965801,2.67676456970046,2288,27721,fhi:git
county,Agder,2021-02-26,400,466,19854,8733,6.42850898352885,2.82765029480998,866,28587,fhi:git
county,Agder,2021-02-27,0,1,19854,8734,6.42850898352885,2.82797408391966,1,28588,fhi:git
county,Agder,2021-02-28,10,82,19864,8816,6.43174687462562,2.85452479091318,92,28680,fhi:git
county,Agder,2021-03-01,263,0,20127,8816,6.51690341047069,2.85452479091318,263,28943,fhi:git
county,Agder,2021-03-02,578,192,20705,9008,6.70405351586405,2.91669229997118,770,29713,fhi:git
county,Agder,2021-03-03,636,880,21341,9888,6.90998338961867,3.20162671648702,1516,31229,fhi:git
county,Agder,2021-03-04,796,1070,22137,10958,7.16771952092163,3.5480810638415,1866,33095,fhi:git
county,Agder,2021-03-05,960,384,23097,11342,7.47855706621164,3.6724160819575,1344,34439,fhi:git
county,Agder,2021-03-06,36,405,23133,11747,7.49021347416001,3.80355067137672,441,34880,fhi:git
county,Agder,2021-03-07,5,1,23138,11748,7.4918324197084,3.8038744604864,6,34886,fhi:git
county,Agder,2021-03-08,226,0,23364,11748,7.56500875849542,3.8038744604864,226,35112,fhi:git
county,Agder,2021-03-09,724,141,24088,11889,7.79943207390163,3.84952872495087,865,35977,fhi:git
county,Agder,2021-03-10,1037,785,25125,12674,8.13520138063676,4.10370317604738,1822,37799,fhi:git
county,Agder,2021-03-11,649,814,25774,13488,8.34534051281719,4.36726751132452,1463,39262,fhi:git
county,Agder,2021-03-12,99,328,25873,13816,8.37739563467522,4.47347033929861,427,39689,fhi:git
county,Agder,2021-03-13,1,0,25874,13816,8.3777194237849,4.47347033929861,1,39690,fhi:git
county,Agder,2021-03-14,0,0,25874,13816,8.3777194237849,4.47347033929861,0,39690,fhi:git
county,Agder,2021-03-15,1,3,25875,13819,8.37804321289458,4.47444170662764,4,39694,fhi:git
county,Agder,2021-03-16,243,14,26118,13833,8.45672396654611,4.47897475416312,257,39951,fhi:git
county,Agder,2021-03-17,1611,48,27729,13881,8.97834822223589,4.49451663142762,1659,41610,fhi:git
county,Agder,2021-03-18,1247,94,28976,13975,9.38211324200322,4.52495280773726,1341,42951,fhi:git
county,Agder,2021-03-19,266,41,29242,14016,9.46824114517732,4.53822816123403,307,43258,fhi:git
county,Agder,2021-03-20,0,0,29242,14016,9.46824114517732,4.53822816123403,0,43258,fhi:git
county,Agder,2021-03-21,17,53,29259,14069,9.47374556004183,4.55538898404691,70,43328,fhi:git
county,Agder,2021-03-22,9,1,29268,14070,9.47665966202893,4.55571277315659,10,43338,fhi:git
county,Agder,2021-03-23,314,14,29582,14084,9.57832944246753,4.56024582069207,328,43666,fhi:git
county,Agder,2021-03-24,2267,78,31849,14162,10.3123593541055,4.58550137124688,2345,46011,fhi:git
county,Agder,2021-03-25,2038,54,33887,14216,10.9722415596274,4.60298598316944,2092,48103,fhi:git
county,Agder,2021-03-26,776,12,34663,14228,11.2235019087368,4.60687145248557,788,48891,fhi:git
county,Agder,2021-03-27,1,0,34664,14228,11.2238256978465,4.60687145248557,1,48892,fhi:git
county,Agder,2021-03-28,173,1,34837,14229,11.2798412138206,4.60719524159524,174,49066,fhi:git
county,Agder,2021-03-29,107,0,34944,14229,11.3144866485561,4.60719524159524,107,49173,fhi:git
county,Agder,2021-03-30,690,71,35634,14300,11.5379011342333,4.63018426838232,761,49934,fhi:git
county,Agder,2021-03-31,3377,403,39011,14703,12.6313369576128,4.76067127958218,3780,53714,fhi:git
county,Agder,2021-04-01,237,49,39248,14752,12.7080749766062,4.77653694595636,286,54000,fhi:git
county,Agder,2021-04-02,1,0,39249,14752,12.7083987657159,4.77653694595636,1,54001,fhi:git
county,Agder,2021-04-03,14,0,39263,14752,12.7129318132514,4.77653694595636,14,54015,fhi:git
county,Agder,2021-04-04,1,5,39264,14757,12.7132556023611,4.77815589150475,6,54021,fhi:git
county,Agder,2021-04-05,0,0,39264,14757,12.7132556023611,4.77815589150475,0,54021,fhi:git
county,Agder,2021-04-06,619,1,39883,14758,12.9136810612512,4.77847968061442,620,54641,fhi:git
county,Agder,2021-04-07,3664,60,43547,14818,14.100044359108,4.79790702719505,3724,58365,fhi:git
county,Agder,2021-04-08,3505,83,47052,14901,15.2349251885262,4.82478152329825,3588,61953,fhi:git
county,Agder,2021-04-09,900,1,47952,14902,15.5263353872356,4.82510531240792,901,62854,fhi:git
county,Agder,2021-04-10,0,1,47952,14903,15.5263353872356,4.8254291015176,1,62855,fhi:git
county,Agder,2021-04-11,164,0,48116,14903,15.5794368012226,4.8254291015176,164,63019,fhi:git
county,Agder,2021-04-12,35,2,48151,14905,15.5907694200613,4.82607667973695,37,63056,fhi:git
county,Agder,2021-04-13,764,6,48915,14911,15.8381442998546,4.82801941439502,770,63826,fhi:git
county,Agder,2021-04-14,4191,33,53106,14944,17.1951444585113,4.83870445501436,4224,68050,fhi:git
county,Agder,2021-04-15,4771,38,57877,14982,18.7399423007807,4.85100844118209,4809,72859,fhi:git
county,Agder,2021-04-16,1715,4,59592,14986,19.2952406238769,4.8523035976208,1719,74578,fhi:git
county,Agder,2021-04-17,2,0,59594,14986,19.2958882020962,4.8523035976208,2,74580,fhi:git
county,Agder,2021-04-18,216,8,59810,14994,19.3658266497865,4.85489391049821,224,74804,fhi:git
county,Agder,2021-04-19,2,0,59812,14994,19.3664742280058,4.85489391049821,2,74806,fhi:git
county,Agder,2021-04-20,446,10,60258,15004,19.5108841709218,4.85813180159499,456,75262,fhi:git
county,Agder,2021-04-21,3408,91,63666,15095,20.6143574567013,4.8875966105756,3499,78761,fhi:git
county,Agder,2021-04-22,3768,51,67434,15146,21.8343948219646,4.90410985516913,3819,82580,fhi:git
county,Agder,2021-04-23,710,17,68144,15163,22.0642850898353,4.90961427003364,727,83307,fhi:git
county,Agder,2021-04-24,2,0,68146,15163,22.0649326680546,4.90961427003364,2,83309,fhi:git
county,Agder,2021-04-25,199,3,68345,15166,22.1293667008804,4.91058563736267,202,83511,fhi:git
county,Agder,2021-04-26,3,0,68348,15166,22.1303380682094,4.91058563736267,3,83514,fhi:git
county,Agder,2021-04-27,550,237,68898,15403,22.3084220785318,4.98732365635614,787,84301,fhi:git
county,Agder,2021-04-28,3380,1429,72278,16832,23.4028292692404,5.4500182940847,4809,89110,fhi:git
county,Agder,2021-04-29,3656,1243,75934,18075,24.5866022542198,5.85248815741331,4899,94009,fhi:git
county,Agder,2021-04-30,1667,315,77601,18390,25.1263587000515,5.9544817269616,1982,95991,fhi:git
county,Agder,2021-05-01,0,0,77601,18390,25.1263587000515,5.9544817269616,0,95991,fhi:git
county,Agder,2021-05-02,3,25,77604,18415,25.1273300673805,5.96257645470352,28,96019,fhi:git
county,Agder,2021-05-03,11,1,77615,18416,25.130891747587,5.9629002438132,12,96031,fhi:git
county,Agder,2021-05-04,305,158,77920,18574,25.2296474260385,6.01405892314218,463,96494,fhi:git
county,Innlandet,2020-12-27,0,0,0,0,0.0,0.0,0,0,fhi:git
county,Innlandet,2020-12-28,272,0,272,0,0.0732393607711674,0.0,272,272,fhi:git
county,Innlandet,2020-12-29,260,0,532,0,0.143247573273019,0.0,260,532,fhi:git
county,Innlandet,2020-12-30,149,0,681,0,0.183367664283695,0.0,149,681,fhi:git
county,Innlandet,2020-12-31,0,0,681,0,0.183367664283695,0.0,0,681,fhi:git
county,Innlandet,2021-01-01,0,0,681,0,0.183367664283695,0.0,0,681,fhi:git
county,Innlandet,2021-01-02,0,0,681,0,0.183367664283695,0.0,0,681,fhi:git
county,Innlandet,2021-01-03,0,0,681,0,0.183367664283695,0.0,0,681,fhi:git
county,Innlandet,2021-01-04,0,0,681,0,0.183754583745949,0.0,0,681,fhi:git
county,Innlandet,2021-01-05,270,0,951,0,0.256608823997647,0.0,270,951,fhi:git
county,Innlandet,2021-01-06,703,0,1654,0,0.446299679171512,0.0,703,1654,fhi:git
county,Innlandet,2021-01-07,695,0,2349,0,0.633831890189772,0.0,695,2349,fhi:git
county,Innlandet,2021-01-08,75,0,2424,0,0.654069179148577,0.0,75,2424,fhi:git
county,Innlandet,2021-01-09,0,0,2424,0,0.654069179148577,0.0,0,2424,fhi:git
county,Innlandet,2021-01-10,0,0,2424,0,0.654069179148577,0.0,0,2424,fhi:git
county,Innlandet,2021-01-11,50,0,2474,0,0.667560705121113,0.0,50,2474,fhi:git
county,Innlandet,2021-01-12,406,0,2880,0,0.777111896018111,0.0,406,2880,fhi:git
county,Innlandet,2021-01-13,993,0,3873,0,1.04505360183269,0.0,993,3873,fhi:git
county,Innlandet,2021-01-14,958,0,4831,0,1.30355123946649,0.0,958,4831,fhi:git
county,Innlandet,2021-01-15,281,0,5112,0,1.37937361543215,0.0,281,5112,fhi:git
county,Innlandet,2021-01-16,4,0,5116,0,1.38045293750995,0.0,4,5116,fhi:git
county,Innlandet,2021-01-17,0,0,5116,0,1.38045293750995,0.0,0,5116,fhi:git
county,Innlandet,2021-01-18,61,0,5177,0,1.39691259919644,0.0,61,5177,fhi:git
county,Innlandet,2021-01-19,331,318,5508,318,1.48622650113464,0.0858061051853331,649,5826,fhi:git
county,Innlandet,2021-01-20,663,252,6171,570,1.66512413553047,0.153803396086918,915,6741,fhi:git
county,Innlandet,2021-01-21,834,48,7005,618,1.89016278875238,0.166755261020553,882,7623,fhi:git
county,Innlandet,2021-01-22,239,0,7244,618,1.95465228290111,0.166755261020553,239,7862,fhi:git
county,Innlandet,2021-01-23,6,0,7250,618,1.95627126601781,0.166755261020553,6,7868,fhi:git
county,Innlandet,2021-01-24,0,0,7250,618,1.95627126601781,0.166755261020553,0,7868,fhi:git
county,Innlandet,2021-01-25,1,0,7251,618,1.95654109653727,0.166755261020553,1,7869,fhi:git
county,Innlandet,2021-01-26,152,130,7403,748,1.99755533549378,0.201833228549148,282,8151,fhi:git
county,Innlandet,2021-01-27,934,604,8337,1352,2.24957704066076,0.364810862297391,1538,9689,fhi:git
county,Innlandet,2021-01-28,903,707,9240,2059,2.49323399972477,0.555581039549059,1610,11299,fhi:git
county,Innlandet,2021-01-29,318,132,9558,2191,2.57904010491011,0.591198668116556,450,11749,fhi:git
county,Innlandet,2021-01-30,2,0,9560,2191,2.57957976594901,0.591198668116556,2,11751,fhi:git
county,Innlandet,2021-01-31,2,0,9562,2191,2.58011942698791,0.591198668116556,2,11753,fhi:git
county,Innlandet,2021-02-01,9,49,9571,2240,2.58254790166297,0.604420363569642,58,11811,fhi:git
county,Innlandet,2021-02-02,611,341,10182,2581,2.74741434904736,0.696432570702342,952,12763,fhi:git
county,Innlandet,2021-02-03,2313,872,12495,3453,3.37153234053691,0.931724783663381,3185,15948,fhi:git
county,Innlandet,2021-02-04,2657,1000,15152,4453,4.08847203071751,1.20155530311411,3657,19605,fhi:git
county,Innlandet,2021-02-05,814,272,15966,4725,4.3081140735504,1.27494920440471,1086,20691,fhi:git
county,Innlandet,2021-02-06,8,4,15974,4729,4.31027271770601,1.27602852648252,12,20703,fhi:git
county,Innlandet,2021-02-07,0,0,15974,4729,4.31027271770601,1.27602852648252,0,20703,fhi:git
county,Innlandet,2021-02-08,2,61,15976,4790,4.31081237874491,1.29248818816901,63,20766,fhi:git
county,Innlandet,2021-02-09,259,269,16235,5059,4.38069848328265,1.36507259790126,528,21294,fhi:git
county,Innlandet,2021-02-10,2057,591,18292,5650,4.93573986179281,1.52454243489664,2648,23942,fhi:git
county,Innlandet,2021-02-11,2240,848,20532,6498,5.54016022536245,1.75335871539086,3088,27030,fhi:git
county,Innlandet,2021-02-12,430,283,20962,6781,5.65618734872627,1.82972075239542,713,27743,fhi:git
county,Innlandet,2021-02-13,0,5,20962,6786,5.65618734872627,1.83106990499267,5,27748,fhi:git
county,Innlandet,2021-02-14,1,1,20963,6787,5.65645717924572,1.83133973551212,2,27750,fhi:git
county,Innlandet,2021-02-15,85,14,21048,6801,5.67939277339903,1.83511736278444,99,27849,fhi:git
county,Innlandet,2021-02-16,613,92,21661,6893,5.84479888182233,1.8599417705739,705,28554,fhi:git
county,Innlandet,2021-02-17,1574,783,23235,7676,6.26951211943778,2.07121906730383,2357,30911,fhi:git
county,Innlandet,2021-02-18,1464,904,24699,8580,6.66454399991365,2.31514585688729,2368,33279,fhi:git
county,Innlandet,2021-02-19,540,295,25239,8875,6.81025248041705,2.39474586012526,835,34114,fhi:git
county,Innlandet,2021-02-20,0,3,25239,8878,6.81025248041705,2.39555535168361,3,34117,fhi:git
county,Innlandet,2021-02-21,0,2,25239,8880,6.81025248041705,2.39609501272251,2,34119,fhi:git
county,Innlandet,2021-02-22,285,3,25524,8883,6.88715417846051,2.39690450428086,288,34407,fhi:git
county,Innlandet,2021-02-23,319,307,25843,9190,6.97323011416529,2.47974247375224,626,35033,fhi:git
county,Innlandet,2021-02-24,859,2321,26702,11511,7.20501453037347,3.10601910939739,3180,38213,fhi:git
county,Innlandet,2021-02-25,1752,2477,28454,13988,7.67775760045116,3.77438930607685,4229,42442,fhi:git
county,Innlandet,2021-02-26,679,815,29133,14803,7.8609725231582,3.9943011794292,1494,43936,fhi:git
county,Innlandet,2021-02-27,3,1,29136,14804,7.86178201471656,3.99457100994865,4,43940,fhi:git
county,Innlandet,2021-02-28,3,6,29139,14810,7.86259150627491,3.99618999306536,9,43949,fhi:git
county,Innlandet,2021-03-01,189,7,29328,14817,7.9135894744511,3.99807880670151,196,44145,fhi:git
county,Innlandet,2021-03-02,529,160,29857,14977,8.05632981924054,4.04125168981363,689,44834,fhi:git
county,Innlandet,2021-03-03,1600,1976,31457,16953,8.48805865036171,4.57443679624828,3576,48410,fhi:git
county,Innlandet,2021-03-04,1517,2292,32974,19245,8.89739154836847,5.19288834682936,3809,52219,fhi:git
county,Innlandet,2021-03-05,551,420,33525,19665,9.04606816458582,5.30621716499867,971,53190,fhi:git
county,Innlandet,2021-03-06,7,4,33532,19669,9.04795697822198,5.30729648707647,11,53201,fhi:git
county,Innlandet,2021-03-07,0,0,33532,19669,9.04795697822198,5.30729648707647,0,53201,fhi:git
county,Innlandet,2021-03-08,111,0,33643,19669,9.07790816588101,5.30729648707647,111,53312,fhi:git
county,Innlandet,2021-03-09,938,311,34581,19980,9.3310091931258,5.39121377862565,1249,54561,fhi:git
county,Innlandet,2021-03-10,2033,1307,36614,21287,9.87957463916914,5.74388226754775,3340,57901,fhi:git
county,Innlandet,2021-03-11,1016,971,37630,22258,10.1537224469311,6.00588770193442,1987,59888,fhi:git
county,Innlandet,2021-03-12,45,180,37675,22438,10.1658648203064,6.05445719543555,225,60113,fhi:git
county,Innlandet,2021-03-13,0,0,37675,22438,10.1658648203064,6.05445719543555,0,60113,fhi:git
county,Innlandet,2021-03-14,0,7,37675,22445,10.1658648203064,6.0563460090717,7,60120,fhi:git
county,Innlandet,2021-03-15,25,3,37700,22448,10.1726105832926,6.05715550063006,28,60148,fhi:git
county,Innlandet,2021-03-16,366,9,38066,22457,10.2713685534116,6.05958397530511,375,60523,fhi:git
county,Innlandet,2021-03-17,1810,159,39876,22616,10.7597617936174,6.10248702789778,1969,62492,fhi:git
county,Innlandet,2021-03-18,1654,106,41530,22722,11.2060614727889,6.13108906295956,1760,64252,fhi:git
county,Innlandet,2021-03-19,192,23,41722,22745,11.2578689325235,6.13729516490692,215,64467,fhi:git
county,Innlandet,2021-03-20,0,0,41722,22745,11.2578689325235,6.13729516490692,0,64467,fhi:git
county,Innlandet,2021-03-21,1,0,41723,22745,11.2581387630429,6.13729516490692,1,64468,fhi:git
county,Innlandet,2021-03-22,99,9,41822,22754,11.2848519844686,6.13972363958198,108,64576,fhi:git
county,Innlandet,2021-03-23,812,51,42634,22805,11.5039543662626,6.15348499607397,863,65439,fhi:git
county,Innlandet,2021-03-24,3250,527,45884,23332,12.3809035544774,6.2956856798245,3777,69216,fhi:git
county,Innlandet,2021-03-25,3198,321,49082,23653,13.2438215556809,6.38230127656819,3519,72735,fhi:git
county,Innlandet,2021-03-26,676,52,49758,23705,13.4262269868296,6.39633246357963,728,73463,fhi:git
county,Innlandet,2021-03-27,0,0,49758,23705,13.4262269868296,6.39633246357963,0,73463,fhi:git
county,Innlandet,2021-03-28,0,0,49758,23705,13.4262269868296,6.39633246357963,0,73463,fhi:git
county,Innlandet,2021-03-29,397,2,50155,23707,13.5333497030515,6.39687212461853,399,73862,fhi:git
county,Innlandet,2021-03-30,2888,227,53043,23934,14.3126202432252,6.45812365253384,3115,76977,fhi:git
county,Innlandet,2021-03-31,2849,566,55892,24500,15.0813673931404,6.61084772654296,3415,80392,fhi:git
county,Innlandet,2021-04-01,88,18,55980,24518,15.105112478852,6.61570467589307,106,80498,fhi:git
county,Innlandet,2021-04-02,6,1,55986,24519,15.1067314619687,6.61597450641252,7,80505,fhi:git
county,Innlandet,2021-04-03,2,6,55988,24525,15.1072711230076,6.61759348952923,8,80513,fhi:git
county,Innlandet,2021-04-04,0,0,55988,24525,15.1072711230076,6.61759348952923,0,80513,fhi:git
county,Innlandet,2021-04-05,11,2,55999,24527,15.1102392587216,6.61813315056813,13,80526,fhi:git
county,Innlandet,2021-04-06,510,35,56509,24562,15.2478528236415,6.6275772187489,545,81071,fhi:git
county,Innlandet,2021-04-07,4314,90,60823,24652,16.4119016845519,6.65186196549947,4404,85475,fhi:git
county,Innlandet,2021-04-08,4576,93,65399,24745,17.6466461415585,6.67695620380839,4669,90144,fhi:git
county,Innlandet,2021-04-09,1535,13,66934,24758,18.0608359889154,6.68046400056125,1548,91692,fhi:git
county,Innlandet,2021-04-10,2,0,66936,24758,18.0613756499543,6.68046400056125,2,91694,fhi:git
county,Innlandet,2021-04-11,0,0,66936,24758,18.0613756499543,6.68046400056125,0,91694,fhi:git
county,Innlandet,2021-04-12,9,11,66945,24769,18.0638041246293,6.68343213627521,20,91714,fhi:git
county,Innlandet,2021-04-13,1279,8,68224,24777,18.4089173590068,6.68559078043081,1287,93001,fhi:git
county,Innlandet,2021-04-14,4745,59,72969,24836,19.6892631738005,6.7015107810784,4804,97805,fhi:git
county,Innlandet,2021-04-15,5601,111,78570,24947,21.2005839132441,6.73146196873744,5712,103517,fhi:git
county,Innlandet,2021-04-16,872,33,79442,24980,21.4358761262051,6.74036637587931,905,104422,fhi:git
county,Innlandet,2021-04-17,3,0,79445,24980,21.4366856177635,6.74036637587931,3,104425,fhi:git
county,Innlandet,2021-04-18,0,0,79445,24980,21.4366856177635,6.74036637587931,0,104425,fhi:git
county,Innlandet,2021-04-19,65,7,79510,24987,21.4542246015278,6.74225518951547,72,104497,fhi:git
county,Innlandet,2021-04-20,1399,15,80909,25002,21.8317174982394,6.74630264730723,1414,105911,fhi:git
county,Innlandet,2021-04-21,4196,154,85105,25156,22.9639263578546,6.78785654730264,4350,110261,fhi:git
county,Innlandet,2021-04-22,4783,55,89888,25211,24.2545257323875,6.80269722587243,4838,115099,fhi:git
county,Innlandet,2021-04-23,681,13,90569,25224,24.4382803161334,6.80620502262529,694,115793,fhi:git
county,Innlandet,2021-04-24,62,0,90631,25224,24.4550098083394,6.80620502262529,62,115855,fhi:git
county,Innlandet,2021-04-25,0,0,90631,25224,24.4550098083394,6.80620502262529,0,115855,fhi:git
county,Innlandet,2021-04-26,15,16,90646,25240,24.4590572661311,6.8105223109365,31,115886,fhi:git
county,Innlandet,2021-04-27,1411,286,92057,25526,24.8397881290761,6.88769383949941,1697,117583,fhi:git
county,Innlandet,2021-04-28,4367,1801,96424,27327,26.0181380075175,7.37365860503018,6168,123751,fhi:git
county,Innlandet,2021-04-29,4384,1399,100808,28726,27.2010750047895,7.75115150174176,5783,129534,fhi:git
county,Innlandet,2021-04-30,934,466,101742,29192,27.4530967099565,7.8768925238058,1400,130934,fhi:git
county,Innlandet,2021-05-01,12,1,101754,29193,27.4563346761899,7.87716235432525,13,130947,fhi:git
county,Innlandet,2021-05-02,0,1,101754,29194,27.4563346761899,7.8774321848447,1,130948,fhi:git
county,Innlandet,2021-05-03,29,7,101783,29201,27.464159761254,7.87932099848085,36,130984,fhi:git
county,Innlandet,2021-05-04,598,838,102381,30039,27.6255184118855,8.10543897378057,1436,132420,fhi:git
county,Møre og Romsdal,2020-12-27,0,0,0,0,0.0,0.0,0,0,fhi:git
county,Møre og Romsdal,2020-12-28,1,0,1,0,0.0003770198840286,0.0,1,1,fhi:git
county,Møre og Romsdal,2020-12-29,0,0,1,0,0.0003770198840286,0.0,0,1,fhi:git
county,Møre og Romsdal,2020-12-30,0,0,1,0,0.0003770198840286,0.0,0,1,fhi:git
county,Møre og Romsdal,2020-12-31,0,0,1,0,0.0003770198840286,0.0,0,1,fhi:git
county,Møre og Romsdal,2021-01-01,0,0,1,0,0.0003770198840286,0.0,0,1,fhi:git
county,Møre og Romsdal,2021-01-02,0,0,1,0,0.0003770198840286,0.0,0,1,fhi:git
county,Møre og Romsdal,2021-01-03,0,0,1,0,0.0003770198840286,0.0,0,1,fhi:git
county,Møre og Romsdal,2021-01-04,0,0,1,0,0.0003765854246377,0.0,0,1,fhi:git
county,Møre og Romsdal,2021-01-05,186,0,187,0,0.0704214744072545,0.0,186,187,fhi:git
county,Møre og Romsdal,2021-01-06,496,0,683,0,0.257207845027566,0.0,496,683,fhi:git
county,Møre og Romsdal,2021-01-07,457,0,1140,0,0.429307384087006,0.0,457,1140,fhi:git
county,Møre og Romsdal,2021-01-08,36,0,1176,0,0.442864459373964,0.0,36,1176,fhi:git
county,Møre og Romsdal,2021-01-09,1,0,1177,0,0.443241044798602,0.0,1,1177,fhi:git
county,Møre og Romsdal,2021-01-10,0,0,1177,0,0.443241044798602,0.0,0,1177,fhi:git
county,Møre og Romsdal,2021-01-11,1,0,1178,0,0.44361763022324,0.0,1,1178,fhi:git
county,Møre og Romsdal,2021-01-12,225,0,1403,0,0.528349350766728,0.0,225,1403,fhi:git
county,Møre og Romsdal,2021-01-13,388,0,1791,0,0.674464495526165,0.0,388,1791,fhi:git
county,Møre og Romsdal,2021-01-14,409,0,2200,0,0.828487934202995,0.0,409,2200,fhi:git
county,Møre og Romsdal,2021-01-15,150,0,2350,0,0.884975747898653,0.0,150,2350,fhi:git
county,Møre og Romsdal,2021-01-16,1,0,2351,0,0.885352333323291,0.0,1,2351,fhi:git
county,Møre og Romsdal,2021-01-17,2,0,2353,0,0.886105504172566,0.0,2,2353,fhi:git
county,Møre og Romsdal,2021-01-18,11,0,2364,0,0.890247943843582,0.0,11,2364,fhi:git
county,Møre og Romsdal,2021-01-19,203,0,2567,0,0.966694785045039,0.0,203,2567,fhi:git
county,Møre og Romsdal,2021-01-20,500,0,3067,0,1.1549874973639,0.0,500,3067,fhi:git
county,Møre og Romsdal,2021-01-21,800,0,3867,0,1.45625583707408,0.0,800,3867,fhi:git
county,Møre og Romsdal,2021-01-22,212,0,4079,0,1.53609194709728,0.0,212,4079,fhi:git
county,Møre og Romsdal,2021-01-23,0,0,4079,0,1.53609194709728,0.0,0,4079,fhi:git
county,Møre og Romsdal,2021-01-24,0,0,4079,0,1.53609194709728,0.0,0,4079,fhi:git
county,Møre og Romsdal,2021-01-25,3,0,4082,0,1.53722170337119,0.0,3,4082,fhi:git
county,Møre og Romsdal,2021-01-26,78,129,4160,129,1.56659536649294,0.0485795197782665,207,4289,fhi:git
county,Møre og Romsdal,2021-01-27,543,358,4703,487,1.77108125207122,0.183397101798572,901,5190,fhi:git
county,Møre og Romsdal,2021-01-28,492,509,5195,996,1.95636128099298,0.375079082939174,1001,6191,fhi:git
county,Møre og Romsdal,2021-01-29,99,78,5294,1074,1.99364323803212,0.404452746060916,177,6368,fhi:git
county,Møre og Romsdal,2021-01-30,0,1,5294,1075,1.99364323803212,0.404829331485554,1,6369,fhi:git
county,Møre og Romsdal,2021-01-31,1,0,5295,1075,1.99401982345675,0.404829331485554,1,6370,fhi:git
county,Møre og Romsdal,2021-02-01,0,0,5295,1075,1.99401982345675,0.404829331485554,0,6370,fhi:git
county,Møre og Romsdal,2021-02-02,291,193,5586,1268,2.10360618202633,0.477510318440635,484,6854,fhi:git
county,Møre og Romsdal,2021-02-03,1064,312,6650,1580,2.50429307384087,0.595004970927605,1376,8230,fhi:git
county,Møre og Romsdal,2021-02-04,1546,462,8196,2042,3.08649414033079,0.768987437110234,2008,10238,fhi:git
county,Møre og Romsdal,2021-02-05,218,154,8414,2196,3.16858976290182,0.826981592504444,372,10610,fhi:git
county,Møre og Romsdal,2021-02-06,1,2,8415,2198,3.16896634832645,0.827734763353719,3,10613,fhi:git
county,Møre og Romsdal,2021-02-07,0,1,8415,2199,3.16896634832645,0.828111348778357,1,10614,fhi:git
county,Møre og Romsdal,2021-02-08,1,2,8416,2201,3.16934293375109,0.828864519627632,3,10617,fhi:git
county,Møre og Romsdal,2021-02-09,335,183,8751,2384,3.29549905100473,0.897779652336336,518,11135,fhi:git
county,Møre og Romsdal,2021-02-10,1265,435,10016,2819,3.77187961317145,1.06159431205375,1700,12835,fhi:git
county,Møre og Romsdal,2021-02-11,1255,805,11271,3624,4.2444943210918,1.36474557888711,2060,14895,fhi:git
county,Møre og Romsdal,2021-02-12,295,207,11566,3831,4.35558702135993,1.44269876178712,502,15397,fhi:git
county,Møre og Romsdal,2021-02-13,24,0,11590,3831,4.36462507155123,1.44269876178712,24,15421,fhi:git
county,Møre og Romsdal,2021-02-14,0,0,11590,3831,4.36462507155123,1.44269876178712,0,15421,fhi:git
county,Møre og Romsdal,2021-02-15,1,8,11591,3839,4.36500165697587,1.44571144518423,9,15430,fhi:git
county,Møre og Romsdal,2021-02-16,354,58,11945,3897,4.49831289729762,1.46755339981321,412,15842,fhi:git
county,Møre og Romsdal,2021-02-17,1208,427,13153,4324,4.95322809025999,1.62835537613352,1635,17477,fhi:git
county,Møre og Romsdal,2021-02-18,1165,522,14318,4846,5.39195010996294,1.82493296779441,1687,19164,fhi:git
county,Møre og Romsdal,2021-02-19,499,94,14817,4940,5.57986623685717,1.86033199771036,593,19757,fhi:git
county,Møre og Romsdal,2021-02-20,11,0,14828,4940,5.58400867652818,1.86033199771036,11,19768,fhi:git
county,Møre og Romsdal,2021-02-21,0,1,14828,4941,5.58400867652818,1.860708583135,1,19769,fhi:git
county,Møre og Romsdal,2021-02-22,15,0,14843,4941,5.58965745789775,1.860708583135,15,19784,fhi:git
county,Møre og Romsdal,2021-02-23,394,223,15237,5164,5.73803211520501,1.94468713282921,617,20401,fhi:git
county,Møre og Romsdal,2021-02-24,730,878,15967,6042,6.01293947519055,2.27532913566113,1608,22009,fhi:git
county,Møre og Romsdal,2021-02-25,704,1478,16671,7520,6.27805561413551,2.83192239327569,2182,24191,fhi:git
county,Møre og Romsdal,2021-02-26,261,201,16932,7721,6.37634440996596,2.90761606362787,462,24653,fhi:git
county,Møre og Romsdal,2021-02-27,1,1,16933,7722,6.3767209953906,2.90799264905251,2,24655,fhi:git
county,Møre og Romsdal,2021-02-28,0,0,16933,7722,6.3767209953906,2.90799264905251,0,24655,fhi:git
county,Møre og Romsdal,2021-03-01,101,1,17034,7723,6.414756123279,2.90836923447715,102,24757,fhi:git
county,Møre og Romsdal,2021-03-02,741,260,17775,7983,6.69380592293556,3.00628144488296,1001,25758,fhi:git
county,Møre og Romsdal,2021-03-03,869,1134,18644,9117,7.02105865694574,3.43332931642214,2003,27761,fhi:git
county,Møre og Romsdal,2021-03-04,1000,1310,19644,10427,7.39764408158347,3.92665622269756,2310,30071,fhi:git
county,Møre og Romsdal,2021-03-05,814,275,20458,10702,7.70418461723858,4.03021721447293,1089,31160,fhi:git
county,Møre og Romsdal,2021-03-06,3,6,20461,10708,7.70531437351249,4.03247672702076,9,31169,fhi:git
county,Møre og Romsdal,2021-03-07,0,0,20461,10708,7.70531437351249,4.03247672702076,0,31169,fhi:git
county,Møre og Romsdal,2021-03-08,158,0,20619,10708,7.76481487060525,4.03247672702076,158,31327,fhi:git
county,Møre og Romsdal,2021-03-09,672,239,21291,10947,8.0178802759618,4.12248064350917,911,32238,fhi:git
county,Møre og Romsdal,2021-03-10,1283,950,22574,11897,8.501039375772,4.48023679691501,2233,34471,fhi:git
county,Møre og Romsdal,2021-03-11,539,974,23113,12871,8.70401891965173,4.84703100051216,1513,35984,fhi:git
county,Møre og Romsdal,2021-03-12,66,249,23179,13120,8.72887355767782,4.94080077124695,315,36299,fhi:git
county,Møre og Romsdal,2021-03-13,1,16,23180,13136,8.72925014310246,4.94682613804115,17,36316,fhi:git
county,Møre og Romsdal,2021-03-14,0,0,23180,13136,8.72925014310246,4.94682613804115,0,36316,fhi:git
county,Møre og Romsdal,2021-03-15,0,1,23180,13137,8.72925014310246,4.94720272346579,1,36317,fhi:git
county,Møre og Romsdal,2021-03-16,335,11,23515,13148,8.8554062603561,4.95134516313681,346,36663,fhi:git
county,Møre og Romsdal,2021-03-17,1542,129,25057,13277,9.43610098514747,4.99992468291507,1671,38334,fhi:git
county,Møre og Romsdal,2021-03-18,1485,60,26542,13337,9.99533034073449,5.02251980839334,1545,39879,fhi:git
county,Møre og Romsdal,2021-03-19,208,37,26750,13374,10.0736601090591,5.03645346910493,245,40124,fhi:git
county,Møre og Romsdal,2021-03-20,18,0,26768,13374,10.0804386467026,5.03645346910493,18,40142,fhi:git
county,Møre og Romsdal,2021-03-21,0,0,26768,13374,10.0804386467026,5.03645346910493,0,40142,fhi:git
county,Møre og Romsdal,2021-03-22,1,7,26769,13381,10.0808152321273,5.0390895670774,8,40150,fhi:git
county,Møre og Romsdal,2021-03-23,598,19,27367,13400,10.3060133160606,5.04624469014551,617,40767,fhi:git
county,Møre og Romsdal,2021-03-24,1811,50,29178,13450,10.9880095200795,5.0650739613774,1861,42628,fhi:git
county,Møre og Romsdal,2021-03-25,2325,71,31503,13521,11.8635706323622,5.09181152652668,2396,45024,fhi:git
county,Møre og Romsdal,2021-03-26,225,19,31728,13540,11.9483023529057,5.09896664959479,244,45268,fhi:git
county,Møre og Romsdal,2021-03-27,26,1,31754,13541,11.9580935739463,5.09934323501943,27,45295,fhi:git
county,Møre og Romsdal,2021-03-28,0,0,31754,13541,11.9580935739463,5.09934323501943,0,45295,fhi:git
county,Møre og Romsdal,2021-03-29,7,5,31761,13546,11.9607296719188,5.10122616214262,12,45307,fhi:git
county,Møre og Romsdal,2021-03-30,2234,102,33995,13648,12.8020215105595,5.13963787545567,2336,47643,fhi:git
county,Møre og Romsdal,2021-03-31,1940,214,35935,13862,13.5325972343566,5.22022715632814,2154,49797,fhi:git
county,Møre og Romsdal,2021-04-01,99,30,36034,13892,13.5698791913958,5.23152471906727,129,49926,fhi:git
county,Møre og Romsdal,2021-04-02,20,5,36054,13897,13.5774108998885,5.23340764619046,25,49951,fhi:git
county,Møre og Romsdal,2021-04-03,14,0,36068,13897,13.5826830958335,5.23340764619046,14,49965,fhi:git
county,Møre og Romsdal,2021-04-04,0,0,36068,13897,13.5826830958335,5.23340764619046,0,49965,fhi:git
county,Møre og Romsdal,2021-04-05,1,0,36069,13897,13.5830596812581,5.23340764619046,1,49966,fhi:git
county,Møre og Romsdal,2021-04-06,820,49,36889,13946,13.891859729461,5.25186033199771,869,50835,fhi:git
county,Møre og Romsdal,2021-04-07,2462,40,39351,13986,14.8190130449191,5.26692374898322,2502,53337,fhi:git
county,Møre og Romsdal,2021-04-08,3354,77,42705,14063,16.082080559154,5.29592082668032,3431,56768,fhi:git
county,Møre og Romsdal,2021-04-09,681,27,43386,14090,16.3385352333323,5.30608863314554,708,57476,fhi:git
county,Møre og Romsdal,2021-04-10,0,0,43386,14090,16.3385352333323,5.30608863314554,0,57476,fhi:git
county,Møre og Romsdal,2021-04-11,0,0,43386,14090,16.3385352333323,5.30608863314554,0,57476,fhi:git
county,Møre og Romsdal,2021-04-12,4,0,43390,14090,16.3400415750309,5.30608863314554,4,57480,fhi:git
county,Møre og Romsdal,2021-04-13,1334,5,44724,14095,16.8424065314976,5.30797156026873,1339,58819,fhi:git
county,Møre og Romsdal,2021-04-14,2511,14,47235,14109,17.7880125327629,5.31324375621366,2525,61344,fhi:git
county,Møre og Romsdal,2021-04-15,3649,30,50884,14139,19.162172747266,5.32454131895279,3679,65023,fhi:git
county,Møre og Romsdal,2021-04-16,937,13,51821,14152,19.5150332901515,5.32943692947308,950,65973,fhi:git
county,Møre og Romsdal,2021-04-17,13,0,51834,14152,19.5199289006718,5.32943692947308,13,65986,fhi:git
county,Møre og Romsdal,2021-04-18,0,0,51834,14152,19.5199289006718,5.32943692947308,0,65986,fhi:git
county,Møre og Romsdal,2021-04-19,11,0,51845,14152,19.5240713403428,5.32943692947308,11,65997,fhi:git
county,Møre og Romsdal,2021-04-20,1358,13,53203,14165,20.0354743470009,5.33433253999337,1371,67368,fhi:git
county,Møre og Romsdal,2021-04-21,1955,25,55158,14190,20.7716988521676,5.34374717560932,1980,69348,fhi:git
county,Møre og Romsdal,2021-04-22,3265,102,58423,14292,22.0012502636098,5.38215888892236,3367,72715,fhi:git
county,Møre og Romsdal,2021-04-23,512,1,58935,14293,22.1940620010243,5.382535474347,513,73228,fhi:git
county,Møre og Romsdal,2021-04-24,25,1,58960,14294,22.2034766366403,5.38291205977164,26,73254,fhi:git
county,Møre og Romsdal,2021-04-25,1,0,58961,14294,22.2038532220649,5.38291205977164,1,73255,fhi:git
county,Møre og Romsdal,2021-04-26,5,0,58966,14294,22.2057361491881,5.38291205977164,5,73260,fhi:git
county,Møre og Romsdal,2021-04-27,1489,340,60455,14634,22.7664718464737,5.51095110414846,1829,75089,fhi:git
county,Møre og Romsdal,2021-04-28,2406,1413,62861,16047,23.672536378152,6.04306630916157,3819,78908,fhi:git
county,Møre og Romsdal,2021-04-29,2594,1279,65455,17326,24.6493989696623,6.52471906727322,3873,82781,fhi:git
county,Møre og Romsdal,2021-04-30,178,121,65633,17447,24.7164311752478,6.57028590365439,299,83080,fhi:git
county,Møre og Romsdal,2021-05-01,4,15,65637,17462,24.7179375169464,6.57593468502395,19,83099,fhi:git
county,Møre og Romsdal,2021-05-02,0,0,65637,17462,24.7179375169464,6.57593468502395,0,83099,fhi:git
county,Møre og Romsdal,2021-05-03,17,2,65654,17464,24.7243394691652,6.57668785587323,19,83118,fhi:git
county,Møre og Romsdal,2021-05-04,406,836,66060,18300,24.8772331515681,6.89151327087036,1242,84360,fhi:git
county,Nordland,2020-12-27,0,0,0,0,0.0,0.0,0,0,fhi:git
county,Nordland,2020-12-28,0,0,0,0,0.0,0.0,0,0,fhi:git
county,Nordland,2020-12-29,0,0,0,0,0.0,0.0,0,0,fhi:git
county,Nordland,2020-12-30,1,0,1,0,0.0004145335461272,0.0,1,1,fhi:git
county,Nordland,2020-12-31,0,0,1,0,0.0004145335461272,0.0,0,1,fhi:git
county,Nordland,2021-01-01,0,0,1,0,0.0004145335461272,0.0,0,1,fhi:git
county,Nordland,2021-01-02,0,0,1,0,0.0004145335461272,0.0,0,1,fhi:git
county,Nordland,2021-01-03,0,0,1,0,0.0004145335461272,0.0,0,1,fhi:git
county,Nordland,2021-01-04,0,0,1,0,0.0004160685681,0.0,0,1,fhi:git
county,Nordland,2021-01-05,200,0,201,0,0.0836297821881046,0.0,200,201,fhi:git
county,Nordland,2021-01-06,686,0,887,0,0.36905281990472,0.0,686,887,fhi:git
county,Nordland,2021-01-07,238,0,1125,0,0.468077139112526,0.0,238,1125,fhi:git
county,Nordland,2021-01-08,114,0,1239,0,0.515508955875928,0.0,114,1239,fhi:git
county,Nordland,2021-01-09,0,0,1239,0,0.515508955875928,0.0,0,1239,fhi:git
county,Nordland,2021-01-10,0,0,1239,0,0.515508955875928,0.0,0,1239,fhi:git
county,Nordland,2021-01-11,0,0,1239,0,0.515508955875928,0.0,0,1239,fhi:git
county,Nordland,2021-01-12,292,0,1531,0,0.637000977761135,0.0,292,1531,fhi:git
county,Nordland,2021-01-13,625,0,2156,0,0.897043832823649,0.0,625,2156,fhi:git
county,Nordland,2021-01-14,273,0,2429,0,1.01063055191496,0.0,273,2429,fhi:git
county,Nordland,2021-01-15,69,0,2498,0,1.03933928311386,0.0,69,2498,fhi:git
county,Nordland,2021-01-16,0,0,2498,0,1.03933928311386,0.0,0,2498,fhi:git
county,Nordland,2021-01-17,1,0,2499,0,1.03975535168196,0.0,1,2499,fhi:git
county,Nordland,2021-01-18,0,0,2499,0,1.03975535168196,0.0,0,2499,fhi:git
county,Nordland,2021-01-19,313,0,2812,0,1.16998481349726,0.0,313,2812,fhi:git
county,Nordland,2021-01-20,787,0,3599,0,1.49743077659198,0.0,787,3599,fhi:git
county,Nordland,2021-01-21,618,0,4217,0,1.7545611516778,0.0,618,4217,fhi:git
county,Nordland,2021-01-22,173,0,4390,0,1.8265410139591,0.0,173,4390,fhi:git
county,Nordland,2021-01-23,4,0,4394,0,1.8282052882315,0.0,4,4394,fhi:git
county,Nordland,2021-01-24,0,0,4394,0,1.8282052882315,0.0,0,4394,fhi:git
county,Nordland,2021-01-25,51,0,4445,0,1.8494247852046,0.0,51,4445,fhi:git
county,Nordland,2021-01-26,119,90,4564,90,1.8989369448085,0.0374461711290021,209,4654,fhi:git
county,Nordland,2021-01-27,626,528,5190,618,2.15939586843912,0.257130375085814,1154,5808,fhi:git
county,Nordland,2021-01-28,472,365,5662,983,2.35578023258233,0.408995402442323,837,6645,fhi:git
county,Nordland,2021-01-29,212,144,5874,1127,2.44398676901953,0.468909276248726,356,7001,fhi:git
county,Nordland,2021-01-30,1,0,5875,1127,2.44440283758763,0.468909276248726,1,7002,fhi:git
county,Nordland,2021-01-31,0,0,5875,1127,2.44440283758763,0.468909276248726,0,7002,fhi:git
county,Nordland,2021-02-01,9,4,5884,1131,2.44814745470053,0.470573550521126,13,7015,fhi:git
county,Nordland,2021-02-02,111,200,5995,1331,2.49433106575964,0.553787264141131,311,7326,fhi:git
county,Nordland,2021-02-03,1435,458,7430,1789,3.09138946098317,0.744346668330941,1893,9219,fhi:git
county,Nordland,2021-02-04,1681,349,9111,2138,3.79080072395931,0.889554598597849,2030,11249,fhi:git
county,Nordland,2021-02-05,330,157,9441,2295,3.92810335143232,0.954877363789553,487,11736,fhi:git
county,Nordland,2021-02-06,0,0,9441,2295,3.92810335143232,0.954877363789553,0,11736,fhi:git
county,Nordland,2021-02-07,1,0,9442,2295,3.92851942000042,0.954877363789553,1,11737,fhi:git
county,Nordland,2021-02-08,7,1,9449,2296,3.93143189997712,0.955293432357653,8,11745,fhi:git
county,Nordland,2021-02-09,73,262,9522,2558,3.96180490544842,1.06430339719986,335,12080,fhi:git
county,Nordland,2021-02-10,2036,635,11558,3193,4.80892051010007,1.32850693794337,2671,14751,fhi:git
county,Nordland,2021-02-11,1224,586,12782,3779,5.31818843745449,1.57232311884999,1810,16561,fhi:git
county,Nordland,2021-02-12,285,239,13067,4018,5.436767979363,1.67176350662589,524,17085,fhi:git
county,Nordland,2021-02-13,53,3,13120,4021,5.4588196134723,1.67301171233019,56,17141,fhi:git
county,Nordland,2021-02-14,0,0,13120,4021,5.4588196134723,1.67301171233019,0,17141,fhi:git
county,Nordland,2021-02-15,0,1,13120,4022,5.4588196134723,1.67342778089829,1,17142,fhi:git
county,Nordland,2021-02-16,222,71,13342,4093,5.55118683559051,1.70296864923339,293,17435,fhi:git
county,Nordland,2021-02-17,1492,515,14834,4608,6.17196113919574,1.91724396180491,2007,19442,fhi:git
county,Nordland,2021-02-18,849,608,15683,5216,6.52520335351266,2.17021365120972,1457,20899,fhi:git
county,Nordland,2021-02-19,306,231,15989,5447,6.65252033535127,2.26632549044082,537,21436,fhi:git
county,Nordland,2021-02-20,1,1,15990,5448,6.65293640391937,2.26674155900892,2,21438,fhi:git
county,Nordland,2021-02-21,0,0,15990,5448,6.65293640391937,2.26674155900892,0,21438,fhi:git
county,Nordland,2021-02-22,270,0,16260,5448,6.76527491730637,2.26674155900892,270,21708,fhi:git
county,Nordland,2021-02-23,308,56,16568,5504,6.89342403628118,2.29004139882253,364,22072,fhi:git
county,Nordland,2021-02-24,976,1008,17544,6512,7.2995069587468,2.70943851546735,1984,24056,fhi:git
county,Nordland,2021-02-25,599,1872,18143,8384,7.54873203103872,3.48831887495059,2471,26527,fhi:git
county,Nordland,2021-02-26,428,398,18571,8782,7.72680937818552,3.6539141650544,826,27353,fhi:git
county,Nordland,2021-02-27,1,4,18572,8786,7.72722544675362,3.6555784393268,5,27358,fhi:git
county,Nordland,2021-02-28,0,1,18572,8787,7.72722544675362,3.6559945078949,1,27359,fhi:git
county,Nordland,2021-03-01,240,0,18812,8787,7.82708190309763,3.6559945078949,240,27599,fhi:git
county,Nordland,2021-03-02,517,50,19329,8837,8.04218935280534,3.6767979362999,567,28166,fhi:git
county,Nordland,2021-03-03,618,1585,19947,10422,8.29931972789116,4.33626661673844,2203,30369,fhi:git
county,Nordland,2021-03-04,719,1388,20666,11810,8.59847302835507,4.91376978926127,2107,32476,fhi:git
county,Nordland,2021-03-05,448,340,21114,12150,8.78487174686388,5.05523310241528,788,33264,fhi:git
county,Nordland,2021-03-06,13,51,21127,12201,8.79028063824918,5.07645259938838,64,33328,fhi:git
county,Nordland,2021-03-07,0,0,21127,12201,8.79028063824918,5.07645259938838,0,33328,fhi:git
county,Nordland,2021-03-08,362,0,21489,12201,8.94089745990139,5.07645259938838,362,33690,fhi:git
county,Nordland,2021-03-09,653,51,22142,12252,9.21259023487071,5.09767209636148,704,34394,fhi:git
county,Nordland,2021-03-10,1209,1188,23351,13440,9.71561713370363,5.59196155526431,2397,36791,fhi:git
county,Nordland,2021-03-11,728,990,24079,14430,10.0185150512805,6.00386943768333,1718,38509,fhi:git
county,Nordland,2021-03-12,71,262,24150,14692,10.0480559196156,6.11287940252554,333,38842,fhi:git
county,Nordland,2021-03-13,3,2,24153,14694,10.0493041253199,6.11371153966174,5,38847,fhi:git
county,Nordland,2021-03-14,1,0,24154,14694,10.049720193888,6.11371153966174,1,38848,fhi:git
county,Nordland,2021-03-15,0,1,24154,14695,10.049720193888,6.11412760822984,1,38849,fhi:git
county,Nordland,2021-03-16,120,5,24274,14700,10.09964842206,6.11620795107034,125,38974,fhi:git
county,Nordland,2021-03-17,902,64,25176,14764,10.4749422704862,6.14283633942874,966,39940,fhi:git
county,Nordland,2021-03-18,1161,75,26337,14839,10.9579978780503,6.17404148203624,1236,41176,fhi:git
county,Nordland,2021-03-19,227,28,26564,14867,11.052445443009,6.18569140194304,255,41431,fhi:git
county,Nordland,2021-03-20,40,0,26604,14867,11.069088185733,6.18569140194304,40,41471,fhi:git
county,Nordland,2021-03-21,0,0,26604,14867,11.069088185733,6.18569140194304,0,41471,fhi:git
county,Nordland,2021-03-22,36,1,26640,14868,11.0840666541846,6.18610747051114,37,41508,fhi:git
county,Nordland,2021-03-23,559,8,27199,14876,11.3166489837525,6.18943601905594,567,42075,fhi:git
county,Nordland,2021-03-24,2193,49,29392,14925,12.2290873535959,6.20982337889284,2242,44317,fhi:git
county,Nordland,2021-03-25,1595,71,30987,14996,12.8927167197154,6.23936424722794,1666,45983,fhi:git
county,Nordland,2021-03-26,343,12,31330,15008,13.0354282385737,6.24435707004514,355,46338,fhi:git
county,Nordland,2021-03-27,0,0,31330,15008,13.0354282385737,6.24435707004514,0,46338,fhi:git
county,Nordland,2021-03-28,0,0,31330,15008,13.0354282385737,6.24435707004514,0,46338,fhi:git
county,Nordland,2021-03-29,9,1,31339,15009,13.0391728556866,6.24477313861324,10,46348,fhi:git
county,Nordland,2021-03-30,1570,128,32909,15137,13.6924005076037,6.29802991533005,1698,48046,fhi:git
county,Nordland,2021-03-31,1158,312,34067,15449,14.1742079094635,6.42784330857725,1470,49516,fhi:git
county,Nordland,2021-04-01,227,164,34294,15613,14.2686554744222,6.49607855374566,391,49907,fhi:git
county,Nordland,2021-04-02,99,10,34393,15623,14.3098462626641,6.50023923942666,109,50016,fhi:git
county,Nordland,2021-04-03,0,0,34393,15623,14.3098462626641,6.50023923942666,0,50016,fhi:git
county,Nordland,2021-04-04,0,0,34393,15623,14.3098462626641,6.50023923942666,0,50016,fhi:git
county,Nordland,2021-04-05,0,1,34393,15624,14.3098462626641,6.50065530799476,1,50017,fhi:git
county,Nordland,2021-04-06,469,13,34862,15637,14.504982421103,6.50606419938006,482,50499,fhi:git
county,Nordland,2021-04-07,3184,80,38046,15717,15.8297447419335,6.53934968482806,3264,53763,fhi:git
county,Nordland,2021-04-08,2298,423,40344,16140,16.7858703114273,6.71534668913437,2721,56484,fhi:git
county,Nordland,2021-04-09,701,29,41045,16169,17.0775343776654,6.72741267760927,730,57214,fhi:git
county,Nordland,2021-04-10,0,0,41045,16169,17.0775343776654,6.72741267760927,0,57214,fhi:git
county,Nordland,2021-04-11,1,0,41046,16169,17.0779504462335,6.72741267760927,1,57215,fhi:git
county,Nordland,2021-04-12,3,27,41049,16196,17.0791986519378,6.73864652894797,30,57245,fhi:git
county,Nordland,2021-04-13,957,10,42006,16206,17.4773762716096,6.74280721462897,967,58212,fhi:git
county,Nordland,2021-04-14,3832,29,45838,16235,19.0717510245688,6.75487320310387,3861,62073,fhi:git
county,Nordland,2021-04-15,2582,31,48420,16266,20.1460400674031,6.76777132871497,2613,64686,fhi:git
county,Nordland,2021-04-16,798,27,49218,16293,20.4780627847469,6.77900518005367,825,65511,fhi:git
county,Nordland,2021-04-17,0,1,49218,16294,20.4780627847469,6.77942124862177,1,65512,fhi:git
county,Nordland,2021-04-18,0,0,49218,16294,20.4780627847469,6.77942124862177,0,65512,fhi:git
county,Nordland,2021-04-19,120,7,49338,16301,20.5279910129189,6.78233372859847,127,65639,fhi:git
county,Nordland,2021-04-20,863,34,50201,16335,20.8870581871892,6.79648005991388,897,66536,fhi:git
county,Nordland,2021-04-21,3850,60,54051,16395,22.4889221743743,6.82144417399988,3910,70446,fhi:git
county,Nordland,2021-04-22,2580,58,56631,16453,23.5623790800724,6.84557615094968,2638,73084,fhi:git
county,Nordland,2021-04-23,562,8,57193,16461,23.7962096153446,6.84890469949448,570,73654,fhi:git
county,Nordland,2021-04-24,0,0,57193,16461,23.7962096153446,6.84890469949448,0,73654,fhi:git
county,Nordland,2021-04-25,0,0,57193,16461,23.7962096153446,6.84890469949448,0,73654,fhi:git
county,Nordland,2021-04-26,47,160,57240,16621,23.8157648380453,6.91547567039048,207,73861,fhi:git
county,Nordland,2021-04-27,251,49,57491,16670,23.9201980486384,6.93586303022738,300,74161,fhi:git
county,Nordland,2021-04-28,3510,1071,61001,17741,25.3805987226695,7.38147246666251,4581,78742,fhi:git
county,Nordland,2021-04-29,2727,1047,63728,18788,26.5152177078783,7.81709625746323,3774,82516,fhi:git
county,Nordland,2021-04-30,397,170,64125,18958,26.680396929414,7.88782791404023,567,83083,fhi:git
county,Nordland,2021-05-01,1,0,64126,18958,26.6808129979821,7.88782791404023,1,83084,fhi:git
county,Nordland,2021-05-02,0,0,64126,18958,26.6808129979821,7.88782791404023,0,83084,fhi:git
county,Nordland,2021-05-03,30,1,64156,18959,26.6932950550251,7.88824398260833,31,83115,fhi:git
county,Nordland,2021-05-04,32,222,64188,19181,26.7066092492043,7.98061120472654,254,83369,fhi:git
county,Oslo,2020-12-27,5,0,5,0,0.0007209867713347,0.0,5,5,fhi:git
county,Oslo,2020-12-28,264,0,269,0,0.0387890882978079,0.0,264,269,fhi:git
county,Oslo,2020-12-29,118,0,387,0,0.0558043761013073,0.0,118,387,fhi:git
county,Oslo,2020-12-30,58,0,445,0,0.06416782264879,0.0,58,445,fhi:git
county,Oslo,2020-12-31,6,0,451,0,0.0650330067743917,0.0,6,451,fhi:git
county,Oslo,2021-01-01,6,0,457,0,0.0658981908999934,0.0,6,457,fhi:git
county,Oslo,2021-01-02,0,0,457,0,0.0658981908999934,0.0,0,457,fhi:git
county,Oslo,2021-01-03,0,0,457,0,0.0658981908999934,0.0,0,457,fhi:git
county,Oslo,2021-01-04,0,0,457,0,0.0655657738052539,0.0,0,457,fhi:git
county,Oslo,2021-01-05,482,0,939,0,0.134718296724581,0.0,482,939,fhi:git
county,Oslo,2021-01-06,603,0,1542,0,0.221230685356021,0.0,603,1542,fhi:git
county,Oslo,2021-01-07,968,0,2510,0,0.360109611052926,0.0,968,2510,fhi:git
county,Oslo,2021-01-08,450,0,2960,0,0.42467109510624,0.0,450,2960,fhi:git
county,Oslo,2021-01-09,129,0,3089,0,0.443178720534856,0.0,129,3089,fhi:git
county,Oslo,2021-01-10,100,0,3189,0,0.457525716991148,0.0,100,3189,fhi:git
county,Oslo,2021-01-11,78,0,3267,0,0.468716374227056,0.0,78,3267,fhi:git
county,Oslo,2021-01-12,241,0,3508,0,0.503292635686719,0.0,241,3508,fhi:git
county,Oslo,2021-01-13,491,0,3999,0,0.573736388287112,0.0,491,3999,fhi:git
county,Oslo,2021-01-14,1240,0,5239,0,0.751639144345131,0.0,1240,5239,fhi:git
county,Oslo,2021-01-15,1638,0,6877,0,0.986642946299192,0.0,1638,6877,fhi:git
county,Oslo,2021-01-16,642,0,7519,0,1.07875066354859,0.0,642,7519,fhi:git
county,Oslo,2021-01-17,281,5,7800,5,1.11906572359077,0.0007173498228145,286,7805,fhi:git
county,Oslo,2021-01-18,764,231,8564,236,1.22867677651684,0.0338589116368488,995,8800,fhi:git
county,Oslo,2021-01-19,808,70,9372,306,1.34460050788367,0.0439018091562531,878,9678,fhi:git
county,Oslo,2021-01-20,991,99,10363,405,1.48677924276553,0.0581053356479821,1090,10768,fhi:git
county,Oslo,2021-01-21,1020,21,11383,426,1.6331186066197,0.0611182049038034,1041,11809,fhi:git
county,Oslo,2021-01-22,670,6,12053,432,1.72924348287686,0.0619790246911809,676,12485,fhi:git
county,Oslo,2021-01-23,233,0,12286,432,1.76267198462002,0.0619790246911809,233,12718,fhi:git
county,Oslo,2021-01-24,68,0,12354,432,1.7724279422103,0.0619790246911809,68,12786,fhi:git
county,Oslo,2021-01-25,258,0,12612,432,1.80944319306753,0.0619790246911809,258,13044,fhi:git
county,Oslo,2021-01-26,312,406,12924,838,1.85420582201116,0.120227830303726,718,13762,fhi:git
county,Oslo,2021-01-27,1100,528,14024,1366,2.01202278303037,0.195979971592947,1628,15390,fhi:git
county,Oslo,2021-01-28,871,847,14895,2213,2.13698512216468,0.317499031577739,1718,17108,fhi:git
county,Oslo,2021-01-29,431,504,15326,2717,2.19882067689129,0.38980789371745,935,18043,fhi:git
county,Oslo,2021-01-30,93,154,15419,2871,2.21216338359564,0.41190226826014,247,18290,fhi:git
county,Oslo,2021-01-31,63,46,15482,2917,2.22120199136311,0.418501886630034,109,18399,fhi:git
county,Oslo,2021-02-01,53,48,15535,2965,2.22880589948494,0.425388444929054,101,18500,fhi:git
county,Oslo,2021-02-02,1521,150,17056,3115,2.44702371558514,0.446908939613492,1671,20171,fhi:git
county,Oslo,2021-02-03,2459,458,19515,3573,2.79981635844536,0.512618183383309,2917,23088,fhi:git
county,Oslo,2021-02-04,2052,1234,21567,4807,3.09421672572847,0.689660119653951,3286,26374,fhi:git
county,Oslo,2021-02-05,1381,1572,22948,6379,3.29234874678986,0.915194903946859,2953,29327,fhi:git
county,Oslo,2021-02-06,244,632,23192,7011,3.32735541814321,1.00586792155062,876,30203,fhi:git
county,Oslo,2021-02-07,210,275,23402,7286,3.35748411070142,1.04532216180543,485,30688,fhi:git
county,Oslo,2021-02-08,46,445,23448,7731,3.36408372907132,1.10916629603593,491,31179,fhi:git
county,Oslo,2021-02-09,1163,244,24611,7975,3.53093929785799,1.14417296738928,1407,32586,fhi:git
county,Oslo,2021-02-10,1828,812,26439,8787,3.79320239307901,1.26067057861437,2640,35226,fhi:git
county,Oslo,2021-02-11,1585,745,28024,9532,4.02060228691124,1.36755570221374,2330,37556,fhi:git
county,Oslo,2021-02-12,1359,424,29383,9956,4.21557796875224,1.42838696718842,1783,39339,fhi:git
county,Oslo,2021-02-13,274,194,29657,10150,4.25488873904248,1.45622014031363,468,39807,fhi:git
county,Oslo,2021-02-14,102,1,29759,10151,4.2695226754279,1.45636361027819,103,39910,fhi:git
county,Oslo,2021-02-15,276,447,30035,10598,4.30912038564726,1.52049468443781,723,40633,fhi:git
county,Oslo,2021-02-16,725,775,30760,11373,4.41313610995538,1.63168390697408,1500,42133,fhi:git
county,Oslo,2021-02-17,1423,1149,32183,12522,4.61729386952841,1.79653089625687,2572,44705,fhi:git
county,Oslo,2021-02-18,1074,921,33257,13443,4.77138061146899,1.92866673361932,1995,46700,fhi:git
county,Oslo,2021-02-19,1493,975,34750,14418,4.98558126856143,2.06854994906816,2468,49168,fhi:git
county,Oslo,2021-02-20,101,115,34851,14533,5.00007173498228,2.0850489949929,216,49384,fhi:git
county,Oslo,2021-02-21,4,63,34855,14596,5.00064561484053,2.09408760276036,67,49451,fhi:git
county,Oslo,2021-02-22,602,112,35457,14708,5.08701453350741,2.11015623879141,714,50165,fhi:git
county,Oslo,2021-02-23,341,1529,35798,16237,5.13593779142337,2.32952181460811,1870,52035,fhi:git
county,Oslo,2021-02-24,707,2345,36505,18582,5.23737105636935,2.66595888150816,3052,55087,fhi:git
county,Oslo,2021-02-25,602,1980,37107,20562,5.32373997503623,2.95002941134274,2582,57669,fhi:git
county,Oslo,2021-02-26,782,1375,37889,21937,5.43593348732443,3.14730061261675,2157,59826,fhi:git
county,Oslo,2021-02-27,260,105,38149,22042,5.47323567811079,3.16236495889586,365,60191,fhi:git
county,Oslo,2021-02-28,102,62,38251,22104,5.48786961449621,3.17126009669876,164,60355,fhi:git
county,Oslo,2021-03-01,1049,39,39300,22143,5.63836960732271,3.17685542531671,1088,61443,fhi:git
county,Oslo,2021-03-02,773,137,40073,22280,5.74927188992984,3.19651081046183,910,62353,fhi:git
county,Oslo,2021-03-03,1359,172,41432,22452,5.94424757177085,3.22118764436665,1531,63884,fhi:git
county,Oslo,2021-03-04,1186,203,42618,22655,6.11440294974247,3.25031204717292,1389,65273,fhi:git
county,Oslo,2021-03-05,1306,69,43924,22724,6.30177472346164,3.26021147472777,1375,66648,fhi:git
county,Oslo,2021-03-06,115,3,44039,22727,6.31827376938638,3.26064188462146,118,66766,fhi:git
county,Oslo,2021-03-07,69,0,44108,22727,6.32817319694122,3.26064188462146,69,66835,fhi:git
county,Oslo,2021-03-08,669,11,44777,22738,6.42415460323381,3.26222005423165,680,67515,fhi:git
county,Oslo,2021-03-09,777,1326,45554,24064,6.5356307656992,3.45246122724208,2103,69618,fhi:git
county,Oslo,2021-03-10,1204,2423,46758,26487,6.70836860303296,3.80008895137803,3627,73245,fhi:git
county,Oslo,2021-03-11,886,2392,47644,28879,6.8354829916357,4.14326910661253,3278,76523,fhi:git
county,Oslo,2021-03-12,278,1640,47922,30519,6.87536764178419,4.37855984849572,1918,78441,fhi:git
county,Oslo,2021-03-13,16,266,47938,30785,6.8776631612172,4.41672285906945,282,78723,fhi:git
county,Oslo,2021-03-14,4,96,47942,30881,6.87823704107545,4.43049597566749,100,78823,fhi:git
county,Oslo,2021-03-15,23,360,47965,31241,6.8815368502604,4.48214516291015,383,79206,fhi:git
county,Oslo,2021-03-16,1007,138,48972,31379,7.02601110457526,4.50194401801983,1145,80351,fhi:git
county,Oslo,2021-03-17,2745,116,51717,31495,7.41983615730047,4.51858653390913,2861,83212,fhi:git
county,Oslo,2021-03-18,2031,126,53748,31621,7.71122365532776,4.53666374944405,2157,85369,fhi:git
county,Oslo,2021-03-19,2032,187,55780,31808,8.00275462331961,4.56349263281732,2219,87588,fhi:git
county,Oslo,2021-03-20,394,18,56174,31826,8.0592817893574,4.56607509217945,412,88000,fhi:git
county,Oslo,2021-03-21,163,15,56337,31841,8.08266739358115,4.5682271416479,178,88178,fhi:git
county,Oslo,2021-03-22,935,11,57272,31852,8.21681181044748,4.56980531125809,946,89124,fhi:git
county,Oslo,2021-03-23,3330,104,60602,31956,8.694566792442,4.58472618757263,3434,92558,fhi:git
county,Oslo,2021-03-24,5133,212,65735,32168,9.43099812054346,4.61514182005997,5345,97903,fhi:git
county,Oslo,2021-03-25,5148,51,70883,32219,10.1695814981134,4.62245878825268,5199,103102,fhi:git
county,Oslo,2021-03-26,4185,87,75068,32306,10.7700032998092,4.63494067516965,4272,107374,fhi:git
county,Oslo,2021-03-27,651,1,75719,32307,10.8634022467396,4.63508414513422,652,108026,fhi:git
county,Oslo,2021-03-28,151,0,75870,32307,10.8850662113886,4.63508414513422,151,108177,fhi:git
county,Oslo,2021-03-29,2195,10,78065,32317,11.1999827836043,4.63651884477985,2205,110382,fhi:git
county,Oslo,2021-03-30,4374,212,82439,32529,11.8275204086025,4.66693447726718,4586,114968,fhi:git
county,Oslo,2021-03-31,4233,772,86672,33301,12.4348287685973,4.77769328990976,5005,119973,fhi:git
county,Oslo,2021-04-01,2815,295,89487,33596,12.8386967188419,4.82001692945582,3110,123083,fhi:git
county,Oslo,2021-04-02,1673,167,91160,33763,13.0787219695557,4.84397641353783,1840,124923,fhi:git
county,Oslo,2021-04-03,230,1,91390,33764,13.1117200614051,4.84411988350239,231,125154,fhi:git
county,Oslo,2021-04-04,375,36,91765,33800,13.1655212981162,4.84928480222665,411,125565,fhi:git
county,Oslo,2021-04-05,1255,56,93020,33856,13.3455761036427,4.85731912024218,1311,126876,fhi:git
county,Oslo,2021-04-06,4564,109,97584,33965,14.0003730219079,4.87295734637954,4673,131549,fhi:git
county,Oslo,2021-04-07,6234,163,103818,34128,14.8947647809931,4.89634295060329,6397,137946,fhi:git
county,Oslo,2021-04-08,6086,147,109904,34275,15.767922985323,4.91743303539404,6233,144179,fhi:git
county,Oslo,2021-04-09,5165,65,115069,34340,16.5089453522905,4.92675858309063,5230,149409,fhi:git
county,Oslo,2021-04-10,748,0,115817,34340,16.6162608857836,4.92675858309063,748,150157,fhi:git
county,Oslo,2021-04-11,368,8,116185,34348,16.6690578327427,4.92790634280713,376,150533,fhi:git
county,Oslo,2021-04-12,1796,4,117981,34352,16.9267298890977,4.92848022266539,1800,152333,fhi:git
county,Oslo,2021-04-13,3139,47,121120,34399,17.3770821078607,4.93522331099984,3186,155519,fhi:git
county,Oslo,2021-04-14,5593,52,126713,34451,18.1795096196611,4.94268374915711,5645,161164,fhi:git
county,Oslo,2021-04-15,5636,159,132349,34610,18.9881063399377,4.96549547352262,5795,166959,fhi:git
county,Oslo,2021-04-16,5054,272,137403,34882,19.7132035408387,5.00451930388373,5326,172285,fhi:git
county,Oslo,2021-04-17,1600,155,139003,35037,19.9427554841394,5.02675714839099,1755,174040,fhi:git
county,Oslo,2021-04-18,1009,3,140012,35040,20.0875166783834,5.02718755828467,1012,175052,fhi:git
county,Oslo,2021-04-19,3173,113,143185,35153,20.5427468759415,5.04339966428028,3286,178338,fhi:git
county,Oslo,2021-04-20,3233,420,146418,35573,21.0065852713734,5.10365704939671,3653,181991,fhi:git
county,Oslo,2021-04-21,4474,480,150892,36053,21.6484698928279,5.17252263238691,4954,186945,fhi:git
county,Oslo,2021-04-22,4640,410,155532,36463,22.3141705283999,5.23134531785771,5050,191995,fhi:git
county,Oslo,2021-04-23,3220,510,158752,36973,22.7761438142925,5.3045149997848,3730,195725,fhi:git
county,Oslo,2021-04-24,210,26,158962,36999,22.8062725068507,5.30824521886343,236,195961,fhi:git
county,Oslo,2021-04-25,74,0,159036,36999,22.8168892842284,5.30824521886343,74,196035,fhi:git
county,Oslo,2021-04-26,935,248,159971,37247,22.9510337010947,5.34382577007504,1183,197218,fhi:git
county,Oslo,2021-04-27,3747,1485,163718,38732,23.4886156583119,5.55687866745097,5232,202450,fhi:git
county,Oslo,2021-04-28,5343,3098,169061,41830,24.2551756789716,6.00134861766689,8441,210891,fhi:git
county,Oslo,2021-04-29,5104,2597,174165,44427,24.9874463781008,6.37394011563679,7701,218592,fhi:git
county,Oslo,2021-04-30,4052,2602,178217,47029,25.5687866745097,6.74724896342951,6654,225246,fhi:git
county,Oslo,2021-05-01,960,255,179177,47284,25.7065178404901,6.78383380439305,1215,226461,fhi:git
county,Oslo,2021-05-02,830,226,180007,47510,25.8255979110773,6.81625801638427,1056,227517,fhi:git
county,Oslo,2021-05-03,1317,920,181324,48430,26.0145478544067,6.94825038378216,2237,229754,fhi:git
county,Oslo,2021-05-04,2550,2075,183874,50505,26.3803962640421,7.24595056025021,4625,234379,fhi:git
county,Rogaland,2020-12-27,0,0,0,0,0.0,0.0,0,0,fhi:git
county,Rogaland,2020-12-28,1,0,1,0,0.0002083802188825,0.0,1,1,fhi:git
county,Rogaland,2020-12-29,0,0,1,0,0.0002083802188825,0.0,0,1,fhi:git
county,Rogaland,2020-12-30,0,0,1,0,0.0002083802188825,0.0,0,1,fhi:git
county,Rogaland,2020-12-31,0,0,1,0,0.0002083802188825,0.0,0,1,fhi:git
county,Rogaland,2021-01-01,0,0,1,0,0.0002083802188825,0.0,0,1,fhi:git
county,Rogaland,2021-01-02,0,0,1,0,0.0002083802188825,0.0,0,1,fhi:git
county,Rogaland,2021-01-03,0,0,1,0,0.0002083802188825,0.0,0,1,fhi:git
county,Rogaland,2021-01-04,0,0,1,0,0.0002071916211708,0.0,0,1,fhi:git
county,Rogaland,2021-01-05,547,0,548,0,0.11354100840162,0.0,547,548,fhi:git
county,Rogaland,2021-01-06,641,0,1189,0,0.246350837572129,0.0,641,1189,fhi:git
county,Rogaland,2021-01-07,212,0,1401,0,0.290275461260347,0.0,212,1401,fhi:git
county,Rogaland,2021-01-08,20,0,1421,0,0.294419293683763,0.0,20,1421,fhi:git
county,Rogaland,2021-01-09,1,0,1422,0,0.294626485304934,0.0,1,1422,fhi:git
county,Rogaland,2021-01-10,0,0,1422,0,0.294626485304934,0.0,0,1422,fhi:git
county,Rogaland,2021-01-11,4,0,1426,0,0.295455251789618,0.0,4,1426,fhi:git
county,Rogaland,2021-01-12,117,0,1543,0,0.319696671466606,0.0,117,1543,fhi:git
county,Rogaland,2021-01-13,763,0,2306,0,0.477783878419957,0.0,763,2306,fhi:git
county,Rogaland,2021-01-14,534,0,2840,0,0.588424204125185,0.0,534,2840,fhi:git
county,Rogaland,2021-01-15,292,0,3132,0,0.648924157507071,0.0,292,3132,fhi:git
county,Rogaland,2021-01-16,0,0,3132,0,0.648924157507071,0.0,0,3132,fhi:git
county,Rogaland,2021-01-17,2,0,3134,0,0.649338540749412,0.0,2,3134,fhi:git
county,Rogaland,2021-01-18,71,0,3205,0,0.664049145852542,0.0,71,3205,fhi:git
county,Rogaland,2021-01-19,512,0,3717,0,0.770131255892012,0.0,512,3717,fhi:git
county,Rogaland,2021-01-20,659,0,4376,0,0.906670534243595,0.0,659,4376,fhi:git
county,Rogaland,2021-01-21,431,0,4807,0,0.995970122968227,0.0,431,4807,fhi:git
county,Rogaland,2021-01-22,272,0,5079,0,1.0523262439267,0.0,272,5079,fhi:git
county,Rogaland,2021-01-23,0,0,5079,0,1.0523262439267,0.0,0,5079,fhi:git
county,Rogaland,2021-01-24,0,0,5079,0,1.0523262439267,0.0,0,5079,fhi:git
county,Rogaland,2021-01-25,150,0,5229,0,1.08340498710232,0.0,150,5229,fhi:git
county,Rogaland,2021-01-26,339,380,5568,380,1.15364294667924,0.0787328160449192,719,5948,fhi:git
county,Rogaland,2021-01-27,865,603,6433,983,1.33286369899201,0.203669363610936,1468,7416,fhi:git
county,Rogaland,2021-01-28,525,283,6958,1266,1.4416393001067,0.262304592402283,808,8224,fhi:git
county,Rogaland,2021-01-29,410,22,7368,1288,1.52658786478675,0.266862808068042,432,8656,fhi:git
county,Rogaland,2021-01-30,5,1,7373,1289,1.5276238228926,0.267069999689213,6,8662,fhi:git
county,Rogaland,2021-01-31,2,0,7375,1289,1.52803820613494,0.267069999689213,2,8664,fhi:git
county,Rogaland,2021-02-01,13,6,7388,1295,1.53073169721016,0.268313149416238,19,8683,fhi:git
county,Rogaland,2021-02-02,450,78,7838,1373,1.62396792673704,0.284474095867563,528,9211,fhi:git
county,Rogaland,2021-02-03,2432,638,10270,2011,2.12785794942453,0.416662350174559,3070,12281,fhi:git
county,Rogaland,2021-02-04,1889,561,12159,2572,2.51924292181624,0.5328968496514,2450,14731,fhi:git
county,Rogaland,2021-02-05,654,282,12813,2854,2.65474624206197,0.591324886821577,936,15667,fhi:git
county,Rogaland,2021-02-06,0,0,12813,2854,2.65474624206197,0.591324886821577,0,15667,fhi:git
county,Rogaland,2021-02-07,0,1,12813,2855,2.65474624206197,0.591532078442748,1,15668,fhi:git
county,Rogaland,2021-02-08,7,70,12820,2925,2.65619658341017,0.606035491924707,77,15745,fhi:git
county,Rogaland,2021-02-09,588,395,13408,3320,2.77802525665862,0.687876182287188,983,16728,fhi:git
county,Rogaland,2021-02-10,1924,685,15332,4005,3.17666193579132,0.829802442789214,2609,19337,fhi:git
county,Rogaland,2021-02-11,1182,496,16514,4501,3.42156243201525,0.93256948688995,1678,21015,fhi:git
county,Rogaland,2021-02-12,481,268,16995,4769,3.52122160179842,0.988096841363735,749,21764,fhi:git
county,Rogaland,2021-02-13,2,0,16997,4769,3.52163598504077,0.988096841363735,2,21766,fhi:git
county,Rogaland,2021-02-14,0,0,16997,4769,3.52163598504077,0.988096841363735,0,21766,fhi:git
county,Rogaland,2021-02-15,0,147,16997,4916,3.52163598504077,1.01855400967585,147,21913,fhi:git
county,Rogaland,2021-02-16,480,315,17477,5231,3.62108796320277,1.08381937034466,795,22708,fhi:git
county,Rogaland,2021-02-17,1489,783,18966,6014,3.92959628712615,1.24605040972143,2272,24980,fhi:git
county,Rogaland,2021-02-18,1102,476,20068,6490,4.15792145365641,1.34467362139875,1578,26558,fhi:git
county,Rogaland,2021-02-19,444,412,20512,6902,4.24991453345627,1.43003656932114,856,27414,fhi:git
county,Rogaland,2021-02-20,1,3,20513,6905,4.25012172507744,1.43065814418465,4,27418,fhi:git
county,Rogaland,2021-02-21,0,2,20513,6907,4.25012172507744,1.43107252742699,2,27420,fhi:git
county,Rogaland,2021-02-22,252,13,20765,6920,4.30233401361249,1.43376601850221,265,27685,fhi:git
county,Rogaland,2021-02-23,379,407,21144,7327,4.38085963803624,1.51809300831874,786,28471,fhi:git
county,Rogaland,2021-02-24,822,2171,21966,9498,4.55117115063867,1.96790601788064,2993,31464,fhi:git
county,Rogaland,2021-02-25,1231,1814,23197,11312,4.80622403629997,2.34375161868454,3045,34509,fhi:git
county,Rogaland,2021-02-26,1000,678,24197,11990,5.01341565747081,2.48422753783837,1678,36187,fhi:git
county,Rogaland,2021-02-27,1,1,24198,11991,5.01362284909198,2.48443472945954,2,36189,fhi:git
county,Rogaland,2021-02-28,4,0,24202,11991,5.01445161557667,2.48443472945954,4,36193,fhi:git
county,Rogaland,2021-03-01,648,2,24850,11993,5.14871178609537,2.48484911270188,650,36843,fhi:git
county,Rogaland,2021-03-02,795,545,25645,12538,5.31342912492619,2.59776854623999,1340,38183,fhi:git
county,Rogaland,2021-03-03,1268,1462,26913,14000,5.57614810057081,2.90068269639176,2730,40913,fhi:git
county,Rogaland,2021-03-04,1091,1479,28004,15479,5.8021941592682,3.20711910410343,2570,43483,fhi:git
county,Rogaland,2021-03-05,603,424,28607,15903,5.92713070683422,3.29496835147987,1027,44510,fhi:git
county,Rogaland,2021-03-06,4,2,28611,15905,5.9279594733189,3.29538273472221,6,44516,fhi:git
county,Rogaland,2021-03-07,0,0,28611,15905,5.9279594733189,3.29538273472221,0,44516,fhi:git
county,Rogaland,2021-03-08,543,0,29154,15905,6.04046452361467,3.29538273472221,543,45059,fhi:git
county,Rogaland,2021-03-09,1576,466,30730,16371,6.36699851857991,3.39193403018782,2042,47101,fhi:git
county,Rogaland,2021-03-10,2204,1081,32934,17452,6.82364885164044,3.6159081726735,3285,50386,fhi:git
county,Rogaland,2021-03-11,1445,1059,34379,18511,7.1230407442323,3.83532409949342,2504,52890,fhi:git
county,Rogaland,2021-03-12,118,545,34497,19056,7.14748935553046,3.94824353303152,663,53553,fhi:git
county,Rogaland,2021-03-13,0,0,34497,19056,7.14748935553046,3.94824353303152,0,53553,fhi:git
county,Rogaland,2021-03-14,0,0,34497,19056,7.14748935553046,3.94824353303152,0,53553,fhi:git
county,Rogaland,2021-03-15,0,1,34497,19057,7.14748935553046,3.9484507246527,1,53554,fhi:git
county,Rogaland,2021-03-16,587,94,35084,19151,7.26911083715775,3.96792673704275,681,54235,fhi:git
county,Rogaland,2021-03-17,2399,95,37483,19246,7.76616353634659,3.98760994105398,2494,56729,fhi:git
county,Rogaland,2021-03-18,1677,83,39160,19329,8.11362388505009,4.00480684561116,1760,58489,fhi:git
county,Rogaland,2021-03-19,272,26,39432,19355,8.16998000600856,4.01019382776161,298,58787,fhi:git
county,Rogaland,2021-03-20,0,0,39432,19355,8.16998000600856,4.01019382776161,0,58787,fhi:git
county,Rogaland,2021-03-21,0,0,39432,19355,8.16998000600856,4.01019382776161,0,58787,fhi:git
county,Rogaland,2021-03-22,15,17,39447,19372,8.17308788032612,4.01371608532151,32,58819,fhi:git
county,Rogaland,2021-03-23,831,48,40278,19420,8.34526411751909,4.02366128313771,879,59698,fhi:git
county,Rogaland,2021-03-24,3406,82,43684,19502,9.05095877922697,4.04065099607372,3488,63186,fhi:git
county,Rogaland,2021-03-25,3236,166,46920,19668,9.72143086533581,4.07504480518808,3402,66588,fhi:git
county,Rogaland,2021-03-26,816,77,47736,19745,9.89049922821121,4.09099856001823,893,67481,fhi:git
county,Rogaland,2021-03-27,0,0,47736,19745,9.89049922821121,4.09099856001823,0,67481,fhi:git
county,Rogaland,2021-03-28,1,2,47737,19747,9.89070641983238,4.09141294326057,3,67484,fhi:git
county,Rogaland,2021-03-29,234,0,47971,19747,9.93918925918636,4.09141294326057,234,67718,fhi:git
county,Rogaland,2021-03-30,4268,356,52239,20103,10.8234830983435,4.16517316039739,4624,72342,fhi:git
county,Rogaland,2021-03-31,2186,621,54425,20724,11.276403982223,4.29383915714449,2807,75149,fhi:git
county,Rogaland,2021-04-01,569,1,54994,20725,11.3942960146692,4.29404634876566,570,75719,fhi:git
county,Rogaland,2021-04-02,8,21,55002,20746,11.3959535476385,4.29839737281024,29,75748,fhi:git
county,Rogaland,2021-04-03,0,1,55002,20747,11.3959535476385,4.29860456443141,1,75749,fhi:git
county,Rogaland,2021-04-04,0,0,55002,20747,11.3959535476385,4.29860456443141,0,75749,fhi:git
county,Rogaland,2021-04-05,0,1,55002,20748,11.3959535476385,4.29881175605259,1,75750,fhi:git
county,Rogaland,2021-04-06,1375,77,56377,20825,11.6808420267484,4.31476551088274,1452,77202,fhi:git
county,Rogaland,2021-04-07,5917,118,62294,20943,12.9067948492163,4.3392141221809,6035,83237,fhi:git
county,Rogaland,2021-04-08,5155,532,67449,21475,13.974867656352,4.44944006464379,5687,88924,fhi:git
county,Rogaland,2021-04-09,1891,35,69340,21510,14.366667011986,4.45669177138477,1926,90850,fhi:git
county,Rogaland,2021-04-10,5,1,69345,21511,14.3677029700919,4.45689896300594,6,90856,fhi:git
county,Rogaland,2021-04-11,0,0,69345,21511,14.3677029700919,4.45689896300594,0,90856,fhi:git
county,Rogaland,2021-04-12,16,14,69361,21525,14.3710180360306,4.45979964570233,30,90886,fhi:git
county,Rogaland,2021-04-13,1621,35,70982,21560,14.7068756539486,4.46705135244331,1656,92542,fhi:git
county,Rogaland,2021-04-14,7577,39,78559,21599,16.27676656756,4.47513182566897,7616,100158,fhi:git
county,Rogaland,2021-04-15,5159,81,83718,21680,17.3456681411804,4.49191434698381,5240,105398,fhi:git
county,Rogaland,2021-04-16,2143,20,85861,21700,17.7896797853495,4.49605817940722,2163,107561,fhi:git
county,Rogaland,2021-04-17,1,0,85862,21700,17.7898869769707,4.49605817940722,1,107562,fhi:git
county,Rogaland,2021-04-18,0,0,85862,21700,17.7898869769707,4.49605817940722,0,107562,fhi:git
county,Rogaland,2021-04-19,28,1,85890,21701,17.7956883423634,4.4962653710284,29,107591,fhi:git
county,Rogaland,2021-04-20,1073,38,86963,21739,18.0180049518797,4.50413865263289,1111,108702,fhi:git
county,Rogaland,2021-04-21,6626,353,93589,22092,19.3908566337577,4.57727729490619,6979,115681,fhi:git
county,Rogaland,2021-04-22,5102,167,98691,22259,20.4479482849714,4.61187829564172,5269,120950,fhi:git
county,Rogaland,2021-04-23,1677,67,100368,22326,20.7954086336749,4.62576013426017,1744,122694,fhi:git
county,Rogaland,2021-04-24,0,0,100368,22326,20.7954086336749,4.62576013426017,0,122694,fhi:git
county,Rogaland,2021-04-25,0,0,100368,22326,20.7954086336749,4.62576013426017,0,122694,fhi:git
county,Rogaland,2021-04-26,10,2,100378,22328,20.7974805498866,4.62617451750251,12,122706,fhi:git
county,Rogaland,2021-04-27,1008,647,101386,22975,21.0063297040268,4.76022749640005,1655,124361,fhi:git
county,Rogaland,2021-04-28,5643,2364,107029,25339,22.1755120222938,5.25002848884791,8007,132368,fhi:git
county,Rogaland,2021-04-29,4601,1200,111630,26539,23.1288006713009,5.49865843425292,5801,138169,fhi:git
county,Rogaland,2021-04-30,2320,355,113950,26894,23.6094852324172,5.57221145976857,2675,140844,fhi:git
county,Rogaland,2021-05-01,3,0,113953,26894,23.6101068072807,5.57221145976857,3,140847,fhi:git
county,Rogaland,2021-05-02,0,0,113953,26894,23.6101068072807,5.57221145976857,0,140847,fhi:git
county,Rogaland,2021-05-03,27,12,113980,26906,23.6157009810523,5.57469775922262,39,140886,fhi:git
county,Rogaland,2021-05-04,219,905,114199,27811,23.6610759460887,5.76220617638223,1124,142010,fhi:git
county,Troms og Finnmark,2020-12-27,0,0,0,0,0.0,0.0,0,0,fhi:git
county,Troms og Finnmark,2020-12-28,1,0,1,0,0.0004109966257177,0.0,1,1,fhi:git
county,Troms og Finnmark,2020-12-29,0,0,1,0,0.0004109966257177,0.0,0,1,fhi:git
county,Troms og Finnmark,2020-12-30,0,0,1,0,0.0004109966257177,0.0,0,1,fhi:git
county,Troms og Finnmark,2020-12-31,0,0,1,0,0.0004109966257177,0.0,0,1,fhi:git
county,Troms og Finnmark,2021-01-01,0,0,1,0,0.0004109966257177,0.0,0,1,fhi:git
county,Troms og Finnmark,2021-01-02,0,0,1,0,0.0004109966257177,0.0,0,1,fhi:git
county,Troms og Finnmark,2021-01-03,0,0,1,0,0.0004109966257177,0.0,0,1,fhi:git
county,Troms og Finnmark,2021-01-04,0,0,1,0,0.0004129364738528,0.0,0,1,fhi:git
county,Troms og Finnmark,2021-01-05,53,0,54,0,0.0222985695880546,0.0,53,54,fhi:git
county,Troms og Finnmark,2021-01-06,530,0,584,0,0.241154900730072,0.0,530,584,fhi:git
county,Troms og Finnmark,2021-01-07,189,0,773,0,0.319199894288263,0.0,189,773,fhi:git
county,Troms og Finnmark,2021-01-08,247,0,1020,0,0.42119520332992,0.0,247,1020,fhi:git
county,Troms og Finnmark,2021-01-09,0,0,1020,0,0.42119520332992,0.0,0,1020,fhi:git
county,Troms og Finnmark,2021-01-10,0,0,1020,0,0.42119520332992,0.0,0,1020,fhi:git
county,Troms og Finnmark,2021-01-11,0,0,1020,0,0.42119520332992,0.0,0,1020,fhi:git
county,Troms og Finnmark,2021-01-12,190,0,1210,0,0.499653133361964,0.0,190,1210,fhi:git
county,Troms og Finnmark,2021-01-13,570,0,1780,0,0.735026923458095,0.0,570,1780,fhi:git
county,Troms og Finnmark,2021-01-14,331,0,2111,0,0.871708896303393,0.0,331,2111,fhi:git
county,Troms og Finnmark,2021-01-15,38,0,2149,0,0.887400482309802,0.0,38,2149,fhi:git
county,Troms og Finnmark,2021-01-16,2,0,2151,0,0.888226355257507,0.0,2,2151,fhi:git
county,Troms og Finnmark,2021-01-17,0,0,2151,0,0.888226355257507,0.0,0,2151,fhi:git
county,Troms og Finnmark,2021-01-18,0,1,2151,1,0.888226355257507,0.0004129364738528,1,2152,fhi:git
county,Troms og Finnmark,2021-01-19,251,0,2402,1,0.991873410194576,0.0004129364738528,251,2403,fhi:git
county,Troms og Finnmark,2021-01-20,924,0,3326,1,1.37342671203462,0.0004129364738528,924,3327,fhi:git
county,Troms og Finnmark,2021-01-21,248,0,3574,1,1.47583495755013,0.0004129364738528,248,3575,fhi:git
county,Troms og Finnmark,2021-01-22,82,0,3656,1,1.50969574840607,0.0004129364738528,82,3657,fhi:git
county,Troms og Finnmark,2021-01-23,12,0,3668,1,1.5146509860923,0.0004129364738528,12,3669,fhi:git
county,Troms og Finnmark,2021-01-24,0,0,3668,1,1.5146509860923,0.0004129364738528,0,3669,fhi:git
county,Troms og Finnmark,2021-01-25,6,0,3674,1,1.51712860493542,0.0004129364738528,6,3675,fhi:git
county,Troms og Finnmark,2021-01-26,85,0,3759,1,1.55222820521291,0.0004129364738528,85,3760,fhi:git
county,Troms og Finnmark,2021-01-27,668,357,4427,358,1.82806976974662,0.147831257639325,1025,4785,fhi:git
county,Troms og Finnmark,2021-01-28,234,277,4661,635,1.92469690462819,0.262214660896568,511,5296,fhi:git
county,Troms og Finnmark,2021-01-29,105,243,4766,878,1.96805523438274,0.362558224042813,348,5644,fhi:git
county,Troms og Finnmark,2021-01-30,0,0,4766,878,1.96805523438274,0.362558224042813,0,5644,fhi:git
county,Troms og Finnmark,2021-01-31,0,0,4766,878,1.96805523438274,0.362558224042813,0,5644,fhi:git
county,Troms og Finnmark,2021-02-01,0,1,4766,879,1.96805523438274,0.362971160516666,1,5645,fhi:git
county,Troms og Finnmark,2021-02-02,119,24,4885,903,2.01719467477123,0.372881635889135,143,5788,fhi:git
county,Troms og Finnmark,2021-02-03,1160,563,6045,1466,2.49620098444055,0.605364870668296,1723,7511,fhi:git
county,Troms og Finnmark,2021-02-04,1149,381,7194,1847,2.97066499289749,0.762693667206237,1530,9041,fhi:git
county,Troms og Finnmark,2021-02-05,288,141,7482,1988,3.08959069736712,0.820917710019491,429,9470,fhi:git
county,Troms og Finnmark,2021-02-06,1,1,7483,1989,3.09000363384097,0.821330646493344,2,9472,fhi:git
county,Troms og Finnmark,2021-02-07,0,0,7483,1989,3.09000363384097,0.821330646493344,0,9472,fhi:git
county,Troms og Finnmark,2021-02-08,0,0,7483,1989,3.09000363384097,0.821330646493344,0,9472,fhi:git
county,Troms og Finnmark,2021-02-09,71,29,7554,2018,3.11932212348452,0.833305804235076,100,9572,fhi:git
county,Troms og Finnmark,2021-02-10,1411,812,8965,2830,3.70197548809091,1.1686102210036,2223,11795,fhi:git
county,Troms og Finnmark,2021-02-11,997,467,9962,3297,4.11367315252222,1.36145155429289,1464,13259,fhi:git
county,Troms og Finnmark,2021-02-12,294,114,10256,3411,4.23507647583496,1.40852631231211,408,13667,fhi:git
county,Troms og Finnmark,2021-02-13,5,2,10261,3413,4.23714115820422,1.40935218525982,7,13674,fhi:git
county,Troms og Finnmark,2021-02-14,0,0,10261,3413,4.23714115820422,1.40935218525982,0,13674,fhi:git
county,Troms og Finnmark,2021-02-15,0,6,10261,3419,4.23714115820422,1.41182980410294,6,13680,fhi:git
county,Troms og Finnmark,2021-02-16,133,52,10394,3471,4.29206170922665,1.43330250074329,185,13865,fhi:git
county,Troms og Finnmark,2021-02-17,968,583,11362,4054,4.69178421591622,1.6740444649995,1551,15416,fhi:git
county,Troms og Finnmark,2021-02-18,1299,261,12661,4315,5.22818869545109,1.7818208846751,1560,16976,fhi:git
county,Troms og Finnmark,2021-02-19,232,135,12893,4450,5.32398995738496,1.83756730864524,367,17343,fhi:git
county,Troms og Finnmark,2021-02-20,0,0,12893,4450,5.32398995738496,1.83756730864524,0,17343,fhi:git
county,Troms og Finnmark,2021-02-21,1,0,12894,4450,5.32440289385881,1.83756730864524,1,17344,fhi:git
county,Troms og Finnmark,2021-02-22,107,0,13001,4450,5.36858709656107,1.83756730864524,107,17451,fhi:git
county,Troms og Finnmark,2021-02-23,79,78,13080,4528,5.40120907799544,1.86977635360576,157,17608,fhi:git
county,Troms og Finnmark,2021-02-24,431,993,13511,5521,5.57918469822603,2.27982227214165,1424,19032,fhi:git
county,Troms og Finnmark,2021-02-25,569,1055,14080,6576,5.8141455518483,2.71547025205642,1624,20656,fhi:git
county,Troms og Finnmark,2021-02-26,283,407,14363,6983,5.93100657394866,2.88353539691454,690,21346,fhi:git
county,Troms og Finnmark,2021-02-27,0,0,14363,6983,5.93100657394866,2.88353539691454,0,21346,fhi:git
county,Troms og Finnmark,2021-02-28,3,0,14366,6983,5.93224538337022,2.88353539691454,3,21349,fhi:git
county,Troms og Finnmark,2021-03-01,341,0,14707,6983,6.07305672095405,2.88353539691454,341,21690,fhi:git
county,Troms og Finnmark,2021-03-02,560,72,15267,7055,6.30430114631165,2.91326682303195,632,22322,fhi:git
county,Troms og Finnmark,2021-03-03,599,1184,15866,8239,6.55165009414952,3.40218360807373,1783,24105,fhi:git
county,Troms og Finnmark,2021-03-04,881,936,16747,9175,6.91544712761389,3.78869214760001,1817,25922,fhi:git
county,Troms og Finnmark,2021-03-05,725,374,17472,9549,7.21482607115721,3.94313038882098,1099,27021,fhi:git
county,Troms og Finnmark,2021-03-06,0,1,17472,9550,7.21482607115721,3.94354332529484,1,27022,fhi:git
county,Troms og Finnmark,2021-03-07,0,0,17472,9550,7.21482607115721,3.94354332529484,0,27022,fhi:git
county,Troms og Finnmark,2021-03-08,434,0,17906,9550,7.39404050080936,3.94354332529484,434,27456,fhi:git
county,Troms og Finnmark,2021-03-09,624,51,18530,9601,7.65171286049354,3.96460308546133,675,28131,fhi:git
county,Troms og Finnmark,2021-03-10,939,701,19469,10302,8.03946020944138,4.25407155363219,1640,29771,fhi:git
county,Troms og Finnmark,2021-03-11,813,1043,20282,11345,8.37517756268376,4.68476429586073,1856,31627,fhi:git
county,Troms og Finnmark,2021-03-12,68,210,20350,11555,8.40325724290575,4.77148095536983,278,31905,fhi:git
county,Troms og Finnmark,2021-03-13,0,0,20350,11555,8.40325724290575,4.77148095536983,0,31905,fhi:git
county,Troms og Finnmark,2021-03-14,0,0,20350,11555,8.40325724290575,4.77148095536983,0,31905,fhi:git
county,Troms og Finnmark,2021-03-15,3,5,20353,11560,8.40449605232731,4.77354563773909,8,31913,fhi:git
county,Troms og Finnmark,2021-03-16,21,2,20374,11562,8.41316771827822,4.7743715106868,23,31936,fhi:git
county,Troms og Finnmark,2021-03-17,548,46,20922,11608,8.63945690594959,4.79336658848403,594,32530,fhi:git
county,Troms og Finnmark,2021-03-18,1114,122,22036,11730,9.09946813782168,4.84374483829408,1236,33766,fhi:git
county,Troms og Finnmark,2021-03-19,407,33,22443,11763,9.26753328267979,4.85737174193122,440,34206,fhi:git
county,Troms og Finnmark,2021-03-20,0,0,22443,11763,9.26753328267979,4.85737174193122,0,34206,fhi:git
county,Troms og Finnmark,2021-03-21,1,0,22444,11763,9.26794621915365,4.85737174193122,1,34207,fhi:git
county,Troms og Finnmark,2021-03-22,3,0,22447,11763,9.2691850285752,4.85737174193122,3,34210,fhi:git
county,Troms og Finnmark,2021-03-23,428,14,22875,11777,9.44592183938423,4.86315285256516,442,34652,fhi:git
county,Troms og Finnmark,2021-03-24,1877,42,24752,11819,10.2210036008061,4.88049618446698,1919,36571,fhi:git
county,Troms og Finnmark,2021-03-25,1996,38,26748,11857,11.0452248026164,4.89618777047339,2034,38605,fhi:git
county,Troms og Finnmark,2021-03-26,558,15,27306,11872,11.2756433550263,4.90238181758118,573,39178,fhi:git
county,Troms og Finnmark,2021-03-27,1,0,27307,11872,11.2760562915001,4.90238181758118,1,39179,fhi:git
county,Troms og Finnmark,2021-03-28,0,0,27307,11872,11.2760562915001,4.90238181758118,0,39179,fhi:git
county,Troms og Finnmark,2021-03-29,176,0,27483,11872,11.3487331108982,4.90238181758118,176,39355,fhi:git
county,Troms og Finnmark,2021-03-30,1625,149,29108,12021,12.0197548809091,4.96390935218526,1774,41129,fhi:git
county,Troms og Finnmark,2021-03-31,1429,291,30537,12312,12.6098411020449,5.08407386607644,1720,42849,fhi:git
county,Troms og Finnmark,2021-04-01,165,35,30702,12347,12.6779756202306,5.09852664266129,200,43049,fhi:git
county,Troms og Finnmark,2021-04-02,27,14,30729,12361,12.6891249050246,5.10430775329523,41,43090,fhi:git
county,Troms og Finnmark,2021-04-03,1,0,30730,12361,12.6895378414985,5.10430775329523,1,43091,fhi:git
county,Troms og Finnmark,2021-04-04,0,0,30730,12361,12.6895378414985,5.10430775329523,0,43091,fhi:git
county,Troms og Finnmark,2021-04-05,0,0,30730,12361,12.6895378414985,5.10430775329523,0,43091,fhi:git
county,Troms og Finnmark,2021-04-06,722,13,31452,12374,12.9876779756202,5.10967592745532,735,43826,fhi:git
county,Troms og Finnmark,2021-04-07,2686,60,34138,12434,14.096825344389,5.13445211588649,2746,46572,fhi:git
county,Troms og Finnmark,2021-04-08,2504,320,36642,12754,15.1308182749166,5.26659178751941,2824,49396,fhi:git
county,Troms og Finnmark,2021-04-09,1994,62,38636,12816,15.9542136037792,5.29219384889829,2056,51452,fhi:git
county,Troms og Finnmark,2021-04-10,4,1,38640,12817,15.9558653496746,5.29260678537214,5,51457,fhi:git
county,Troms og Finnmark,2021-04-11,1,0,38641,12817,15.9562782861485,5.29260678537214,1,51458,fhi:git
county,Troms og Finnmark,2021-04-12,4,4,38645,12821,15.9579300320439,5.29425853126755,8,51466,fhi:git
county,Troms og Finnmark,2021-04-13,505,17,39150,12838,16.1664629513396,5.30127845132305,522,51988,fhi:git
county,Troms og Finnmark,2021-04-14,3076,38,42226,12876,17.436655544911,5.31697003732946,3114,55102,fhi:git
county,Troms og Finnmark,2021-04-15,3184,118,45410,12994,18.7514452776585,5.3656965412441,3302,58404,fhi:git
county,Troms og Finnmark,2021-04-16,1721,8,47131,13002,19.4621089491593,5.36900003303492,1729,60133,fhi:git
county,Troms og Finnmark,2021-04-17,2,0,47133,13002,19.462934822107,5.36900003303492,2,60135,fhi:git
county,Troms og Finnmark,2021-04-18,0,0,47133,13002,19.462934822107,5.36900003303492,0,60135,fhi:git
county,Troms og Finnmark,2021-04-19,6,0,47139,13002,19.4654124409501,5.36900003303492,6,60141,fhi:git
county,Troms og Finnmark,2021-04-20,547,1,47686,13003,19.6912886921476,5.36941296950877,548,60689,fhi:git
county,Troms og Finnmark,2021-04-21,2463,162,50149,13165,20.7083512272472,5.43630867827293,2625,63314,fhi:git
county,Troms og Finnmark,2021-04-22,2534,36,52683,13201,21.7547322519904,5.45117439133164,2570,65884,fhi:git
county,Troms og Finnmark,2021-04-23,1716,20,54399,13221,22.4633312411219,5.45943312080869,1736,67620,fhi:git
county,Troms og Finnmark,2021-04-24,0,0,54399,13221,22.4633312411219,5.45943312080869,0,67620,fhi:git
county,Troms og Finnmark,2021-04-25,0,0,54399,13221,22.4633312411219,5.45943312080869,0,67620,fhi:git
county,Troms og Finnmark,2021-04-26,10,0,54409,13221,22.4674606058604,5.45943312080869,10,67630,fhi:git
county,Troms og Finnmark,2021-04-27,506,10,54915,13231,22.6764064616299,5.46356248554722,516,68146,fhi:git
county,Troms og Finnmark,2021-04-28,2561,597,57476,13828,23.7339367711671,5.71008556043738,3158,71304,fhi:git
county,Troms og Finnmark,2021-04-29,2065,840,59541,14668,24.5866505896733,6.05695219847379,2905,74209,fhi:git
county,Troms og Finnmark,2021-04-30,1561,416,61102,15084,25.2312444253576,6.22873377159658,1977,76186,fhi:git
county,Troms og Finnmark,2021-05-01,0,0,61102,15084,25.2312444253576,6.22873377159658,0,76186,fhi:git
county,Troms og Finnmark,2021-05-02,0,1,61102,15085,25.2312444253576,6.22914670807043,1,76187,fhi:git
county,Troms og Finnmark,2021-05-03,57,2,61159,15087,25.2547818043672,6.22997258101814,59,76246,fhi:git
county,Troms og Finnmark,2021-05-04,237,542,61396,15629,25.3526477486703,6.45378414984639,779,77025,fhi:git
county,Trøndelag,2020-12-27,0,0,0,0,0.0,0.0,0,0,fhi:git
county,Trøndelag,2020-12-28,0,0,0,0,0.0,0.0,0,0,fhi:git
county,Trøndelag,2020-12-29,0,0,0,0,0.0,0.0,0,0,fhi:git
county,Trøndelag,2020-12-30,0,0,0,0,0.0,0.0,0,0,fhi:git
county,Trøndelag,2020-12-31,0,0,0,0,0.0,0.0,0,0,fhi:git
county,Trøndelag,2021-01-01,0,0,0,0,0.0,0.0,0,0,fhi:git
county,Trøndelag,2021-01-02,0,0,0,0,0.0,0.0,0,0,fhi:git
county,Trøndelag,2021-01-03,0,0,0,0,0.0,0.0,0,0,fhi:git
county,Trøndelag,2021-01-04,3,0,3,0,0.0006367750316264,0.0,3,3,fhi:git
county,Trøndelag,2021-01-05,407,0,410,0,0.0870259209889541,0.0,407,410,fhi:git
county,Trøndelag,2021-01-06,675,0,1085,0,0.230300303104915,0.0,675,1085,fhi:git
county,Trøndelag,2021-01-07,483,0,1568,0,0.332821083196781,0.0,483,1568,fhi:git
county,Trøndelag,2021-01-08,141,0,1709,0,0.362749509683226,0.0,141,1709,fhi:git
county,Trøndelag,2021-01-09,0,0,1709,0,0.362749509683226,0.0,0,1709,fhi:git
county,Trøndelag,2021-01-10,0,0,1709,0,0.362749509683226,0.0,0,1709,fhi:git
county,Trøndelag,2021-01-11,96,0,1805,0,0.383126310695273,0.0,96,1805,fhi:git
county,Trøndelag,2021-01-12,502,0,2307,0,0.489679999320773,0.0,502,2307,fhi:git
county,Trøndelag,2021-01-13,861,0,3168,0,0.672434433397577,0.0,861,3168,fhi:git
county,Trøndelag,2021-01-14,671,0,3839,0,0.814859782138036,0.0,671,3839,fhi:git
county,Trøndelag,2021-01-15,253,0,4092,0,0.868561143138537,0.0,253,4092,fhi:git
county,Trøndelag,2021-01-16,0,0,4092,0,0.868561143138537,0.0,0,4092,fhi:git
county,Trøndelag,2021-01-17,0,0,4092,0,0.868561143138537,0.0,0,4092,fhi:git
county,Trøndelag,2021-01-18,152,0,4244,0,0.900824411407612,0.0,152,4244,fhi:git
county,Trøndelag,2021-01-19,569,0,4813,0,1.02159940907277,0.0,569,4813,fhi:git
county,Trøndelag,2021-01-20,739,0,5552,0,1.17845832519676,0.0,739,5552,fhi:git
county,Trøndelag,2021-01-21,536,0,6088,0,1.29222879751403,0.0,536,6088,fhi:git
county,Trøndelag,2021-01-22,283,0,6371,0,1.3522979088308,0.0,283,6371,fhi:git
county,Trøndelag,2021-01-23,1,0,6372,0,1.35251016717467,0.0,1,6372,fhi:git
county,Trøndelag,2021-01-24,0,0,6372,0,1.35251016717467,0.0,0,6372,fhi:git
county,Trøndelag,2021-01-25,1,0,6373,0,1.35272242551855,0.0,1,6373,fhi:git
county,Trøndelag,2021-01-26,313,191,6686,191,1.41915928715158,0.0405413436802201,504,6877,fhi:git
county,Trøndelag,2021-01-27,1013,605,7699,796,1.63417698949746,0.168957641724896,1618,8495,fhi:git
county,Trøndelag,2021-01-28,727,483,8426,1279,1.78848880549494,0.271478421816762,1210,9705,fhi:git
county,Trøndelag,2021-01-29,423,229,8849,1508,1.87827408495428,0.320085582564251,652,10357,fhi:git
county,Trøndelag,2021-01-30,1,0,8850,1508,1.87848634329816,0.320085582564251,1,10358,fhi:git
county,Trøndelag,2021-01-31,2,1,8852,1509,1.87891085998591,0.320297840908126,3,10361,fhi:git
county,Trøndelag,2021-02-01,15,86,8867,1595,1.88209473514404,0.338552058481419,101,10462,fhi:git
county,Trøndelag,2021-02-02,836,393,9703,1988,2.05954271062395,0.42196958762449,1229,11691,fhi:git
county,Trøndelag,2021-02-03,2124,811,11827,2799,2.51037943301551,0.594111104507518,2935,14626,fhi:git
county,Trøndelag,2021-02-04,2145,608,13972,3407,2.96567358062845,0.723164177583821,2753,17379,fhi:git
county,Trøndelag,2021-02-05,1290,321,15262,3728,3.23948684422785,0.791299105967856,1611,18990,fhi:git
county,Trøndelag,2021-02-06,7,0,15269,3728,3.24097265263497,0.791299105967856,7,18997,fhi:git
county,Trøndelag,2021-02-07,1,0,15270,3728,3.24118491097885,0.791299105967856,1,18998,fhi:git
county,Trøndelag,2021-02-08,3,150,15273,3878,3.24182168601048,0.82313785754918,153,19151,fhi:git
county,Trøndelag,2021-02-09,836,524,16109,4402,3.41926966149039,0.934361229739941,1360,20511,fhi:git
county,Trøndelag,2021-02-10,2235,631,18344,5033,3.89366706005213,1.06829624472538,2866,23377,fhi:git
county,Trøndelag,2021-02-11,2362,587,20706,5620,4.39502126828606,1.1928918925803,2949,26326,fhi:git
county,Trøndelag,2021-02-12,890,353,21596,5973,4.58393119433525,1.26781908796835,1243,27569,fhi:git
county,Trøndelag,2021-02-13,2,0,21598,5973,4.584355711023,1.26781908796835,2,27571,fhi:git
county,Trøndelag,2021-02-14,0,0,21598,5973,4.584355711023,1.26781908796835,0,27571,fhi:git
county,Trøndelag,2021-02-15,0,2,21598,5975,4.584355711023,1.2682436046561,2,27573,fhi:git
county,Trøndelag,2021-02-16,345,210,21943,6185,4.65758483966005,1.31281785686995,555,28128,fhi:git
county,Trøndelag,2021-02-17,2226,922,24169,7107,5.13007191312691,1.50852004992316,3148,31276,fhi:git
county,Trøndelag,2021-02-18,2124,752,26293,7859,5.58090863551846,1.66813832451754,2876,34152,fhi:git
county,Trøndelag,2021-02-19,1263,414,27556,8273,5.84899092383322,1.75601327888199,1677,35829,fhi:git
county,Trøndelag,2021-02-20,1,1,27557,8274,5.84920318217709,1.75622553722587,2,35831,fhi:git
county,Trøndelag,2021-02-21,0,4,27557,8278,5.84920318217709,1.75707457060137,4,35835,fhi:git
county,Trøndelag,2021-02-22,17,3,27574,8281,5.85281157402298,1.757711345633,20,35855,fhi:git
county,Trøndelag,2021-02-23,333,674,27907,8955,5.92349360253352,1.90077346940508,1007,36862,fhi:git
county,Trøndelag,2021-02-24,1010,2047,28917,11002,6.13787452984777,2.33526629931823,3057,39919,fhi:git
county,Trøndelag,2021-02-25,472,1983,29389,12985,6.238060468157,2.75617459522334,2455,42374,fhi:git
county,Trøndelag,2021-02-26,630,1156,30019,14141,6.37178322479857,3.00154524074341,1786,44160,fhi:git
county,Trøndelag,2021-02-27,4,1,30023,14142,6.37263225817407,3.00175749908729,5,44165,fhi:git
county,Trøndelag,2021-02-28,0,0,30023,14142,6.37263225817407,3.00175749908729,0,44165,fhi:git
county,Trøndelag,2021-03-01,545,0,30568,14142,6.48831305558622,3.00175749908729,545,44710,fhi:git
county,Trøndelag,2021-03-02,819,785,31387,14927,6.66215263922025,3.16838029902956,1604,46314,fhi:git
county,Trøndelag,2021-03-03,2047,2146,33434,17073,7.09664546913339,3.62388670498637,4193,50507,fhi:git
county,Trøndelag,2021-03-04,1874,2283,35308,19356,7.49441760555607,4.10847250405413,4157,54664,fhi:git
county,Trøndelag,2021-03-05,1048,983,36356,20339,7.7168643499376,4.31712245608375,2031,56695,fhi:git
county,Trøndelag,2021-03-06,3,0,36359,20339,7.71750112496922,4.31712245608375,3,56698,fhi:git
county,Trøndelag,2021-03-07,0,1,36359,20340,7.71750112496922,4.31733471442762,1,56699,fhi:git
county,Trøndelag,2021-03-08,434,0,36793,20340,7.80962124621119,4.31733471442762,434,57133,fhi:git
county,Trøndelag,2021-03-09,1172,301,37965,20641,8.05838802523327,4.38122447593415,1473,58606,fhi:git
county,Trøndelag,2021-03-10,1688,1501,39653,22142,8.41668010969511,4.69982425009127,3189,61795,fhi:git
county,Trøndelag,2021-03-11,821,1212,40474,23354,8.5909442100169,4.95708136286837,2033,63828,fhi:git
county,Trøndelag,2021-03-12,122,505,40596,23859,8.61683972796971,5.0642718265255,627,64455,fhi:git
county,Trøndelag,2021-03-13,1,1,40597,23860,8.61705198631358,5.06448408486938,2,64457,fhi:git
county,Trøndelag,2021-03-14,0,0,40597,23860,8.61705198631358,5.06448408486938,0,64457,fhi:git
county,Trøndelag,2021-03-15,3,6,40600,23866,8.61768876134521,5.06575763493263,9,64466,fhi:git
county,Trøndelag,2021-03-16,607,12,41207,23878,8.74652957607764,5.06830473505914,619,65085,fhi:git
county,Trøndelag,2021-03-17,1982,122,43189,24000,9.16722561363887,5.09420025301195,2104,67189,fhi:git
county,Trøndelag,2021-03-18,1504,123,44693,24123,9.48646216282762,5.12030802930863,1627,68816,fhi:git
county,Trøndelag,2021-03-19,543,87,45236,24210,9.60171844355202,5.1387745052258,630,69446,fhi:git
county,Trøndelag,2021-03-20,0,0,45236,24210,9.60171844355202,5.1387745052258,0,69446,fhi:git
county,Trøndelag,2021-03-21,0,0,45236,24210,9.60171844355202,5.1387745052258,0,69446,fhi:git
county,Trøndelag,2021-03-22,1,0,45237,24210,9.60193070189589,5.1387745052258,1,69447,fhi:git
county,Trøndelag,2021-03-23,1045,216,46282,24426,9.82374067124579,5.18462230750291,1261,70708,fhi:git
county,Trøndelag,2021-03-24,3151,569,49433,24995,10.4925667127975,5.30539730516807,3720,74428,fhi:git
county,Trøndelag,2021-03-25,2888,304,52321,25299,11.1055688099099,5.36992384170622,3192,77620,fhi:git
county,Trøndelag,2021-03-26,1987,228,54308,25527,11.5273261391905,5.41831874410983,2215,79835,fhi:git
county,Trøndelag,2021-03-27,0,3,54308,25530,11.5273261391905,5.41895551914146,3,79838,fhi:git
county,Trøndelag,2021-03-28,0,0,54308,25530,11.5273261391905,5.41895551914146,0,79838,fhi:git
county,Trøndelag,2021-03-29,3,0,54311,25530,11.5279629142222,5.41895551914146,3,79841,fhi:git
county,Trøndelag,2021-03-30,1874,535,56185,26065,11.9257350506448,5.53251373311485,2409,82250,fhi:git
county,Trøndelag,2021-03-31,2569,422,58754,26487,12.471026736061,5.62208675423031,2991,85241,fhi:git
county,Trøndelag,2021-04-01,163,156,58917,26643,12.5056248461127,5.65519905587489,319,85560,fhi:git
county,Trøndelag,2021-04-02,159,95,59076,26738,12.5393739227889,5.67536359854306,254,85814,fhi:git
county,Trøndelag,2021-04-03,0,0,59076,26738,12.5393739227889,5.67536359854306,0,85814,fhi:git
county,Trøndelag,2021-04-04,0,0,59076,26738,12.5393739227889,5.67536359854306,0,85814,fhi:git
county,Trøndelag,2021-04-05,1,0,59077,26738,12.5395861811328,5.67536359854306,1,85815,fhi:git
county,Trøndelag,2021-04-06,2098,41,61175,26779,12.9849041865836,5.68406619064195,2139,87954,fhi:git
county,Trøndelag,2021-04-07,4459,229,65634,27008,13.9313641419244,5.73267335138944,4688,92642,fhi:git
county,Trøndelag,2021-04-08,4738,116,70372,27124,14.9370441752065,5.757295319279,4854,97496,fhi:git
county,Trøndelag,2021-04-09,2679,33,73051,27157,15.505684278449,5.76429984462689,2712,100208,fhi:git
county,Trøndelag,2021-04-10,0,0,73051,27157,15.505684278449,5.76429984462689,0,100208,fhi:git
county,Trøndelag,2021-04-11,0,0,73051,27157,15.505684278449,5.76429984462689,0,100208,fhi:git
county,Trøndelag,2021-04-12,278,4,73329,27161,15.5646920980464,5.76514887800239,282,100490,fhi:git
county,Trøndelag,2021-04-13,2136,11,75465,27172,16.0180759205644,5.76748371978503,2147,102637,fhi:git
county,Trøndelag,2021-04-14,5349,217,80814,27389,17.1534458019545,5.81354378040601,5566,108203,fhi:git
county,Trøndelag,2021-04-15,5039,178,85853,27567,18.2230155967431,5.85132576561585,5217,113420,fhi:git
county,Trøndelag,2021-04-16,2759,28,88612,27595,18.8086363674956,5.85726899924436,2787,116207,fhi:git
county,Trøndelag,2021-04-17,2,0,88614,27595,18.8090608841834,5.85726899924436,2,116209,fhi:git
county,Trøndelag,2021-04-18,0,0,88614,27595,18.8090608841834,5.85726899924436,0,116209,fhi:git
county,Trøndelag,2021-04-19,1078,1,89692,27596,19.0378753788811,5.85748125758824,1079,117288,fhi:git
county,Trøndelag,2021-04-20,1639,34,91331,27630,19.3857668044931,5.86469804128,1673,118961,fhi:git
county,Trøndelag,2021-04-21,4552,120,95883,27750,20.3519667858144,5.89016904254506,4672,123633,fhi:git
county,Trøndelag,2021-04-22,4043,230,99926,27980,21.210127270103,5.93898846163643,4273,127906,fhi:git
county,Trøndelag,2021-04-23,2558,16,102484,27996,21.7530841137365,5.94238459513844,2574,130480,fhi:git
county,Trøndelag,2021-04-24,0,0,102484,27996,21.7530841137365,5.94238459513844,0,130480,fhi:git
county,Trøndelag,2021-04-25,0,0,102484,27996,21.7530841137365,5.94238459513844,0,130480,fhi:git
county,Trøndelag,2021-04-26,1031,5,103515,28001,21.9719224662722,5.94344588685781,1036,131516,fhi:git
county,Trøndelag,2021-04-27,1524,596,105039,28597,22.2954041823384,6.06995185980761,2120,133636,fhi:git
county,Trøndelag,2021-04-28,3579,1989,108618,30586,23.0550767950688,6.49213370577597,5568,139204,fhi:git
county,Trøndelag,2021-04-29,3654,1686,112272,32272,23.8306687835899,6.85000127355006,5340,144544,fhi:git
county,Trøndelag,2021-04-30,2585,556,114857,32828,24.379356602508,6.96801691274484,3141,147685,fhi:git
county,Trøndelag,2021-05-01,2,1,114859,32829,24.3797811191958,6.96822917108872,3,147688,fhi:git
county,Trøndelag,2021-05-02,0,0,114859,32829,24.3797811191958,6.96822917108872,0,147688,fhi:git
county,Trøndelag,2021-05-03,975,5,115834,32834,24.5867330044744,6.96929046280809,980,148668,fhi:git
county,Trøndelag,2021-05-04,672,997,116506,33831,24.7293706115587,7.18091203165197,1669,150337,fhi:git
county,Vestfold og Telemark,2020-12-27,0,0,0,0,0.0,0.0,0,0,fhi:git
county,Vestfold og Telemark,2020-12-28,0,0,0,0,0.0,0.0,0,0,fhi:git
county,Vestfold og Telemark,2020-12-29,0,0,0,0,0.0,0.0,0,0,fhi:git
county,Vestfold og Telemark,2020-12-30,0,0,0,0,0.0,0.0,0,0,fhi:git
county,Vestfold og Telemark,2020-12-31,0,0,0,0,0.0,0.0,0,0,fhi:git
county,Vestfold og Telemark,2021-01-01,0,0,0,0,0.0,0.0,0,0,fhi:git
county,Vestfold og Telemark,2021-01-02,0,0,0,0,0.0,0.0,0,0,fhi:git
county,Vestfold og Telemark,2021-01-03,0,0,0,0,0.0,0.0,0,0,fhi:git
county,Vestfold og Telemark,2021-01-04,1,0,1,0,0.0002370331040433,0.0,1,1,fhi:git
county,Vestfold og Telemark,2021-01-05,218,0,219,0,0.051910249785485,0.0,218,219,fhi:git
county,Vestfold og Telemark,2021-01-06,1025,0,1244,0,0.294869181429879,0.0,1025,1244,fhi:git
county,Vestfold og Telemark,2021-01-07,443,0,1687,0,0.399874846521065,0.0,443,1687,fhi:git
county,Vestfold og Telemark,2021-01-08,63,0,1750,0,0.414807932075794,0.0,63,1750,fhi:git
county,Vestfold og Telemark,2021-01-09,0,0,1750,0,0.414807932075794,0.0,0,1750,fhi:git
county,Vestfold og Telemark,2021-01-10,3,0,1753,0,0.415519031387924,0.0,3,1753,fhi:git
county,Vestfold og Telemark,2021-01-11,3,0,1756,0,0.416230130700054,0.0,3,1756,fhi:git
county,Vestfold og Telemark,2021-01-12,421,0,2177,0,0.516021067502287,0.0,421,2177,fhi:git
county,Vestfold og Telemark,2021-01-13,1165,0,3342,0,0.792164633712744,0.0,1165,3342,fhi:git
county,Vestfold og Telemark,2021-01-14,582,0,3924,0,0.930117900265951,0.0,582,3924,fhi:git
county,Vestfold og Telemark,2021-01-15,158,0,4082,0,0.967569130704794,0.0,158,4082,fhi:git
county,Vestfold og Telemark,2021-01-16,4,0,4086,0,0.968517263120967,0.0,4,4086,fhi:git
county,Vestfold og Telemark,2021-01-17,42,0,4128,0,0.978472653490786,0.0,42,4128,fhi:git
county,Vestfold og Telemark,2021-01-18,7,0,4135,0,0.98013188521909,0.0,7,4135,fhi:git
county,Vestfold og Telemark,2021-01-19,232,0,4367,0,1.03512356535714,0.0,232,4367,fhi:git
county,Vestfold og Telemark,2021-01-20,1604,0,5971,0,1.41532466424261,0.0,1604,5971,fhi:git
county,Vestfold og Telemark,2021-01-21,833,0,6804,0,1.61277323991069,0.0,833,6804,fhi:git
county,Vestfold og Telemark,2021-01-22,181,0,6985,0,1.65567623174253,0.0,181,6985,fhi:git
county,Vestfold og Telemark,2021-01-23,3,0,6988,0,1.65638733105466,0.0,3,6988,fhi:git
county,Vestfold og Telemark,2021-01-24,0,0,6988,0,1.65638733105466,0.0,0,6988,fhi:git
county,Vestfold og Telemark,2021-01-25,44,0,7032,0,1.66681678763256,0.0,44,7032,fhi:git
county,Vestfold og Telemark,2021-01-26,103,179,7135,179,1.69123119734902,0.0424289256237526,282,7314,fhi:git
county,Vestfold og Telemark,2021-01-27,1625,898,8760,1077,2.0764099914194,0.255284653054646,2523,9837,fhi:git
county,Vestfold og Telemark,2021-01-28,656,450,9416,1527,2.23190370767181,0.361949549874135,1106,10943,fhi:git
county,Vestfold og Telemark,2021-01-29,86,91,9502,1618,2.25228855461954,0.383519562342077,177,11120,fhi:git
county,Vestfold og Telemark,2021-01-30,0,0,9502,1618,2.25228855461954,0.383519562342077,0,11120,fhi:git
county,Vestfold og Telemark,2021-01-31,2,2,9504,1620,2.25276262082763,0.383993628550163,4,11124,fhi:git
county,Vestfold og Telemark,2021-02-01,50,1,9554,1621,2.26461427602979,0.384230661654207,51,11175,fhi:git
county,Vestfold og Telemark,2021-02-02,465,328,10019,1949,2.37483466940993,0.461977519780413,793,11968,fhi:git
county,Vestfold og Telemark,2021-02-03,3220,893,13239,2842,3.13808126442939,0.673648081691089,4113,16081,fhi:git
county,Vestfold og Telemark,2021-02-04,1902,709,15141,3551,3.58891822831977,0.841704552457796,2611,18692,fhi:git
county,Vestfold og Telemark,2021-02-05,966,245,16107,3796,3.81789220682561,0.899777662948407,1211,19903,fhi:git
county,Vestfold og Telemark,2021-02-06,0,3,16107,3799,3.81789220682561,0.900488762260537,3,19906,fhi:git
county,Vestfold og Telemark,2021-02-07,2,1,16109,3800,3.81836627303369,0.900725795364581,3,19909,fhi:git
county,Vestfold og Telemark,2021-02-08,17,46,16126,3846,3.82239583580243,0.911629318150573,63,19972,fhi:git
county,Vestfold og Telemark,2021-02-09,356,208,16482,4054,3.90677962084185,0.960932203791582,564,20536,fhi:git
county,Vestfold og Telemark,2021-02-10,2891,1395,19373,5449,4.59204232463106,1.291593383932,4286,24822,fhi:git
county,Vestfold og Telemark,2021-02-11,1545,882,20918,6331,4.95825847037797,1.5006565816982,2427,27249,fhi:git
county,Vestfold og Telemark,2021-02-12,602,213,21520,6544,5.10095239901205,1.55114463285943,815,28064,fhi:git
county,Vestfold og Telemark,2021-02-13,2,2,21522,6546,5.10142646522013,1.55161869906751,4,28068,fhi:git
county,Vestfold og Telemark,2021-02-14,0,0,21522,6546,5.10142646522013,1.55161869906751,0,28068,fhi:git
county,Vestfold og Telemark,2021-02-15,4,2,21526,6548,5.10237459763631,1.5520927652756,6,28074,fhi:git
county,Vestfold og Telemark,2021-02-16,579,75,22105,6623,5.23961676487738,1.56987024807885,654,28728,fhi:git
county,Vestfold og Telemark,2021-02-17,3045,1534,25150,8157,5.96138256668926,1.93347902968129,4579,33307,fhi:git
county,Vestfold og Telemark,2021-02-18,1826,637,26976,8794,6.39420501467235,2.08446911695687,2463,35770,fhi:git
county,Vestfold og Telemark,2021-02-19,284,84,27260,8878,6.46152241622065,2.10437989769651,368,36138,fhi:git
county,Vestfold og Telemark,2021-02-20,0,1,27260,8879,6.46152241622065,2.10461693080056,1,36139,fhi:git
county,Vestfold og Telemark,2021-02-21,1,1,27261,8880,6.46175944932469,2.1048539639046,2,36141,fhi:git
county,Vestfold og Telemark,2021-02-22,50,0,27311,8880,6.47361110452686,2.1048539639046,50,36191,fhi:git
county,Vestfold og Telemark,2021-02-23,625,386,27936,9266,6.62175679455393,2.19634874206532,1011,37202,fhi:git
county,Vestfold og Telemark,2021-02-24,669,2872,28605,12138,6.7803319411589,2.87710781687771,3541,40743,fhi:git
county,Vestfold og Telemark,2021-02-25,706,2009,29311,14147,6.94767731261348,3.35330732290072,2715,43458,fhi:git
county,Vestfold og Telemark,2021-02-26,542,848,29853,14995,7.07614925500495,3.55431139512944,1390,44848,fhi:git
county,Vestfold og Telemark,2021-02-27,3,2,29856,14997,7.07686035431708,3.55478546133753,5,44853,fhi:git
county,Vestfold og Telemark,2021-02-28,1,0,29857,14997,7.07709738742113,3.55478546133753,1,44854,fhi:git
county,Vestfold og Telemark,2021-03-01,607,0,30464,14997,7.22097648157542,3.55478546133753,607,45461,fhi:git
county,Vestfold og Telemark,2021-03-02,845,354,31309,15351,7.42126945449201,3.63869518016886,1199,46660,fhi:git
county,Vestfold og Telemark,2021-03-03,1976,2815,33285,18166,7.8896468680816,4.30594336805078,4791,51451,fhi:git
county,Vestfold og Telemark,2021-03-04,1011,1436,34296,19602,8.12928733626938,4.64632290545698,2447,53898,fhi:git
county,Vestfold og Telemark,2021-03-05,1476,591,35772,20193,8.47914819783731,4.78640946994657,2067,55965,fhi:git
county,Vestfold og Telemark,2021-03-06,3,1,35775,20194,8.47985929714944,4.78664650305062,4,55969,fhi:git
county,Vestfold og Telemark,2021-03-07,1,0,35776,20194,8.48009633025349,4.78664650305062,1,55970,fhi:git
county,Vestfold og Telemark,2021-03-08,236,0,36012,20194,8.53603614280771,4.78664650305062,236,56206,fhi:git
county,Vestfold og Telemark,2021-03-09,933,142,36945,20336,8.75718802888011,4.82030520382477,1075,57281,fhi:git
county,Vestfold og Telemark,2021-03-10,1592,2263,38537,22599,9.13454473051706,5.35671111827478,3855,61136,fhi:git
county,Vestfold og Telemark,2021-03-11,303,840,38840,23439,9.20636576104219,5.55581892567116,1143,62279,fhi:git
county,Vestfold og Telemark,2021-03-12,36,126,38876,23565,9.21489895278775,5.58568509678062,162,62441,fhi:git
county,Vestfold og Telemark,2021-03-13,1,2,38877,23567,9.21513598589179,5.5861591629887,3,62444,fhi:git
county,Vestfold og Telemark,2021-03-14,0,0,38877,23567,9.21513598589179,5.5861591629887,0,62444,fhi:git
county,Vestfold og Telemark,2021-03-15,2,3,38879,23570,9.21561005209988,5.58687026230083,5,62449,fhi:git
county,Vestfold og Telemark,2021-03-16,403,26,39282,23596,9.31113439302933,5.59303312300596,429,62878,fhi:git
county,Vestfold og Telemark,2021-03-17,3116,169,42398,23765,10.0497295452283,5.63309171758928,3285,66163,fhi:git
county,Vestfold og Telemark,2021-03-18,912,53,43310,23818,10.2659037361158,5.64565447210357,965,67128,fhi:git
county,Vestfold og Telemark,2021-03-19,27,32,43337,23850,10.272303629925,5.65323953143296,59,67187,fhi:git
county,Vestfold og Telemark,2021-03-20,1,0,43338,23850,10.272540663029,5.65323953143296,1,67188,fhi:git
county,Vestfold og Telemark,2021-03-21,0,1,43338,23851,10.272540663029,5.653476564537,1,67189,fhi:git
county,Vestfold og Telemark,2021-03-22,0,1,43338,23852,10.272540663029,5.65371359764105,1,67190,fhi:git
county,Vestfold og Telemark,2021-03-23,664,58,44002,23910,10.4299306441138,5.66746151767556,722,67912,fhi:git
county,Vestfold og Telemark,2021-03-24,4610,816,48612,24726,11.5226532537534,5.8608805305749,5426,73338,fhi:git
county,Vestfold og Telemark,2021-03-25,2947,273,51559,24999,12.2211898113691,5.92559056797872,3220,76558,fhi:git
county,Vestfold og Telemark,2021-03-26,899,152,52458,25151,12.434282571904,5.96161959979331,1051,77609,fhi:git
county,Vestfold og Telemark,2021-03-27,0,0,52458,25151,12.434282571904,5.96161959979331,0,77609,fhi:git
county,Vestfold og Telemark,2021-03-28,0,0,52458,25151,12.434282571904,5.96161959979331,0,77609,fhi:git
county,Vestfold og Telemark,2021-03-29,184,3,52642,25154,12.477896663048,5.96233069910544,187,77796,fhi:git
county,Vestfold og Telemark,2021-03-30,3018,80,55660,25234,13.1932625710507,5.9812933474289,3098,80894,fhi:git
county,Vestfold og Telemark,2021-03-31,3406,494,59066,25728,14.0005973234222,6.0983877008263,3900,84794,fhi:git
county,Vestfold og Telemark,2021-04-01,426,17,59492,25745,14.1015734257446,6.10241726359503,443,85237,fhi:git
county,Vestfold og Telemark,2021-04-02,3,3,59495,25748,14.1022845250568,6.10312836290716,6,85243,fhi:git
county,Vestfold og Telemark,2021-04-03,2,0,59497,25748,14.1027585912649,6.10312836290716,2,85245,fhi:git
county,Vestfold og Telemark,2021-04-04,0,0,59497,25748,14.1027585912649,6.10312836290716,0,85245,fhi:git
county,Vestfold og Telemark,2021-04-05,1,1,59498,25749,14.1029956243689,6.10336539601121,2,85247,fhi:git
county,Vestfold og Telemark,2021-04-06,968,40,60466,25789,14.3324436690828,6.11284672017294,1008,86255,fhi:git
county,Vestfold og Telemark,2021-04-07,6308,152,66774,25941,15.827648489388,6.14887575198752,6460,92715,fhi:git
county,Vestfold og Telemark,2021-04-08,3682,60,70456,26001,16.7004043784755,6.16309773823012,3742,96457,fhi:git
county,Vestfold og Telemark,2021-04-09,1266,14,71722,26015,17.0004882881943,6.16641620168673,1280,97737,fhi:git
county,Vestfold og Telemark,2021-04-10,2,0,71724,26015,17.0009623544024,6.16641620168673,2,97739,fhi:git
county,Vestfold og Telemark,2021-04-11,1,0,71725,26015,17.0011993875065,6.16641620168673,1,97740,fhi:git
county,Vestfold og Telemark,2021-04-12,10,0,71735,26015,17.0035697185469,6.16641620168673,10,97750,fhi:git
county,Vestfold og Telemark,2021-04-13,1284,14,73019,26029,17.3079202241385,6.16973466514333,1298,99048,fhi:git
county,Vestfold og Telemark,2021-04-14,6849,80,79868,26109,18.9313599537311,6.1886973134668,6929,105977,fhi:git
county,Vestfold og Telemark,2021-04-15,4554,89,84422,26198,20.0108087095444,6.20979325972665,4643,110620,fhi:git
county,Vestfold og Telemark,2021-04-16,1734,13,86156,26211,20.4218241119555,6.21287469007922,1747,112367,fhi:git
county,Vestfold og Telemark,2021-04-17,5,0,86161,26211,20.4230092774757,6.21287469007922,5,112372,fhi:git
county,Vestfold og Telemark,2021-04-18,0,0,86161,26211,20.4230092774757,6.21287469007922,0,112372,fhi:git
county,Vestfold og Telemark,2021-04-19,26,1,86187,26212,20.4291721381808,6.21311172318326,27,112399,fhi:git
county,Vestfold og Telemark,2021-04-20,708,20,86895,26232,20.5969915758435,6.21785238526413,728,113127,fhi:git
county,Vestfold og Telemark,2021-04-21,6482,785,93377,27017,22.1334401562522,6.40392337193813,7267,120394,fhi:git
county,Vestfold og Telemark,2021-04-22,3893,510,97270,27527,23.0562100302928,6.52481025500021,4403,124797,fhi:git
county,Vestfold og Telemark,2021-04-23,910,308,98180,27835,23.2719101549722,6.59781645104555,1218,126015,fhi:git
county,Vestfold og Telemark,2021-04-24,1,0,98181,27835,23.2721471880763,6.59781645104555,1,126016,fhi:git
county,Vestfold og Telemark,2021-04-25,0,0,98181,27835,23.2721471880763,6.59781645104555,0,126016,fhi:git
county,Vestfold og Telemark,2021-04-26,8,2,98189,27837,23.2740434529086,6.59829051725364,10,126026,fhi:git
county,Vestfold og Telemark,2021-04-27,1065,346,99254,28183,23.5264837087148,6.68030397125263,1411,127437,fhi:git
county,Vestfold og Telemark,2021-04-28,5292,3091,104546,31274,24.780862895312,7.4129732958505,8383,135820,fhi:git
county,Vestfold og Telemark,2021-04-29,4798,991,109344,32265,25.9181477285118,7.64787310195742,5789,141609,fhi:git
county,Vestfold og Telemark,2021-04-30,1125,43,110469,32308,26.1848099705605,7.65806552543128,1168,142777,fhi:git
county,Vestfold og Telemark,2021-05-01,44,0,110513,32308,26.1952394271384,7.65806552543128,44,142821,fhi:git
county,Vestfold og Telemark,2021-05-02,2,0,110515,32308,26.1957134933465,7.65806552543128,2,142823,fhi:git
county,Vestfold og Telemark,2021-05-03,34,6,110549,32314,26.203772618884,7.65948772405554,40,142863,fhi:git
county,Vestfold og Telemark,2021-05-04,416,440,110965,32754,26.302378390166,7.7637822898346,856,143719,fhi:git
county,Vestland,2020-12-27,0,0,0,0,0.0,0.0,0,0,fhi:git
county,Vestland,2020-12-28,0,0,0,0,0.0,0.0,0,0,fhi:git
county,Vestland,2020-12-29,0,0,0,0,0.0,0.0,0,0,fhi:git
county,Vestland,2020-12-30,0,0,0,0,0.0,0.0,0,0,fhi:git
county,Vestland,2020-12-31,0,0,0,0,0.0,0.0,0,0,fhi:git
county,Vestland,2021-01-01,0,0,0,0,0.0,0.0,0,0,fhi:git
county,Vestland,2021-01-02,0,0,0,0,0.0,0.0,0,0,fhi:git
county,Vestland,2021-01-03,1,0,1,0,0.0001571015394379,0.0,1,1,fhi:git
county,Vestland,2021-01-04,2,0,3,0,0.0004696151191022,0.0,2,3,fhi:git
county,Vestland,2021-01-05,416,0,419,0,0.0655895783012769,0.0,416,419,fhi:git
county,Vestland,2021-01-06,1257,0,1676,0,0.262358313205108,0.0,1257,1676,fhi:git
county,Vestland,2021-01-07,715,0,2391,0,0.37428324992447,0.0,715,2391,fhi:git
county,Vestland,2021-01-08,139,0,2530,0,0.396042083776206,0.0,139,2530,fhi:git
county,Vestland,2021-01-09,0,0,2530,0,0.396042083776206,0.0,0,2530,fhi:git
county,Vestland,2021-01-10,0,0,2530,0,0.396042083776206,0.0,0,2530,fhi:git
county,Vestland,2021-01-11,65,0,2595,0,0.406217078023421,0.0,65,2595,fhi:git
county,Vestland,2021-01-12,856,0,3451,0,0.540213925340588,0.0,856,3451,fhi:git
county,Vestland,2021-01-13,1126,0,4577,0,0.716476133376955,0.0,1126,4577,fhi:git
county,Vestland,2021-01-14,999,0,5576,0,0.872857968037995,0.0,999,5576,fhi:git
county,Vestland,2021-01-15,426,0,6002,0,0.93954331495051,0.0,426,6002,fhi:git
county,Vestland,2021-01-16,2,0,6004,0,0.939856391696578,0.0,2,6004,fhi:git
county,Vestland,2021-01-17,1,0,6005,0,0.940012930069613,0.0,1,6005,fhi:git
county,Vestland,2021-01-18,62,0,6067,0,0.949718309197725,0.0,62,6067,fhi:git
county,Vestland,2021-01-19,369,0,6436,0,1.0074809688473,0.0,369,6436,fhi:git
county,Vestland,2021-01-20,1237,0,7673,0,1.20111893629045,0.0,1237,7673,fhi:git
county,Vestland,2021-01-21,783,0,8456,0,1.32368848237613,0.0,783,8456,fhi:git
county,Vestland,2021-01-22,314,0,8770,0,1.37284153150883,0.0,314,8770,fhi:git
county,Vestland,2021-01-23,0,0,8770,0,1.37284153150883,0.0,0,8770,fhi:git
county,Vestland,2021-01-24,0,0,8770,0,1.37284153150883,0.0,0,8770,fhi:git
county,Vestland,2021-01-25,2,0,8772,0,1.37315460825489,0.0,2,8772,fhi:git
county,Vestland,2021-01-26,152,174,8924,174,1.39694844095607,0.0272376769079288,326,9098,fhi:git
county,Vestland,2021-01-27,1592,1212,10516,1386,1.64615753082632,0.216962185025226,2804,11902,fhi:git
county,Vestland,2021-01-28,1959,695,12475,2081,1.95281620360007,0.325756354283907,2654,14556,fhi:git
county,Vestland,2021-01-29,481,176,12956,2257,2.02811116102946,0.353307107937904,657,15213,fhi:git
county,Vestland,2021-01-30,3,0,12959,2257,2.02858077614856,0.353307107937904,3,15216,fhi:git
county,Vestland,2021-01-31,1,0,12960,2257,2.0287373145216,0.353307107937904,1,15217,fhi:git
county,Vestland,2021-02-01,13,59,12973,2316,2.03077231337104,0.362542871946915,72,15289,fhi:git
county,Vestland,2021-02-02,720,582,13693,2898,2.14347994195557,0.453648205052746,1302,16591,fhi:git
county,Vestland,2021-02-03,2830,1048,16523,3946,2.586483537642,0.617700419992455,3878,20469,fhi:git
county,Vestland,2021-02-04,2590,1127,19113,5073,2.99191792380025,0.794119166401856,3717,24186,fhi:git
county,Vestland,2021-02-05,912,488,20025,5561,3.13468092000733,0.870509892442484,1400,25586,fhi:git
county,Vestland,2021-02-06,0,2,20025,5563,3.13468092000733,0.870822969188552,2,25588,fhi:git
county,Vestland,2021-02-07,2,1,20027,5564,3.13499399675339,0.870979507561586,3,25591,fhi:git
county,Vestland,2021-02-08,8,49,20035,5613,3.13624630373767,0.878649887840256,57,25648,fhi:git
county,Vestland,2021-02-09,893,307,20928,5920,3.27603507085709,0.926707168361716,1200,26848,fhi:git
county,Vestland,2021-02-10,2760,973,23688,6893,3.70808098043114,1.07901900532387,3733,30581,fhi:git
county,Vestland,2021-02-11,2705,837,26393,7730,4.13151727948831,1.21004162355339,3542,34123,fhi:git
county,Vestland,2021-02-12,630,460,27023,8190,4.23013645449977,1.28204927514906,1090,35213,fhi:git
county,Vestland,2021-02-13,0,0,27023,8190,4.23013645449977,1.28204927514906,0,35213,fhi:git
county,Vestland,2021-02-14,0,2,27023,8192,4.23013645449977,1.28236235189513,2,35215,fhi:git
county,Vestland,2021-02-15,95,1,27118,8193,4.24500759993801,1.28251889026817,96,35311,fhi:git
county,Vestland,2021-02-16,1088,55,28206,8248,4.41532134979908,1.29112850078504,1143,36454,fhi:git
county,Vestland,2021-02-17,2708,1330,30914,9578,4.83922726397536,1.49932453692036,4038,40492,fhi:git
county,Vestland,2021-02-18,2008,2002,32922,11580,5.15355631702778,1.81271435973457,4010,44502,fhi:git
county,Vestland,2021-02-19,1157,541,34079,12121,5.3346712146282,1.89740161954601,1698,46200,fhi:git
county,Vestland,2021-02-20,3,5,34082,12126,5.3351408297473,1.89818431141118,8,46208,fhi:git
county,Vestland,2021-02-21,0,1,34082,12127,5.3351408297473,1.89834084978421,1,46209,fhi:git
county,Vestland,2021-02-22,49,2,34131,12129,5.34281121002597,1.89865392653028,51,46260,fhi:git
county,Vestland,2021-02-23,542,591,34673,12720,5.42765500821044,1.99116810499342,1133,47393,fhi:git
county,Vestland,2021-02-24,1414,2401,36087,15121,5.64900026768062,2.36701673864823,3815,51208,fhi:git
county,Vestland,2021-02-25,1257,2646,37344,17767,5.84576900258445,2.78121727369639,3903,55111,fhi:git
county,Vestland,2021-02-26,1428,876,38772,18643,6.06930579927711,2.91834488847424,2304,57415,fhi:git
county,Vestland,2021-02-27,5,0,38777,18643,6.07008849114228,2.91834488847424,5,57420,fhi:git
county,Vestland,2021-02-28,1,8,38778,18651,6.07024502951531,2.91959719545851,9,57429,fhi:git
county,Vestland,2021-03-01,440,11,39218,18662,6.1391219136503,2.92131911756188,451,57880,fhi:git
county,Vestland,2021-03-02,1349,759,40567,19421,6.35029217887327,3.04013174269475,2108,59988,fhi:git
county,Vestland,2021-03-03,1744,2050,42311,21471,6.62329510144469,3.3610354074146,3794,63782,fhi:git
county,Vestland,2021-03-04,1804,2850,44115,24321,6.90569032639816,3.80716977056171,4654,68436,fhi:git
county,Vestland,2021-03-05,1246,903,45361,25224,7.10073713919862,3.94852392141148,2149,70585,fhi:git
county,Vestland,2021-03-06,1,6,45362,25230,7.10089367757165,3.94946315164968,7,70592,fhi:git
county,Vestland,2021-03-07,5,0,45367,25230,7.10167636943682,3.94946315164968,5,70597,fhi:git
county,Vestland,2021-03-08,635,15,46002,25245,7.20107823631346,3.95181122724519,650,71247,fhi:git
county,Vestland,2021-03-09,1503,528,47505,25773,7.43635541098367,4.03446348820718,2031,73278,fhi:git
county,Vestland,2021-03-10,2507,1852,50012,27625,7.82879711218009,4.32437255506629,4359,77637,fhi:git
county,Vestland,2021-03-11,1406,1549,51418,29174,8.048890064666,4.56685049489607,2955,80592,fhi:git
county,Vestland,2021-03-12,180,976,51598,30150,8.07706697181214,4.71963194697732,1156,81748,fhi:git
county,Vestland,2021-03-13,8,10,51606,30160,8.07831927879641,4.72119733070766,18,81766,fhi:git
county,Vestland,2021-03-14,0,0,51606,30160,8.07831927879641,4.72119733070766,0,81766,fhi:git
county,Vestland,2021-03-15,7,8,51613,30168,8.07941504740765,4.72244963769194,15,81781,fhi:git
county,Vestland,2021-03-16,1200,36,52813,30204,8.26726109504854,4.72808501912116,1236,83017,fhi:git
county,Vestland,2021-03-17,2441,222,55254,30426,8.64937126362471,4.76283653793473,2663,85680,fhi:git
county,Vestland,2021-03-18,2324,145,57578,30571,9.0131664425559,4.78553460202467,2469,88149,fhi:git
county,Vestland,2021-03-19,587,116,58165,30687,9.1050544675269,4.80369305329662,703,88852,fhi:git
county,Vestland,2021-03-20,1,2,58166,30689,9.10521100589993,4.80400613004269,3,88855,fhi:git
county,Vestland,2021-03-21,0,0,58166,30689,9.10521100589993,4.80400613004269,0,88855,fhi:git
county,Vestland,2021-03-22,9,13,58175,30702,9.10661985125724,4.80604112889213,22,88877,fhi:git
county,Vestland,2021-03-23,2055,341,60230,31043,9.42830620784226,4.85942071409675,2396,91273,fhi:git
county,Vestland,2021-03-24,4026,514,64256,31557,10.0585296976774,4.93988143783626,4540,95813,fhi:git
county,Vestland,2021-03-25,3164,375,67420,31932,10.5538171099572,4.99858332772404,3539,99352,fhi:git
county,Vestland,2021-03-26,997,188,68417,32120,10.7098858678722,5.02801254185445,1185,100537,fhi:git
county,Vestland,2021-03-27,2,0,68419,32120,10.7101989446183,5.02801254185445,2,100539,fhi:git
county,Vestland,2021-03-28,0,2,68419,32122,10.7101989446183,5.02832561860052,2,100541,fhi:git
county,Vestland,2021-03-29,115,2,68534,32124,10.7282008575172,5.02863869534658,117,100658,fhi:git
county,Vestland,2021-03-30,3584,572,72118,32696,11.2892343864713,5.11817864472207,4156,104814,fhi:git
county,Vestland,2021-03-31,3688,1160,75806,33856,11.866547906221,5.2997631574416,4848,109662,fhi:git
county,Vestland,2021-04-01,951,232,76757,34088,12.0154158989764,5.3360800599855,1183,110845,fhi:git
county,Vestland,2021-04-02,53,90,76810,34178,12.0237124327472,5.35016851355857,143,110988,fhi:git
county,Vestland,2021-04-03,1,0,76811,34178,12.0238689711202,5.35016851355857,1,110989,fhi:git
county,Vestland,2021-04-04,0,2,76811,34180,12.0238689711202,5.35048159030464,2,110991,fhi:git
county,Vestland,2021-04-05,1,1,76812,34181,12.0240255094933,5.35063812867767,2,110993,fhi:git
county,Vestland,2021-04-06,3096,101,79908,34282,12.5086683124068,5.36644850435412,3197,114190,fhi:git
county,Vestland,2021-04-07,8110,157,88018,34439,13.7781945177131,5.39102502892046,8267,122457,fhi:git
county,Vestland,2021-04-08,6398,304,94416,34743,14.7797270283851,5.43861269432282,6702,129159,fhi:git
county,Vestland,2021-04-09,2028,103,96444,34846,15.0971868488982,5.45473614674533,2131,131290,fhi:git
county,Vestland,2021-04-10,42,2,96486,34848,15.1037614605656,5.4550492234914,44,131334,fhi:git
county,Vestland,2021-04-11,5,0,96491,34848,15.1045441524308,5.4550492234914,5,131339,fhi:git
county,Vestland,2021-04-12,58,10,96549,34858,15.1136233780668,5.45661460722174,68,131407,fhi:git
county,Vestland,2021-04-13,4818,66,101367,34924,15.867825259345,5.46694613984199,4884,136291,fhi:git
county,Vestland,2021-04-14,9038,99,110405,35023,17.2826190748269,5.48244343877236,9137,145428,fhi:git
county,Vestland,2021-04-15,6836,188,117241,35211,18.3527153928878,5.51187265290277,7024,152452,fhi:git
county,Vestland,2021-04-16,1361,140,118602,35351,18.5657641185872,5.53378802512754,1501,153953,fhi:git
county,Vestland,2021-04-17,51,2,118653,35353,18.573747575612,5.53410110187361,53,154006,fhi:git
county,Vestland,2021-04-18,1,0,118654,35353,18.573904113985,5.53410110187361,1,154007,fhi:git
county,Vestland,2021-04-19,40,10,118694,35363,18.5801656489063,5.53566648560395,50,154057,fhi:git
county,Vestland,2021-04-20,5191,68,123885,35431,19.3927563433262,5.54631109497027,5259,159316,fhi:git
county,Vestland,2021-04-21,7794,74,131679,35505,20.6128164227538,5.55789493457479,7868,167184,fhi:git
county,Vestland,2021-04-22,5170,131,136849,35636,21.42211981134,5.57840146144225,5301,172485,fhi:git
county,Vestland,2021-04-23,1206,35,138055,35671,21.610905089219,5.58388030449844,1241,173726,fhi:git
county,Vestland,2021-04-24,1,0,138056,35671,21.6110616275921,5.58388030449844,1,173727,fhi:git
county,Vestland,2021-04-25,7,0,138063,35671,21.6121573962033,5.58388030449844,7,173734,fhi:git
county,Vestland,2021-04-26,26,2,138089,35673,21.6162273939022,5.58419338124451,28,173762,fhi:git
county,Vestland,2021-04-27,2971,1137,141060,36810,22.0813029001864,5.76217751138425,4108,177870,fhi:git
county,Vestland,2021-04-28,6736,2821,147796,39631,23.135745380944,6.20377226171338,9557,187427,fhi:git
county,Vestland,2021-04-29,6404,2254,154200,41885,24.1382171218542,6.55660975453218,8658,196085,fhi:git
county,Vestland,2021-04-30,2101,459,156301,42344,24.4671042435988,6.62846086775482,2560,198645,fhi:git
county,Vestland,2021-05-01,52,5,156353,42349,24.4752442389965,6.62924355961999,57,198702,fhi:git
county,Vestland,2021-05-02,2,0,156355,42349,24.4755573157426,6.62924355961999,2,198704,fhi:git
county,Vestland,2021-05-03,44,5,156399,42354,24.4824450041561,6.63002625148516,49,198753,fhi:git
county,Vestland,2021-05-04,1812,2126,158211,44480,24.7660925360938,6.9628268325556,3938,202691,fhi:git
county,Viken,2020-12-27,0,0,0,0,0.0,0.0,0,0,fhi:git
county,Viken,2020-12-28,65,0,65,0,0.0052370152236004,0.0,65,65,fhi:git
county,Viken,2020-12-29,689,0,754,0,0.0607493765937647,0.0,689,754,fhi:git
county,Viken,2020-12-30,219,0,973,0,0.0783940894240492,0.0,219,973,fhi:git
county,Viken,2020-12-31,67,0,1040,0,0.0837922435776065,0.0,67,1040,fhi:git
county,Viken,2021-01-01,0,0,1040,0,0.0837922435776065,0.0,0,1040,fhi:git
county,Viken,2021-01-02,0,0,1040,0,0.0837922435776065,0.0,0,1040,fhi:git
county,Viken,2021-01-03,0,0,1040,0,0.0837922435776065,0.0,0,1040,fhi:git
county,Viken,2021-01-04,0,0,1040,0,0.0830416230165828,0.0,0,1040,fhi:git
county,Viken,2021-01-05,526,0,1566,0,0.125041520811508,0.0,526,1566,fhi:git
county,Viken,2021-01-06,1650,0,3216,0,0.256790249635894,0.0,1650,3216,fhi:git
county,Viken,2021-01-07,1924,0,5140,0,0.410417252216573,0.0,1924,5140,fhi:git
county,Viken,2021-01-08,282,0,5422,0,0.432934307688377,0.0,282,5422,fhi:git
county,Viken,2021-01-09,6,0,5428,0,0.433413393975011,0.0,6,5428,fhi:git
county,Viken,2021-01-10,5,0,5433,0,0.433812632547206,0.0,5,5433,fhi:git
county,Viken,2021-01-11,60,0,5493,0,0.438603495413547,0.0,60,5493,fhi:git
county,Viken,2021-01-12,788,0,6281,0,0.501523494391497,0.0,788,6281,fhi:git
county,Viken,2021-01-13,1946,0,8227,0,0.656907146689833,0.0,1946,8227,fhi:git
county,Viken,2021-01-14,1950,0,10177,0,0.812610189845926,0.0,1950,10177,fhi:git
county,Viken,2021-01-15,1052,0,11229,0,0.896609985435777,0.0,1052,11229,fhi:git
county,Viken,2021-01-16,93,0,11322,0,0.904035822878606,0.0,93,11322,fhi:git
county,Viken,2021-01-17,23,0,11345,0,0.905872320310703,0.0,23,11345,fhi:git
county,Viken,2021-01-18,145,51,11490,51,0.917450238904362,0.0040722334363901,196,11541,fhi:git
county,Viken,2021-01-19,652,384,12142,435,0.969510948718604,0.0347337557809745,1036,12577,fhi:git
county,Viken,2021-01-20,1493,342,13635,777,1.08872358637606,0.06204167411912,1835,14412,fhi:git
county,Viken,2021-01-21,1997,100,15632,877,1.24817947211079,0.0700264455630222,2097,16509,fhi:git
county,Viken,2021-01-22,821,1,16453,878,1.31373444566523,0.0701062932774612,822,17331,fhi:git
county,Viken,2021-01-23,99,0,16552,878,1.32163936939469,0.0701062932774612,99,17430,fhi:git
county,Viken,2021-01-24,0,0,16552,878,1.32163936939469,0.0701062932774612,0,17430,fhi:git
county,Viken,2021-01-25,62,0,16614,878,1.32658992768991,0.0701062932774612,62,17492,fhi:git
county,Viken,2021-01-26,564,402,17178,1280,1.37162403863352,0.102205074481948,966,18458,fhi:git
county,Viken,2021-01-27,1950,1219,19128,2499,1.52732708178961,0.199539438383116,3169,21627,fhi:git
county,Viken,2021-01-28,3107,1712,22235,4211,1.77541393055165,0.336238725502721,4819,26446,fhi:git
county,Viken,2021-01-29,1041,427,23276,4638,1.85853540128267,0.370333699568184,1468,27914,fhi:git
county,Viken,2021-01-30,12,18,23288,4656,1.85949357385594,0.371770958428086,30,27944,fhi:git
county,Viken,2021-01-31,10,3,23298,4659,1.86029205100033,0.372010501571403,13,27957,fhi:git
county,Viken,2021-02-01,38,47,23336,4706,1.86332626414902,0.375763344150037,85,28042,fhi:git
county,Viken,2021-02-02,1025,688,24361,5394,1.94517017144901,0.430698571684084,1713,29755,fhi:git
county,Viken,2021-02-03,4780,1724,29141,7118,2.32684224646754,0.568356031376958,6504,36259,fhi:git
county,Viken,2021-02-04,6646,1753,35787,8871,2.85751015662928,0.708329074788563,8399,44658,fhi:git
county,Viken,2021-02-05,3148,1102,38935,9973,3.10887076168332,0.796321256100366,4250,48908,fhi:git
county,Viken,2021-02-06,41,92,38976,10065,3.11214451797532,0.803667245828755,133,49041,fhi:git
county,Viken,2021-02-07,16,20,38992,10085,3.11342208140634,0.805264200117536,36,49077,fhi:git
county,Viken,2021-02-08,14,96,39006,10181,3.11453994940849,0.812929580703682,110,49187,fhi:git
county,Viken,2021-02-09,799,569,39805,10750,3.17833827324527,0.858362930219485,1368,50555,fhi:git
county,Viken,2021-02-10,3452,1326,43257,12076,3.45397258348877,0.964240999565629,4778,55333,fhi:git
county,Viken,2021-02-11,4851,1916,48108,13992,3.84131384623247,1.11722922043079,6767,62100,fhi:git
county,Viken,2021-02-12,2427,980,50535,14972,4.03510424917597,1.19547998058104,3407,65507,fhi:git
county,Viken,2021-02-13,26,99,50561,15071,4.03718028975139,1.2033849043105,125,65632,fhi:git
county,Viken,2021-02-14,7,1,50568,15072,4.03773922375246,1.20346475202494,8,65640,fhi:git
county,Viken,2021-02-15,366,125,50934,15197,4.06696348723714,1.21344571632982,491,66131,fhi:git
county,Viken,2021-02-16,1430,359,52364,15556,4.18114571888494,1.24211104581342,1789,67920,fhi:git
county,Viken,2021-02-17,4426,1822,56790,17378,4.53455170299205,1.38759358152132,6248,74168,fhi:git
county,Viken,2021-02-18,4898,2932,61688,20310,4.92564580831438,1.62170708025653,7830,81998,fhi:git
county,Viken,2021-02-19,3801,1282,65489,21592,5.22914697089711,1.72407185016736,5083,87081,fhi:git
county,Viken,2021-02-20,30,11,65519,21603,5.23154240233028,1.72495017502619,41,87122,fhi:git
county,Viken,2021-02-21,1,9,65520,21612,5.23162225004471,1.72566880445614,10,87132,fhi:git
county,Viken,2021-02-22,706,10,66226,21622,5.28799473643866,1.72646728160053,716,87848,fhi:git
county,Viken,2021-02-23,2132,759,68358,22381,5.45823006362266,1.78707169685975,2891,90739,fhi:git
county,Viken,2021-02-24,2546,4218,70904,26599,5.66152234458441,2.12386935636354,6764,97503,fhi:git
county,Viken,2021-02-25,2546,6275,73450,32874,5.86481462554616,2.62491376446841,8821,106324,fhi:git
county,Viken,2021-02-26,1942,2723,75392,35597,6.01987888698674,2.84233909088586,4665,110989,fhi:git
county,Viken,2021-02-27,166,90,75558,35687,6.03313360758362,2.84952538518537,256,111245,fhi:git
county,Viken,2021-02-28,416,1,75974,35688,6.06635025679025,2.84960523289981,417,111662,fhi:git
county,Viken,2021-03-01,1523,2,77497,35690,6.18795832588088,2.84976492832869,1525,113187,fhi:git
county,Viken,2021-03-02,3023,521,80520,36211,6.42933796663004,2.89136558755142,3544,116731,fhi:git
county,Viken,2021-03-03,4965,2703,85485,38914,6.82578186881979,3.1071939596801,7668,124399,fhi:git
county,Viken,2021-03-04,4396,3262,89881,42176,7.17679242149373,3.36765720418019,7658,132057,fhi:git
county,Viken,2021-03-05,2728,1782,92609,43958,7.39461698648338,3.50994583131052,4510,136567,fhi:git
county,Viken,2021-03-06,215,3,92824,43961,7.41178424508777,3.51018537445384,218,136785,fhi:git
county,Viken,2021-03-07,17,0,92841,43961,7.41314165623323,3.51018537445384,17,136802,fhi:git
county,Viken,2021-03-08,1136,22,93977,43983,7.50384865983596,3.5119420241715,1158,137960,fhi:git
county,Viken,2021-03-09,2898,718,96875,44701,7.73524733628025,3.56927268313872,3616,141576,fhi:git
county,Viken,2021-03-10,5404,3214,102279,47915,8.16674438510872,3.82590323734573,8618,150194,fhi:git
county,Viken,2021-03-11,3430,4773,105709,52688,8.44062204563457,4.20701637836319,8203,158397,fhi:git
county,Viken,2021-03-12,1226,3313,106935,56001,8.53851534353681,4.47155185629967,4539,162936,fhi:git
county,Viken,2021-03-13,17,8,106952,56009,8.53987275468227,4.47219063801518,25,162961,fhi:git
county,Viken,2021-03-14,2,6,106954,56015,8.54003245011115,4.47266972430181,8,162969,fhi:git
county,Viken,2021-03-15,36,48,106990,56063,8.54290696783095,4.47650241459488,84,163053,fhi:git
county,Viken,2021-03-16,784,346,107774,56409,8.60550757595115,4.50412972379079,1130,164183,fhi:git
county,Viken,2021-03-17,3998,507,111772,56916,8.92473873827836,4.54461251501137,4505,168688,fhi:git
county,Viken,2021-03-18,5954,481,117726,57397,9.40015203004829,4.58301926565654,6435,175123,fhi:git
county,Viken,2021-03-19,2049,406,119775,57803,9.56375999693385,4.61543743771878,2455,177578,fhi:git
county,Viken,2021-03-20,6,2,119781,57805,9.56423908322048,4.61559713314766,8,177586,fhi:git
county,Viken,2021-03-21,6,1,119787,57806,9.56471816950712,4.6156769808621,7,177593,fhi:git
county,Viken,2021-03-22,407,25,120194,57831,9.5972161892838,4.61767317372308,432,178025,fhi:git
county,Viken,2021-03-23,2492,81,122686,57912,9.79619669366584,4.62414083859264,2573,180598,fhi:git
county,Viken,2021-03-24,7390,750,130076,58662,10.3862713033702,4.6840266244219,8140,188738,fhi:git
county,Viken,2021-03-25,10228,628,140304,59290,11.2029537266525,4.73417098908961,10856,199594,fhi:git
county,Viken,2021-03-26,5928,317,146232,59607,11.6762909778471,4.75948271456678,6245,205839,fhi:git
county,Viken,2021-03-27,32,1,146264,59608,11.6788461047091,4.75956256228122,33,205872,fhi:git
county,Viken,2021-03-28,5,0,146269,59608,11.6792453432813,4.75956256228122,5,205877,fhi:git
county,Viken,2021-03-29,1335,4,147604,59612,11.7858420420574,4.75988195313897,1339,207216,fhi:git
county,Viken,2021-03-30,6122,1611,153726,61223,12.2746697498531,4.88851662110024,7733,214949,fhi:git
county,Viken,2021-03-31,9926,1841,163652,63064,13.0672381633748,5.03551626338248,11767,226716,fhi:git
county,Viken,2021-04-01,3681,478,167333,63542,13.3611576002249,5.07368347088433,4159,230875,fhi:git
county,Viken,2021-04-02,2261,270,169594,63812,13.5416932825715,5.09524235378287,2531,233406,fhi:git
county,Viken,2021-04-03,4,0,169598,63812,13.5420126734292,5.09524235378287,4,233410,fhi:git
county,Viken,2021-04-04,15,0,169613,63812,13.5432103891458,5.09524235378287,15,233425,fhi:git
county,Viken,2021-04-05,53,2,169666,63814,13.5474423180111,5.09540204921174,55,233480,fhi:git
county,Viken,2021-04-06,3407,2133,173073,65947,13.8194834811048,5.26571722411018,5540,239020,fhi:git
county,Viken,2021-04-07,11150,2524,184223,68471,14.7097854970999,5.46725285535427,13674,252694,fhi:git
county,Viken,2021-04-08,14962,1992,199185,70463,15.9044670005366,5.6263095025168,16954,269648,fhi:git
county,Viken,2021-04-09,8524,267,207709,70730,16.5850889184148,5.64762884227202,8791,278439,fhi:git
county,Viken,2021-04-10,244,42,207953,70772,16.6045717607379,5.65098244627846,286,278725,fhi:git
county,Viken,2021-04-11,13,0,207966,70772,16.6056097810256,5.65098244627846,13,278738,fhi:git
county,Viken,2021-04-12,1443,8,209409,70780,16.7208300329611,5.65162122799397,1451,280189,fhi:git
county,Viken,2021-04-13,7663,174,217072,70954,17.3327030687074,5.66551473030636,7837,288026,fhi:git
county,Viken,2021-04-14,14100,788,231172,71742,18.4585558422976,5.72843472928431,14888,302914,fhi:git
county,Viken,2021-04-15,18038,209,249210,71951,19.8988489153486,5.74512290160206,18247,321161,fhi:git
county,Viken,2021-04-16,9752,279,258962,72230,20.677523826558,5.76740041393055,10031,331192,fhi:git
county,Viken,2021-04-17,288,2,259250,72232,20.7005199683164,5.76756010935943,290,331482,fhi:git
county,Viken,2021-04-18,54,2,259304,72234,20.7048317448961,5.76771980478831,56,331538,fhi:git
county,Viken,2021-04-19,1804,4,261108,72238,20.8488770217441,5.76803919564606,1808,333346,fhi:git
county,Viken,2021-04-20,2994,115,264102,72353,21.0879410787746,5.77722168280655,3109,336455,fhi:git
county,Viken,2021-04-21,12787,509,276889,72862,22.1089538033063,5.81786416945601,13296,349751,fhi:git
county,Viken,2021-04-22,10866,530,287755,73392,22.9765790684007,5.8601834581087,11396,361147,fhi:git
county,Viken,2021-04-23,4389,332,292144,73724,23.3270306870736,5.88669289930245,4721,365868,fhi:git
county,Viken,2021-04-24,14,3,292158,73727,23.3281485550758,5.88693244244577,17,365885,fhi:git
county,Viken,2021-04-25,2,1,292160,73728,23.3283082505046,5.88701229016021,3,365888,fhi:git
county,Viken,2021-04-26,164,36,292324,73764,23.3414032756726,5.88988680788001,200,366088,fhi:git
county,Viken,2021-04-27,4438,714,296762,74478,23.695767432353,5.94689807598947,5152,371240,fhi:git
county,Viken,2021-04-28,14804,4453,311566,78931,24.8778329969083,6.30245994838644,19257,390497,fhi:git
county,Viken,2021-04-29,11688,5764,323254,84695,25.8110930832716,6.76270217441296,17452,407949,fhi:git
county,Viken,2021-04-30,7039,2481,330293,87176,26.3731411452079,6.96080435393617,9520,417469,fhi:git
county,Viken,2021-05-01,340,10,330633,87186,26.4002893681171,6.96160283108056,350,417819,fhi:git
county,Viken,2021-05-02,130,11,330763,87197,26.4106695709942,6.96248115593939,141,417960,fhi:git
county,Viken,2021-05-03,351,433,331114,87630,26.4386961187623,6.99705521629149,784,418744,fhi:git
county,Viken,2021-05-04,1936,1937,333050,89567,26.5932812939162,7.15172023915987,3873,422617,fhi:git
nation,Norge,2020-12-27,5,0,5,0,9.31518486915891e-05,0.0,5,5,fhi:git
nation,Norge,2020-12-28,604,0,609,0,0.0113458951706356,0.0,604,609,fhi:git
nation,Norge,2020-12-29,1067,0,1676,0,0.0312244996814207,0.0,1067,1676,fhi:git
nation,Norge,2020-12-30,427,0,2103,0,0.0391796675596824,0.0,427,2103,fhi:git
nation,Norge,2020-12-31,73,0,2176,0,0.0405396845505796,0.0,73,2176,fhi:git
nation,Norge,2021-01-01,6,0,2182,0,0.0406514667690095,0.0,6,2182,fhi:git
nation,Norge,2021-01-02,0,0,2182,0,0.0406514667690095,0.0,0,2182,fhi:git
nation,Norge,2021-01-03,4,0,2186,0,0.0407259882479628,0.0,4,2186,fhi:git
nation,Norge,2021-01-04,6,0,2192,0,0.0406575769530893,0.0,6,2192,fhi:git
nation,Norge,2021-01-05,3387,0,5579,0,0.103480210684893,0.0,3387,5579,fhi:git
nation,Norge,2021-01-06,9069,0,14648,0,0.271693516062432,0.0,9069,14648,fhi:git
nation,Norge,2021-01-07,6557,0,21205,0,0.393313831793001,0.0,6557,21205,fhi:git
nation,Norge,2021-01-08,1616,0,22821,0,0.423287665897103,0.0,1616,22821,fhi:git
nation,Norge,2021-01-09,137,0,22958,0,0.425828764456671,0.0,137,22958,fhi:git
nation,Norge,2021-01-10,108,0,23066,0,0.427831966240856,0.0,108,23066,fhi:git
nation,Norge,2021-01-11,359,0,23425,0,0.434490757356805,0.0,359,23425,fhi:git
nation,Norge,2021-01-12,4265,0,27690,0,0.513598679667446,0.0,4265,27690,fhi:git
nation,Norge,2021-01-13,9795,0,37485,0,0.69527795259423,0.0,9795,37485,fhi:git
nation,Norge,2021-01-14,8478,0,45963,0,0.852529292652757,0.0,8478,45963,fhi:git
nation,Norge,2021-01-15,4486,0,50449,0,0.93573635935511,0.0,4486,50449,fhi:git
nation,Norge,2021-01-16,749,0,51198,0,0.949628934691727,0.0,749,51198,fhi:git
nation,Norge,2021-01-17,354,5,51552,5,0.956194984984333,9.27408233419007e-05,359,51557,fhi:git
nation,Norge,2021-01-18,1289,283,52841,288,0.980103569241875,0.0053418714244934,1572,53129,fhi:git
nation,Norge,2021-01-19,4592,772,57433,1060,1.06527674139908,0.019661054548483,5364,58493,fhi:git
nation,Norge,2021-01-20,10069,693,67502,1753,1.252038211445,0.0325149326636704,10762,69255,fhi:git
nation,Norge,2021-01-21,8449,169,75951,1922,1.40875165472814,0.0356495724926266,8618,77873,fhi:git
nation,Norge,2021-01-22,3320,7,79271,1929,1.47033156142716,0.0357794096453053,3327,81200,fhi:git
nation,Norge,2021-01-23,360,0,79631,1929,1.47700890070778,0.0357794096453053,360,81560,fhi:git
nation,Norge,2021-01-24,68,0,79699,1929,1.47827017590523,0.0357794096453053,68,81628,fhi:git
nation,Norge,2021-01-25,581,0,80280,1929,1.48904665957756,0.0357794096453053,581,82209,fhi:git
nation,Norge,2021-01-26,2280,2150,82560,4079,1.53133647502146,0.0756579636823226,4430,86639,fhi:git
nation,Norge,2021-01-27,11492,7598,94052,11677,1.74449198339049,0.216586918832675,19090,105729,fhi:git
nation,Norge,2021-01-28,10910,6583,104962,18260,1.94685245992252,0.338689486844622,17493,123222,fhi:git
nation,Norge,2021-01-29,3816,2108,108778,20368,2.01763225629706,0.377789017965567,5924,129146,fhi:git
nation,Norge,2021-01-30,150,174,108928,20542,2.02041448099731,0.381016398617865,324,129470,fhi:git
nation,Norge,2021-01-31,109,52,109037,20594,2.02243623094617,0.381980903180621,161,129631,fhi:git
nation,Norge,2021-02-01,201,304,109238,20898,2.02616441204451,0.387619545239808,505,130136,fhi:git
nation,Norge,2021-02-02,6356,3147,115594,24045,2.14405654667673,0.445990619451201,9503,139639,fhi:git
nation,Norge,2021-02-03,25168,8384,140762,32429,2.61087675505053,0.6014984320309,33552,173191,fhi:git
nation,Norge,2021-02-04,25993,8703,166755,41132,3.09299919927573,0.762923109139812,34696,207887,fhi:git
nation,Norge,2021-02-05,10629,4880,177384,46012,3.29014764153594,0.853438152721507,15509,223396,fhi:git
nation,Norge,2021-02-06,813,739,178197,46751,3.30522729941134,0.86714524641144,1552,224948,fhi:git
nation,Norge,2021-02-07,320,301,178517,47052,3.31116271210522,0.872728243976623,621,225569,fhi:git
nation,Norge,2021-02-08,119,923,178636,47975,3.31336994370076,0.889848199965538,1042,226611,fhi:git
nation,Norge,2021-02-09,5563,3246,184199,51221,3.41655338375095,0.9500555424791,8809,235420,fhi:git
nation,Norge,2021-02-10,23025,8675,207224,59896,3.84362487524041,1.1109608709773,31700,267120,fhi:git
nation,Norge,2021-02-11,20962,8594,228186,68490,4.23243150301899,1.27036379813736,29556,296676,fhi:git
nation,Norge,2021-02-12,8053,3618,236239,72108,4.38179987309346,1.33747105790756,11671,308347,fhi:git
nation,Norge,2021-02-13,898,308,237137,72416,4.39845612496566,1.34318389262542,1206,309553,fhi:git
nation,Norge,2021-02-14,110,5,237247,72421,4.40049642307918,1.34327663344876,115,309668,fhi:git
nation,Norge,2021-02-15,830,754,238077,73175,4.41589139975394,1.35726194960872,1584,311252,fhi:git
nation,Norge,2021-02-16,6118,2180,244195,75355,4.52936907119509,1.39769694858579,8298,319550,fhi:git
nation,Norge,2021-02-17,21805,10290,266000,85645,4.93381180178912,1.58855756302342,32095,351645,fhi:git
nation,Norge,2021-02-18,18914,10849,284914,96494,5.28463178832686,1.78978660151067,29763,381408,fhi:git
nation,Norge,2021-02-19,10741,4810,295655,101304,5.48385762502993,1.87900327356558,15551,396959,fhi:git
nation,Norge,2021-02-20,503,178,296158,101482,5.49318735185813,1.88230484687655,681,397640,fhi:git
nation,Norge,2021-02-21,59,108,296217,101590,5.49428169357356,1.88430804866074,167,397807,fhi:git
nation,Norge,2021-02-22,2578,144,298795,101734,5.54209886208865,1.88697898437299,2722,400529,fhi:git
nation,Norge,2021-02-23,5756,5213,304551,106947,5.64886209791984,1.98367056678925,10969,411498,fhi:git
nation,Norge,2021-02-24,11161,22375,315712,129322,5.85587816378363,2.39868575124426,33536,445034,fhi:git
nation,Norge,2021-02-25,11172,25174,326884,154496,6.06309825945878,2.86561724860606,36346,481380,fhi:git
nation,Norge,2021-02-26,8388,9950,335272,164446,6.21868026469715,3.05017148705644,18338,499718,fhi:git
nation,Norge,2021-02-27,445,206,335717,164652,6.22693419797458,3.05399240897813,651,500369,fhi:git
nation,Norge,2021-02-28,540,160,336257,164812,6.2369502068955,3.05696011532507,700,501069,fhi:git
nation,Norge,2021-03-01,5953,63,342210,164875,6.34736743116637,3.05812864969918,6016,507085,fhi:git
nation,Norge,2021-03-02,10543,3837,352753,168712,6.5429207312651,3.12929795753175,14380,521465,fhi:git
nation,Norge,2021-03-03,17698,18117,370451,186829,6.87118614956609,3.46533505682879,35815,557280,fhi:git
nation,Norge,2021-03-04,16281,18519,386732,205348,7.17316881853199,3.80882851832253,34800,592080,fhi:git
nation,Norge,2021-03-05,11949,6548,398681,211896,7.39480083815447,3.93028190057108,18497,610577,fhi:git
nation,Norge,2021-03-06,401,482,399082,212378,7.40223865218649,3.93922211594124,883,611460,fhi:git
nation,Norge,2021-03-07,97,2,399179,212380,7.40403782415932,3.93925921227058,99,611559,fhi:git
nation,Norge,2021-03-08,4949,48,404128,212428,7.49583269110313,3.94014952417466,4997,616556,fhi:git
nation,Norge,2021-03-09,12485,4276,416613,216704,7.72740652698786,4.01946147629665,16761,633317,fhi:git
nation,Norge,2021-03-10,21140,17284,437753,233988,8.11951472807741,4.34004795442493,38424,671741,fhi:git
nation,Norge,2021-03-11,12047,16637,449800,250625,8.34296446783739,4.64863377001278,28684,700425,fhi:git
nation,Norge,2021-03-12,2333,8336,452133,258961,8.38623733600872,4.80325127068839,10669,711094,fhi:git
nation,Norge,2021-03-13,48,305,452181,259266,8.3871276479128,4.80890846091225,353,711447,fhi:git
nation,Norge,2021-03-14,7,109,452188,259375,8.38725748506548,4.8109302108611,116,711563,fhi:git
nation,Norge,2021-03-15,101,439,452289,259814,8.38913084969699,4.81907285515052,540,712103,fhi:git
nation,Norge,2021-03-16,5679,694,457968,260508,8.49446587684872,4.83194528143038,6373,718476,fhi:git
nation,Norge,2021-03-17,23110,1683,481078,262191,8.92311396233498,4.86316184256726,24793,743269,fhi:git
nation,Norge,2021-03-18,21071,1471,502149,263662,9.31394234006242,4.89044619279445,22542,765811,fhi:git
nation,Norge,2021-03-19,6816,1016,508965,264678,9.4403666304421,4.90929112809752,7832,773643,fhi:git
nation,Norge,2021-03-20,460,22,509425,264700,9.44889878618956,4.90969918772023,482,774125,fhi:git
nation,Norge,2021-03-21,188,70,509613,264770,9.45238584114721,4.91099755924701,258,774383,fhi:git
nation,Norge,2021-03-22,1516,86,511129,264856,9.48050485878448,4.91259270140849,1602,775985,fhi:git
nation,Norge,2021-03-23,13144,955,524273,265811,9.72430193518566,4.9303061986668,14099,790084,fhi:git
nation,Norge,2021-03-24,39144,3691,563417,269502,10.4503512929647,4.99876747445779,42835,832919,fhi:git
nation,Norge,2021-03-25,38776,2353,602193,271855,11.1695749261458,5.04241130592249,41129,874048,fhi:git
nation,Norge,2021-03-26,17404,1159,619597,273014,11.4923871840343,5.06390862877314,18563,892611,fhi:git
nation,Norge,2021-03-27,715,6,620312,273020,11.5056491217722,5.06401991776115,721,893332,fhi:git
nation,Norge,2021-03-28,330,5,620642,273025,11.5117700161128,5.06411265858449,335,893667,fhi:git
nation,Norge,2021-03-29,4763,27,625405,273052,11.6001149244283,5.06461345903054,4790,898457,fhi:git
nation,Norge,2021-03-30,32257,4043,657662,277095,12.1984230721362,5.1396036887848,36300,934757,fhi:git
nation,Norge,2021-03-31,36770,7097,694432,284192,12.8804390869926,5.27124001343629,43867,978624,fhi:git
nation,Norge,2021-04-01,9425,1478,703857,285670,13.055255538992,5.29865420081616,10903,989527,fhi:git
nation,Norge,2021-04-02,4312,699,708169,286369,13.1352352250421,5.31161936791935,5011,994538,fhi:git
nation,Norge,2021-04-03,268,8,708437,286377,13.1402061331732,5.3117677532367,276,994814,fhi:git
nation,Norge,2021-04-04,391,43,708828,286420,13.1474584655586,5.31256532431744,434,995248,fhi:git
nation,Norge,2021-04-05,1323,64,710151,286484,13.1719976874148,5.31375240685622,1387,996635,fhi:git
nation,Norge,2021-04-06,18654,2613,728805,289097,13.5179951511388,5.3622187611347,21267,1017902,fhi:git
nation,Norge,2021-04-07,58510,3680,787315,292777,14.6032482658857,5.43047600711434,62190,1080092,fhi:git
nation,Norge,2021-04-08,57317,4152,844632,296929,15.6663734201833,5.50748798681745,61469,1141561,fhi:git
nation,Norge,2021-04-09,27375,651,872007,297580,16.1741294279802,5.51956284201657,28026,1169587,fhi:git
nation,Norge,2021-04-10,1047,47,873054,297627,16.193549356388,5.52043460575598,1094,1170681,fhi:git
nation,Norge,2021-04-11,554,8,873608,297635,16.2038250396142,5.52058299107333,562,1171243,fhi:git
nation,Norge,2021-04-12,3659,85,877267,297720,16.2716927741358,5.52215958507014,3744,1174987,fhi:git
nation,Norge,2021-04-13,25514,394,902781,298114,16.7449306474849,5.52946756194948,25908,1200895,fhi:git
nation,Norge,2021-04-14,66910,1450,969691,299564,17.9859883454462,5.55636240071863,68360,1269255,fhi:git
nation,Norge,2021-04-15,65093,1235,1034784,300799,19.1933440282051,5.57926938408408,66328,1335583,fhi:git
nation,Norge,2021-04-16,28898,838,1063682,301637,19.7293488907919,5.59481274607618,29736,1365319,fhi:git
nation,Norge,2021-04-17,1967,160,1065649,301797,19.7658331306946,5.59778045242312,2127,1367446,fhi:git
nation,Norge,2021-04-18,1280,13,1066929,301810,19.7895747814702,5.59802157856381,1293,1368739,fhi:git
nation,Norge,2021-04-19,6358,144,1073287,301954,19.9075040124317,5.60069251427606,6502,1375241,fhi:git
nation,Norge,2021-04-20,19460,774,1092747,302728,20.2684512968784,5.61504879372938,20234,1395475,fhi:git
nation,Norge,2021-04-21,58637,2813,1151384,305541,21.3560600285382,5.66722478094154,61450,1456925,fhi:git
nation,Norge,2021-04-22,50669,2281,1202053,307822,22.2958769841204,5.70953314455011,52950,1509875,fhi:git
nation,Norge,2021-04-23,18145,1330,1220198,309152,22.6324334320281,5.73420220355906,19475,1529350,fhi:git
nation,Norge,2021-04-24,315,30,1220513,309182,22.6382761038987,5.73475864849911,345,1529695,fhi:git
nation,Norge,2021-04-25,283,4,1220796,309186,22.6435252344998,5.73483284115778,287,1529982,fhi:git
nation,Norge,2021-04-26,2261,472,1223057,309658,22.685462634815,5.74358757488126,2733,1532715,fhi:git
nation,Norge,2021-04-27,18971,5849,1242028,315507,23.0373398667389,5.85207579002662,24820,1557535,fhi:git
nation,Norge,2021-04-28,57651,24136,1299679,339643,24.1066601080356,6.29975429246264,81787,1639322,fhi:git
nation,Norge,2021-04-29,51760,20326,1351439,359969,25.066713111271,6.67676428751213,72086,1711408,fhi:git
nation,Norge,2021-04-30,23976,7986,1375415,367955,25.5114239073601,6.82488993055382,31962,1743370,fhi:git
nation,Norge,2021-05-01,1418,287,1376833,368242,25.5377252048598,6.83021325381364,1705,1745075,fhi:git
nation,Norge,2021-05-02,967,264,1377800,368506,25.5556612800942,6.8351099692861,1231,1746306,fhi:git
nation,Norge,2021-05-03,3024,1394,1380824,369900,25.6117509300513,6.86096611083382,4418,1750724,fhi:git
nation,Norge,2021-05-04,9189,11078,1390013,380978,25.7821900151891,7.06644267903013,20267,1770991,fhi:git
