granularity_geo,location_name,date,new_dose_1,new_dose_2,total_dose_1,total_dose_2,total_pr100_dose_1,total_pr100_dose_2,new_doses,total_doses,source
county,Agder,2020-12-27,0,0,0,0,0.0,0.0,0,0,fhi:git
county,Agder,2020-12-28,0,0,0,0,0.0,0.0,0,0,fhi:git
county,Agder,2020-12-29,0,0,0,0,0.0,0.0,0,0,fhi:git
county,Agder,2020-12-30,0,0,0,0,0.0,0.0,0,0,fhi:git
county,Agder,2020-12-31,0,0,0,0,0.0,0.0,0,0,fhi:git
county,Agder,2021-01-01,0,0,0,0,0.0,0.0,0,0,fhi:git
county,Agder,2021-01-02,0,0,0,0,0.0,0.0,0,0,fhi:git
county,Agder,2021-01-03,3,0,3,0,0.0009764639635974,0.0,3,3,fhi:git
county,Agder,2021-01-04,0,0,3,0,0.0009713673290312,0.0,0,3,fhi:git
county,Agder,2021-01-05,79,0,82,0,0.026550706993521,0.0,79,82,fhi:git
county,Agder,2021-01-06,794,0,876,0,0.283639260077127,0.0,794,876,fhi:git
county,Agder,2021-01-07,230,0,1106,0,0.358110755302856,0.0,230,1106,fhi:git
county,Agder,2021-01-08,49,0,1155,0,0.373976421677033,0.0,49,1155,fhi:git
county,Agder,2021-01-09,0,0,1155,0,0.373976421677033,0.0,0,1155,fhi:git
county,Agder,2021-01-10,0,0,1155,0,0.373976421677033,0.0,0,1155,fhi:git
county,Agder,2021-01-11,1,0,1156,0,0.37430021078671,0.0,1,1156,fhi:git
county,Agder,2021-01-12,226,0,1382,0,0.447476549573732,0.0,226,1382,fhi:git
county,Agder,2021-01-13,862,0,2244,0,0.726582762115379,0.0,862,2244,fhi:git
county,Agder,2021-01-14,517,0,2761,0,0.893981731818432,0.0,517,2761,fhi:git
county,Agder,2021-01-15,119,0,2880,0,0.932512635870005,0.0,119,2880,fhi:git
county,Agder,2021-01-16,1,0,2881,0,0.932836424979682,0.0,1,2881,fhi:git
county,Agder,2021-01-17,2,0,2883,0,0.933484003199036,0.0,2,2883,fhi:git
county,Agder,2021-01-18,15,0,2898,0,0.938340839844193,0.0,15,2898,fhi:git
county,Agder,2021-01-19,346,0,3244,0,1.05037187179246,0.0,346,3244,fhi:git
county,Agder,2021-01-20,460,0,3704,0,1.19931486224392,0.0,460,3704,fhi:git
county,Agder,2021-01-21,340,0,4044,0,1.30940315953413,0.0,340,4044,fhi:git
county,Agder,2021-01-22,67,0,4111,0,1.3310970298825,0.0,67,4111,fhi:git
county,Agder,2021-01-23,2,0,4113,0,1.33174460810185,0.0,2,4113,fhi:git
county,Agder,2021-01-24,0,0,4113,0,1.33174460810185,0.0,0,4113,fhi:git
county,Agder,2021-01-25,3,0,4116,0,1.33271597543088,0.0,3,4116,fhi:git
county,Agder,2021-01-26,63,66,4179,66,1.35311468934054,0.0213700812386876,129,4245,fhi:git
county,Agder,2021-01-27,567,681,4746,747,1.53670311452745,0.241870464928783,1248,5493,fhi:git
county,Agder,2021-01-28,955,251,5701,998,1.84592171426906,0.323141531457731,1206,6699,fhi:git
county,Agder,2021-01-29,204,61,5905,1059,1.91197469264319,0.342892667148033,265,6964,fhi:git
county,Agder,2021-01-30,32,0,5937,1059,1.92233594415285,0.342892667148033,32,6996,fhi:git
county,Agder,2021-01-31,26,0,5963,1059,1.93075446100446,0.342892667148033,26,7022,fhi:git
county,Agder,2021-02-01,1,2,5964,1061,1.93107825011414,0.343540245367387,3,7025,fhi:git
county,Agder,2021-02-02,203,170,6167,1231,1.99680743937858,0.398584394012492,373,7398,fhi:git
county,Agder,2021-02-03,1333,603,7500,1834,2.42841832257814,0.593829227147774,1936,9334,fhi:git
county,Agder,2021-02-04,1709,506,9209,2340,2.98177391101628,0.757666516644379,2215,11549,fhi:git
county,Agder,2021-02-05,621,135,9830,2475,3.18284694812575,0.801378046450786,756,12305,fhi:git
county,Agder,2021-02-06,512,2,10342,2477,3.34862697228041,0.80202562467014,514,12819,fhi:git
county,Agder,2021-02-07,87,2,10429,2479,3.37679662482232,0.802673202889494,89,12908,fhi:git
county,Agder,2021-02-08,13,2,10442,2481,3.38100588324812,0.803320781108848,15,12923,fhi:git
county,Agder,2021-02-09,189,254,10631,2735,3.44220202497709,0.885563214966828,443,13366,fhi:git
county,Agder,2021-02-10,1153,371,11784,3106,3.81553086843477,1.00568897465703,1524,14890,fhi:git
county,Agder,2021-02-11,1008,414,12792,3520,4.14191029098927,1.13973766606334,1422,16312,fhi:git
county,Agder,2021-02-12,358,69,13150,3589,4.25782679225367,1.16207911463106,427,16739,fhi:git
county,Agder,2021-02-13,510,3,13660,3592,4.42295923818898,1.16305048196009,513,17252,fhi:git
county,Agder,2021-02-14,0,0,13660,3592,4.42295923818898,1.16305048196009,0,17252,fhi:git
county,Agder,2021-02-15,1,1,13661,3593,4.42328302729866,1.16337427106977,2,17254,fhi:git
county,Agder,2021-02-16,141,117,13802,3710,4.46893729176313,1.20125759690199,258,17512,fhi:git
county,Agder,2021-02-17,1222,435,15024,4145,4.86460758378853,1.34210585961152,1657,19169,fhi:git
county,Agder,2021-02-18,1083,829,16107,4974,5.21527118956881,1.61052703153382,1912,21081,fhi:git
county,Agder,2021-02-19,721,343,16828,5317,5.44872313764599,1.72158669615306,1064,22145,fhi:git
county,Agder,2021-02-20,355,37,17183,5354,5.56366827158135,1.73356689321111,392,22537,fhi:git
county,Agder,2021-02-21,52,25,17235,5379,5.58050530528456,1.74166162095304,77,22614,fhi:git
county,Agder,2021-02-22,223,1,17458,5380,5.65271027674255,1.74198541006272,224,22838,fhi:git
county,Agder,2021-02-23,294,201,17752,5581,5.74790427498762,1.80706702110781,495,23333,fhi:git
county,Agder,2021-02-24,977,1111,18729,6692,6.06424623514213,2.16679672195905,2088,25421,fhi:git
county,Agder,2021-02-25,718,1568,19447,8260,6.29672681589027,2.67449804593272,2286,27707,fhi:git
county,Agder,2021-02-26,399,466,19846,8726,6.42591867065143,2.82538377104224,865,28572,fhi:git
county,Agder,2021-02-27,0,1,19846,8727,6.42591867065143,2.82570756015192,1,28573,fhi:git
county,Agder,2021-02-28,10,82,19856,8809,6.4291565617482,2.85225826714544,92,28665,fhi:git
county,Agder,2021-03-01,263,0,20119,8809,6.51431309759328,2.85225826714544,263,28928,fhi:git
county,Agder,2021-03-02,578,192,20697,9001,6.70146320298663,2.91442577620344,770,29698,fhi:git
county,Agder,2021-03-03,634,879,21331,9880,6.9067454985219,3.1990364036096,1513,31211,fhi:git
county,Agder,2021-03-04,795,1070,22126,10950,7.16415784071519,3.54549075096408,1865,33076,fhi:git
county,Agder,2021-03-05,961,383,23087,11333,7.47531917511486,3.66950197997041,1344,34420,fhi:git
county,Agder,2021-03-06,36,405,23123,11738,7.48697558306324,3.80063656938963,441,34861,fhi:git
county,Agder,2021-03-07,3,1,23126,11739,7.48794695039227,3.8009603584993,4,34865,fhi:git
county,Agder,2021-03-08,226,0,23352,11739,7.56112328917929,3.8009603584993,226,35091,fhi:git
county,Agder,2021-03-09,723,141,24075,11880,7.79522281547583,3.84661462296377,864,35955,fhi:git
county,Agder,2021-03-10,1035,784,25110,12664,8.13034454399161,4.10046528495061,1819,37774,fhi:git
county,Agder,2021-03-11,646,814,25756,13478,8.339512308843,4.36402962022775,1460,39234,fhi:git
county,Agder,2021-03-12,99,327,25855,13805,8.37156743070104,4.46990865909216,426,39660,fhi:git
county,Agder,2021-03-13,0,0,25855,13805,8.37156743070104,4.46990865909216,0,39660,fhi:git
county,Agder,2021-03-14,0,0,25855,13805,8.37156743070104,4.46990865909216,0,39660,fhi:git
county,Agder,2021-03-15,0,3,25855,13808,8.37156743070104,4.47088002642119,3,39663,fhi:git
county,Agder,2021-03-16,240,14,26095,13822,8.44927681702354,4.47541307395667,254,39917,fhi:git
county,Agder,2021-03-17,1608,48,27703,13870,8.96992970538429,4.49095495122117,1656,41573,fhi:git
county,Agder,2021-03-18,1245,94,28948,13964,9.37304714693226,4.52139112753082,1339,42912,fhi:git
county,Agder,2021-03-19,265,41,29213,14005,9.45885126099669,4.53466648102758,306,43218,fhi:git
county,Agder,2021-03-20,0,0,29213,14005,9.45885126099669,4.53466648102758,0,43218,fhi:git
county,Agder,2021-03-21,17,53,29230,14058,9.4643556758612,4.55182730384046,70,43288,fhi:git
county,Agder,2021-03-22,9,1,29239,14059,9.46726977784829,4.55215109295014,10,43298,fhi:git
county,Agder,2021-03-23,314,14,29553,14073,9.5689395582869,4.55668414048562,328,43626,fhi:git
county,Agder,2021-03-24,2267,75,31820,14148,10.3029694699248,4.5809683237114,2342,45968,fhi:git
county,Agder,2021-03-25,2037,53,33857,14201,10.9625278863371,4.59812914652429,2090,48058,fhi:git
county,Agder,2021-03-26,776,12,34633,14213,11.2137882354465,4.60201461584041,788,48846,fhi:git
county,Agder,2021-03-27,1,0,34634,14213,11.2141120245562,4.60201461584041,1,48847,fhi:git
county,Agder,2021-03-28,173,1,34807,14214,11.2701275405303,4.60233840495009,174,49021,fhi:git
county,Agder,2021-03-29,107,0,34914,14214,11.3047729752658,4.60233840495009,107,49128,fhi:git
county,Agder,2021-03-30,689,71,35603,14285,11.5278636718333,4.62532743173716,760,49888,fhi:git
county,Agder,2021-03-31,3374,402,38977,14687,12.6203281278837,4.75549065382735,3776,53664,fhi:git
county,Agder,2021-04-01,237,49,39214,14736,12.6970661468772,4.77135632020153,286,53950,fhi:git
county,Agder,2021-04-02,1,0,39215,14736,12.6973899359869,4.77135632020153,1,53951,fhi:git
county,Agder,2021-04-03,13,0,39228,14736,12.7015991944127,4.77135632020153,13,53964,fhi:git
county,Agder,2021-04-04,1,5,39229,14741,12.7019229835224,4.77297526574991,6,53970,fhi:git
county,Agder,2021-04-05,0,0,39229,14741,12.7019229835224,4.77297526574991,0,53970,fhi:git
county,Agder,2021-04-06,619,1,39848,14742,12.9023484424125,4.77329905485959,620,54590,fhi:git
county,Agder,2021-04-07,3653,60,43501,14802,14.0851500600629,4.79272640144021,3713,58303,fhi:git
county,Agder,2021-04-08,3502,82,47003,14884,15.219059522152,4.81927710843374,3584,61887,fhi:git
county,Agder,2021-04-09,897,1,47900,14885,15.5094983535324,4.81960089754341,898,62785,fhi:git
county,Agder,2021-04-10,0,0,47900,14885,15.5094983535324,4.81960089754341,0,62785,fhi:git
county,Agder,2021-04-11,164,0,48064,14885,15.5625997675194,4.81960089754341,164,62949,fhi:git
county,Agder,2021-04-12,23,2,48087,14887,15.570046917042,4.82024847576277,25,62974,fhi:git
county,Agder,2021-04-13,548,5,48635,14892,15.747483349145,4.82186742131115,553,63527,fhi:git
county,Innlandet,2020-12-27,0,0,0,0,0.0,0.0,0,0,fhi:git
county,Innlandet,2020-12-28,272,0,272,0,0.0732393607711674,0.0,272,272,fhi:git
county,Innlandet,2020-12-29,260,0,532,0,0.143247573273019,0.0,260,532,fhi:git
county,Innlandet,2020-12-30,149,0,681,0,0.183367664283695,0.0,149,681,fhi:git
county,Innlandet,2020-12-31,0,0,681,0,0.183367664283695,0.0,0,681,fhi:git
county,Innlandet,2021-01-01,0,0,681,0,0.183367664283695,0.0,0,681,fhi:git
county,Innlandet,2021-01-02,0,0,681,0,0.183367664283695,0.0,0,681,fhi:git
county,Innlandet,2021-01-03,0,0,681,0,0.183367664283695,0.0,0,681,fhi:git
county,Innlandet,2021-01-04,0,0,681,0,0.183754583745949,0.0,0,681,fhi:git
county,Innlandet,2021-01-05,271,0,952,0,0.256878654517098,0.0,271,952,fhi:git
county,Innlandet,2021-01-06,704,0,1656,0,0.446839340210414,0.0,704,1656,fhi:git
county,Innlandet,2021-01-07,696,0,2352,0,0.634641381748124,0.0,696,2352,fhi:git
county,Innlandet,2021-01-08,75,0,2427,0,0.654878670706929,0.0,75,2427,fhi:git
county,Innlandet,2021-01-09,0,0,2427,0,0.654878670706929,0.0,0,2427,fhi:git
county,Innlandet,2021-01-10,0,0,2427,0,0.654878670706929,0.0,0,2427,fhi:git
county,Innlandet,2021-01-11,50,0,2477,0,0.668370196679466,0.0,50,2477,fhi:git
county,Innlandet,2021-01-12,404,0,2881,0,0.777381726537562,0.0,404,2881,fhi:git
county,Innlandet,2021-01-13,993,0,3874,0,1.04532343235214,0.0,993,3874,fhi:git
county,Innlandet,2021-01-14,958,0,4832,0,1.30382106998594,0.0,958,4832,fhi:git
county,Innlandet,2021-01-15,280,0,5112,0,1.37937361543215,0.0,280,5112,fhi:git
county,Innlandet,2021-01-16,4,0,5116,0,1.38045293750995,0.0,4,5116,fhi:git
county,Innlandet,2021-01-17,0,0,5116,0,1.38045293750995,0.0,0,5116,fhi:git
county,Innlandet,2021-01-18,62,0,5178,0,1.3971824297159,0.0,62,5178,fhi:git
county,Innlandet,2021-01-19,331,318,5509,318,1.48649633165409,0.0858061051853331,649,5827,fhi:git
county,Innlandet,2021-01-20,662,252,6171,570,1.66512413553047,0.153803396086918,914,6741,fhi:git
county,Innlandet,2021-01-21,834,48,7005,618,1.89016278875238,0.166755261020553,882,7623,fhi:git
county,Innlandet,2021-01-22,239,0,7244,618,1.95465228290111,0.166755261020553,239,7862,fhi:git
county,Innlandet,2021-01-23,6,0,7250,618,1.95627126601781,0.166755261020553,6,7868,fhi:git
county,Innlandet,2021-01-24,0,0,7250,618,1.95627126601781,0.166755261020553,0,7868,fhi:git
county,Innlandet,2021-01-25,1,0,7251,618,1.95654109653727,0.166755261020553,1,7869,fhi:git
county,Innlandet,2021-01-26,152,131,7403,749,1.99755533549378,0.202103059068599,283,8152,fhi:git
county,Innlandet,2021-01-27,934,605,8337,1354,2.24957704066076,0.365350523336292,1539,9691,fhi:git
county,Innlandet,2021-01-28,903,708,9240,2062,2.49323399972477,0.556390531107411,1611,11302,fhi:git
county,Innlandet,2021-01-29,319,132,9559,2194,2.57930993542956,0.592008159674908,451,11753,fhi:git
county,Innlandet,2021-01-30,2,0,9561,2194,2.57984959646846,0.592008159674908,2,11755,fhi:git
county,Innlandet,2021-01-31,1,0,9562,2194,2.58011942698791,0.592008159674908,1,11756,fhi:git
county,Innlandet,2021-02-01,9,49,9571,2243,2.58254790166297,0.605229855127994,58,11814,fhi:git
county,Innlandet,2021-02-02,611,341,10182,2584,2.74741434904736,0.697242062260694,952,12766,fhi:git
county,Innlandet,2021-02-03,2310,872,12492,3456,3.37072284897856,0.932534275221733,3182,15948,fhi:git
county,Innlandet,2021-02-04,2656,999,15148,4455,4.0873927086397,1.20209496415302,3655,19603,fhi:git
county,Innlandet,2021-02-05,815,271,15963,4726,4.30730458199205,1.27521903492416,1086,20689,fhi:git
county,Innlandet,2021-02-06,8,4,15971,4730,4.30946322614766,1.27629835700197,12,20701,fhi:git
county,Innlandet,2021-02-07,0,0,15971,4730,4.30946322614766,1.27629835700197,0,20701,fhi:git
county,Innlandet,2021-02-08,2,62,15973,4792,4.31000288718656,1.29302784920791,64,20765,fhi:git
county,Innlandet,2021-02-09,258,269,16231,5061,4.37961916120485,1.36561225894016,527,21292,fhi:git
county,Innlandet,2021-02-10,2056,589,18287,5650,4.93439070919555,1.52454243489664,2645,23937,fhi:git
county,Innlandet,2021-02-11,2239,848,20526,6498,5.53854124224575,1.75335871539086,3087,27024,fhi:git
county,Innlandet,2021-02-12,430,283,20956,6781,5.65456836560956,1.82972075239542,713,27737,fhi:git
county,Innlandet,2021-02-13,0,5,20956,6786,5.65456836560956,1.83106990499267,5,27742,fhi:git
county,Innlandet,2021-02-14,1,1,20957,6787,5.65483819612901,1.83133973551212,2,27744,fhi:git
county,Innlandet,2021-02-15,86,14,21043,6801,5.67804362080177,1.83511736278444,100,27844,fhi:git
county,Innlandet,2021-02-16,613,92,21656,6893,5.84344972922507,1.8599417705739,705,28549,fhi:git
county,Innlandet,2021-02-17,1572,783,23228,7676,6.26762330580163,2.07121906730383,2355,30904,fhi:git
county,Innlandet,2021-02-18,1466,903,24694,8579,6.6631948473164,2.31487602636784,2369,33273,fhi:git
county,Innlandet,2021-02-19,540,296,25234,8875,6.8089033278198,2.39474586012526,836,34109,fhi:git
county,Innlandet,2021-02-20,0,3,25234,8878,6.8089033278198,2.39555535168361,3,34112,fhi:git
county,Innlandet,2021-02-21,0,1,25234,8879,6.8089033278198,2.39582518220306,1,34113,fhi:git
county,Innlandet,2021-02-22,284,3,25518,8882,6.8855351953438,2.39663467376141,287,34400,fhi:git
county,Innlandet,2021-02-23,320,307,25838,9189,6.97188096156804,2.47947264323279,627,35027,fhi:git
county,Innlandet,2021-02-24,854,2319,26692,11508,7.20231622517897,3.10520961783904,3173,38200,fhi:git
county,Innlandet,2021-02-25,1752,2476,28444,13984,7.67505929525665,3.77330998399905,4228,42428,fhi:git
county,Innlandet,2021-02-26,676,814,29120,14798,7.85746472640534,3.99295202683195,1490,43918,fhi:git
county,Innlandet,2021-02-27,3,1,29123,14799,7.8582742179637,3.9932218573514,4,43922,fhi:git
county,Innlandet,2021-02-28,3,6,29126,14805,7.85908370952205,3.9948408404681,9,43931,fhi:git
county,Innlandet,2021-03-01,189,7,29315,14812,7.91008167769824,3.99672965410426,196,44127,fhi:git
county,Innlandet,2021-03-02,529,160,29844,14972,8.05282202248768,4.03990253721637,689,44816,fhi:git
county,Innlandet,2021-03-03,1599,1972,31443,16944,8.4842810230894,4.57200832157322,3571,48387,fhi:git
county,Innlandet,2021-03-04,1519,2291,32962,19235,8.89415358213506,5.19019004163485,3810,52197,fhi:git
county,Innlandet,2021-03-05,547,421,33509,19656,9.04175087627461,5.30378869032361,968,53165,fhi:git
county,Innlandet,2021-03-06,7,4,33516,19660,9.04363968991077,5.30486801240141,11,53176,fhi:git
county,Innlandet,2021-03-07,0,0,33516,19660,9.04363968991077,5.30486801240141,0,53176,fhi:git
county,Innlandet,2021-03-08,112,0,33628,19660,9.07386070808925,5.30486801240141,112,53288,fhi:git
county,Innlandet,2021-03-09,936,311,34564,19971,9.32642207429513,5.38878530395059,1247,54535,fhi:git
county,Innlandet,2021-03-10,2029,1306,36593,21277,9.87390819826067,5.74118396235325,3335,57870,fhi:git
county,Innlandet,2021-03-11,1014,968,37607,22245,10.1475163449837,6.00237990518156,1982,59852,fhi:git
county,Innlandet,2021-03-12,43,180,37650,22425,10.1591190573201,6.05094939868269,223,60075,fhi:git
county,Innlandet,2021-03-13,0,0,37650,22425,10.1591190573201,6.05094939868269,0,60075,fhi:git
county,Innlandet,2021-03-14,0,7,37650,22432,10.1591190573201,6.05283821231884,7,60082,fhi:git
county,Innlandet,2021-03-15,25,3,37675,22435,10.1658648203064,6.0536477038772,28,60110,fhi:git
county,Innlandet,2021-03-16,364,9,38039,22444,10.2640831293864,6.05607617855225,373,60483,fhi:git
county,Innlandet,2021-03-17,1803,155,39842,22599,10.7505875559561,6.09789990906712,1958,62441,fhi:git
county,Innlandet,2021-03-18,1650,106,41492,22705,11.1958079130498,6.12650194412889,1756,64197,fhi:git
county,Innlandet,2021-03-19,190,20,41682,22725,11.2470757117455,6.13189855451791,210,64407,fhi:git
county,Innlandet,2021-03-20,0,0,41682,22725,11.2470757117455,6.13189855451791,0,64407,fhi:git
county,Innlandet,2021-03-21,1,0,41683,22725,11.2473455422649,6.13189855451791,1,64408,fhi:git
county,Innlandet,2021-03-22,98,9,41781,22734,11.2737889331711,6.13432702919296,107,64515,fhi:git
county,Innlandet,2021-03-23,809,51,42590,22785,11.4920818234067,6.14808838568495,860,65375,fhi:git
county,Innlandet,2021-03-24,3240,523,45830,23308,12.3663327064271,6.28920974735769,3763,69138,fhi:git
county,Innlandet,2021-03-25,3198,323,49028,23631,13.2292507076305,6.37636500514027,3521,72659,fhi:git
county,Innlandet,2021-03-26,672,52,49700,23683,13.4105768167014,6.39039619215171,724,73383,fhi:git
county,Innlandet,2021-03-27,0,0,49700,23683,13.4105768167014,6.39039619215171,0,73383,fhi:git
county,Innlandet,2021-03-28,0,0,49700,23683,13.4105768167014,6.39039619215171,0,73383,fhi:git
county,Innlandet,2021-03-29,396,2,50096,23685,13.5174297024039,6.39093585319061,398,73781,fhi:git
county,Innlandet,2021-03-30,2886,227,52982,23912,14.2961605815387,6.45218738110593,3113,76894,fhi:git
county,Innlandet,2021-03-31,2845,561,55827,24473,15.0638284093761,6.60356230251779,3406,80300,fhi:git
county,Innlandet,2021-04-01,88,18,55915,24491,15.0875734950877,6.6084192518679,106,80406,fhi:git
county,Innlandet,2021-04-02,6,1,55921,24492,15.0891924782044,6.60868908238735,7,80413,fhi:git
county,Innlandet,2021-04-03,0,6,55921,24498,15.0891924782044,6.61030806550406,6,80419,fhi:git
county,Innlandet,2021-04-04,0,0,55921,24498,15.0891924782044,6.61030806550406,0,80419,fhi:git
county,Innlandet,2021-04-05,9,2,55930,24500,15.0916209528795,6.61084772654296,11,80430,fhi:git
county,Innlandet,2021-04-06,509,31,56439,24531,15.2289646872799,6.61921247264593,540,80970,fhi:git
county,Innlandet,2021-04-07,4233,91,60672,24622,16.3711572761149,6.64376704991595,4324,85294,fhi:git
county,Innlandet,2021-04-08,4568,93,65240,24715,17.6037430889658,6.66886128822487,4661,89955,fhi:git
county,Innlandet,2021-04-09,1487,13,66727,24728,18.0049810713891,6.67236908497773,1500,91455,fhi:git
county,Innlandet,2021-04-10,3,0,66730,24728,18.0057905629474,6.67236908497773,3,91458,fhi:git
county,Innlandet,2021-04-11,0,0,66730,24728,18.0057905629474,6.67236908497773,0,91458,fhi:git
county,Innlandet,2021-04-12,6,11,66736,24739,18.0074095460641,6.67533722069168,17,91475,fhi:git
county,Innlandet,2021-04-13,1269,7,68005,24746,18.3498244752471,6.67722603432784,1276,92751,fhi:git
county,Møre og Romsdal,2020-12-27,0,0,0,0,0.0,0.0,0,0,fhi:git
county,Møre og Romsdal,2020-12-28,1,0,1,0,0.0003770198840286,0.0,1,1,fhi:git
county,Møre og Romsdal,2020-12-29,0,0,1,0,0.0003770198840286,0.0,0,1,fhi:git
county,Møre og Romsdal,2020-12-30,0,0,1,0,0.0003770198840286,0.0,0,1,fhi:git
county,Møre og Romsdal,2020-12-31,0,0,1,0,0.0003770198840286,0.0,0,1,fhi:git
county,Møre og Romsdal,2021-01-01,0,0,1,0,0.0003770198840286,0.0,0,1,fhi:git
county,Møre og Romsdal,2021-01-02,0,0,1,0,0.0003770198840286,0.0,0,1,fhi:git
county,Møre og Romsdal,2021-01-03,0,0,1,0,0.0003770198840286,0.0,0,1,fhi:git
county,Møre og Romsdal,2021-01-04,0,0,1,0,0.0003765854246377,0.0,0,1,fhi:git
county,Møre og Romsdal,2021-01-05,186,0,187,0,0.0704214744072545,0.0,186,187,fhi:git
county,Møre og Romsdal,2021-01-06,496,0,683,0,0.257207845027566,0.0,496,683,fhi:git
county,Møre og Romsdal,2021-01-07,457,0,1140,0,0.429307384087006,0.0,457,1140,fhi:git
county,Møre og Romsdal,2021-01-08,36,0,1176,0,0.442864459373964,0.0,36,1176,fhi:git
county,Møre og Romsdal,2021-01-09,1,0,1177,0,0.443241044798602,0.0,1,1177,fhi:git
county,Møre og Romsdal,2021-01-10,0,0,1177,0,0.443241044798602,0.0,0,1177,fhi:git
county,Møre og Romsdal,2021-01-11,1,0,1178,0,0.44361763022324,0.0,1,1178,fhi:git
county,Møre og Romsdal,2021-01-12,225,0,1403,0,0.528349350766728,0.0,225,1403,fhi:git
county,Møre og Romsdal,2021-01-13,387,0,1790,0,0.674087910101528,0.0,387,1790,fhi:git
county,Møre og Romsdal,2021-01-14,409,0,2199,0,0.828111348778357,0.0,409,2199,fhi:git
county,Møre og Romsdal,2021-01-15,150,0,2349,0,0.884599162474016,0.0,150,2349,fhi:git
county,Møre og Romsdal,2021-01-16,1,0,2350,0,0.884975747898653,0.0,1,2350,fhi:git
county,Møre og Romsdal,2021-01-17,2,0,2352,0,0.885728918747929,0.0,2,2352,fhi:git
county,Møre og Romsdal,2021-01-18,11,0,2363,0,0.889871358418944,0.0,11,2363,fhi:git
county,Møre og Romsdal,2021-01-19,203,0,2566,0,0.966318199620402,0.0,203,2566,fhi:git
county,Møre og Romsdal,2021-01-20,500,0,3066,0,1.15461091193926,0.0,500,3066,fhi:git
county,Møre og Romsdal,2021-01-21,800,0,3866,0,1.45587925164944,0.0,800,3866,fhi:git
county,Møre og Romsdal,2021-01-22,212,0,4078,0,1.53571536167264,0.0,212,4078,fhi:git
county,Møre og Romsdal,2021-01-23,0,0,4078,0,1.53571536167264,0.0,0,4078,fhi:git
county,Møre og Romsdal,2021-01-24,0,0,4078,0,1.53571536167264,0.0,0,4078,fhi:git
county,Møre og Romsdal,2021-01-25,3,0,4081,0,1.53684511794656,0.0,3,4081,fhi:git
county,Møre og Romsdal,2021-01-26,78,129,4159,129,1.5662187810683,0.0485795197782665,207,4288,fhi:git
county,Møre og Romsdal,2021-01-27,542,358,4701,487,1.77032808122194,0.183397101798572,900,5188,fhi:git
county,Møre og Romsdal,2021-01-28,492,509,5193,996,1.9556081101437,0.375079082939174,1001,6189,fhi:git
county,Møre og Romsdal,2021-01-29,99,78,5292,1074,1.99289006718284,0.404452746060916,177,6366,fhi:git
county,Møre og Romsdal,2021-01-30,0,1,5292,1075,1.99289006718284,0.404829331485554,1,6367,fhi:git
county,Møre og Romsdal,2021-01-31,1,0,5293,1075,1.99326665260748,0.404829331485554,1,6368,fhi:git
county,Møre og Romsdal,2021-02-01,0,0,5293,1075,1.99326665260748,0.404829331485554,0,6368,fhi:git
county,Møre og Romsdal,2021-02-02,291,193,5584,1268,2.10285301117706,0.477510318440635,484,6852,fhi:git
county,Møre og Romsdal,2021-02-03,1064,312,6648,1580,2.50353990299159,0.595004970927605,1376,8228,fhi:git
county,Møre og Romsdal,2021-02-04,1546,462,8194,2042,3.08574096948152,0.768987437110234,2008,10236,fhi:git
county,Møre og Romsdal,2021-02-05,219,154,8413,2196,3.16821317747718,0.826981592504444,373,10609,fhi:git
county,Møre og Romsdal,2021-02-06,1,2,8414,2198,3.16858976290182,0.827734763353719,3,10612,fhi:git
county,Møre og Romsdal,2021-02-07,0,1,8414,2199,3.16858976290182,0.828111348778357,1,10613,fhi:git
county,Møre og Romsdal,2021-02-08,1,2,8415,2201,3.16896634832645,0.828864519627632,3,10616,fhi:git
county,Møre og Romsdal,2021-02-09,327,183,8742,2384,3.29210978218299,0.897779652336336,510,11126,fhi:git
county,Møre og Romsdal,2021-02-10,1258,435,10000,2819,3.76585424637725,1.06159431205375,1693,12819,fhi:git
county,Møre og Romsdal,2021-02-11,1254,804,11254,3623,4.23809236887296,1.36436899346248,2058,14877,fhi:git
county,Møre og Romsdal,2021-02-12,295,207,11549,3830,4.34918506914108,1.44232217636249,502,15379,fhi:git
county,Møre og Romsdal,2021-02-13,24,0,11573,3830,4.35822311933239,1.44232217636249,24,15403,fhi:git
county,Møre og Romsdal,2021-02-14,0,0,11573,3830,4.35822311933239,1.44232217636249,0,15403,fhi:git
county,Møre og Romsdal,2021-02-15,1,8,11574,3838,4.35859970475703,1.44533485975959,9,15412,fhi:git
county,Møre og Romsdal,2021-02-16,354,58,11928,3896,4.49191094507878,1.46717681438858,412,15824,fhi:git
county,Møre og Romsdal,2021-02-17,1204,424,13132,4320,4.9453197963426,1.62684903443497,1628,17452,fhi:git
county,Møre og Romsdal,2021-02-18,1165,522,14297,4842,5.38404181604555,1.82342662609586,1687,19139,fhi:git
county,Møre og Romsdal,2021-02-19,499,94,14796,4936,5.57195794293978,1.85882565601181,593,19732,fhi:git
county,Møre og Romsdal,2021-02-20,11,0,14807,4936,5.57610038261079,1.85882565601181,11,19743,fhi:git
county,Møre og Romsdal,2021-02-21,0,1,14807,4937,5.57610038261079,1.85920224143645,1,19744,fhi:git
county,Møre og Romsdal,2021-02-22,15,0,14822,4937,5.58174916398036,1.85920224143645,15,19759,fhi:git
county,Møre og Romsdal,2021-02-23,393,223,15215,5160,5.72974723586298,1.94318079113066,616,20375,fhi:git
county,Møre og Romsdal,2021-02-24,729,877,15944,6037,6.00427801042388,2.27344620853794,1606,21981,fhi:git
county,Møre og Romsdal,2021-02-25,704,1477,16648,7514,6.26939414936884,2.82966288072786,2181,24162,fhi:git
county,Møre og Romsdal,2021-02-26,260,203,16908,7717,6.36730635977465,2.90610972192932,463,24625,fhi:git
county,Møre og Romsdal,2021-02-27,2,1,16910,7718,6.36805953062393,2.90648630735396,3,24628,fhi:git
county,Møre og Romsdal,2021-02-28,0,0,16910,7718,6.36805953062393,2.90648630735396,0,24628,fhi:git
county,Møre og Romsdal,2021-03-01,101,1,17011,7719,6.40609465851234,2.9068628927786,102,24730,fhi:git
county,Møre og Romsdal,2021-03-02,741,252,17752,7971,6.68514445816889,3.0017624197873,993,25723,fhi:git
county,Møre og Romsdal,2021-03-03,870,1116,18622,9087,7.01277377760371,3.42203175368301,1986,27709,fhi:git
county,Møre og Romsdal,2021-03-04,989,1308,19611,10395,7.38521676257042,3.91460548910915,2297,30006,fhi:git
county,Møre og Romsdal,2021-03-05,813,274,20424,10669,7.69138071280089,4.01778989545989,1087,31093,fhi:git
county,Møre og Romsdal,2021-03-06,3,6,20427,10675,7.69251046907481,4.02004940800771,9,31102,fhi:git
county,Møre og Romsdal,2021-03-07,0,0,20427,10675,7.69251046907481,4.02004940800771,0,31102,fhi:git
county,Møre og Romsdal,2021-03-08,157,0,20584,10675,7.75163438074293,4.02004940800771,157,31259,fhi:git
county,Møre og Romsdal,2021-03-09,670,238,21254,10913,8.0039466152502,4.10967673907149,908,32167,fhi:git
county,Møre og Romsdal,2021-03-10,1287,946,22541,11859,8.48861205675896,4.46592655077878,2233,34400,fhi:git
county,Møre og Romsdal,2021-03-11,540,974,23081,12833,8.69196818606333,4.83272075437592,1514,35914,fhi:git
county,Møre og Romsdal,2021-03-12,66,249,23147,13082,8.71682282408942,4.92649052511072,315,36229,fhi:git
county,Møre og Romsdal,2021-03-13,0,16,23147,13098,8.71682282408942,4.93251589190492,16,36245,fhi:git
county,Møre og Romsdal,2021-03-14,0,0,23147,13098,8.71682282408942,4.93251589190492,0,36245,fhi:git
county,Møre og Romsdal,2021-03-15,0,1,23147,13099,8.71682282408942,4.93289247732956,1,36246,fhi:git
county,Møre og Romsdal,2021-03-16,335,10,23482,13109,8.84297894134306,4.93665833157594,345,36591,fhi:git
county,Møre og Romsdal,2021-03-17,1536,129,25018,13238,9.4214141535866,4.9852378513542,1665,38256,fhi:git
county,Møre og Romsdal,2021-03-18,1485,60,26503,13298,9.98064350917362,5.00783297683246,1545,39801,fhi:git
county,Møre og Romsdal,2021-03-19,205,37,26708,13335,10.0578435212244,5.02176663754406,242,40043,fhi:git
county,Møre og Romsdal,2021-03-20,18,0,26726,13335,10.0646220588678,5.02176663754406,18,40061,fhi:git
county,Møre og Romsdal,2021-03-21,0,0,26726,13335,10.0646220588678,5.02176663754406,0,40061,fhi:git
county,Møre og Romsdal,2021-03-22,1,7,26727,13342,10.0649986442925,5.02440273551652,8,40069,fhi:git
county,Møre og Romsdal,2021-03-23,598,19,27325,13361,10.2901967282258,5.03155785858464,617,40686,fhi:git
county,Møre og Romsdal,2021-03-24,1808,48,29133,13409,10.9710631759708,5.04963395896725,1856,42542,fhi:git
county,Møre og Romsdal,2021-03-25,2319,71,31452,13480,11.8443647757057,5.07637152411653,2390,44932,fhi:git
county,Møre og Romsdal,2021-03-26,225,19,31677,13499,11.9290964962492,5.08352664718465,244,45176,fhi:git
county,Møre og Romsdal,2021-03-27,25,1,31702,13500,11.9385111318652,5.08390323260929,26,45202,fhi:git
county,Møre og Romsdal,2021-03-28,0,0,31702,13500,11.9385111318652,5.08390323260929,0,45202,fhi:git
county,Møre og Romsdal,2021-03-29,7,5,31709,13505,11.9411472298376,5.08578615973247,12,45214,fhi:git
county,Møre og Romsdal,2021-03-30,2233,99,33942,13604,12.7820624830537,5.12306811677161,2332,47546,fhi:git
county,Møre og Romsdal,2021-03-31,1939,214,35881,13818,13.5122616214262,5.20365739764408,2153,49699,fhi:git
county,Møre og Romsdal,2021-04-01,99,26,35980,13844,13.5495435784653,5.21344861868466,125,49824,fhi:git
county,Møre og Romsdal,2021-04-02,19,1,35999,13845,13.5566987015335,5.2138252041093,20,49844,fhi:git
county,Møre og Romsdal,2021-04-03,14,0,36013,13845,13.5619708974784,5.2138252041093,14,49858,fhi:git
county,Møre og Romsdal,2021-04-04,0,0,36013,13845,13.5619708974784,5.2138252041093,0,49858,fhi:git
county,Møre og Romsdal,2021-04-05,1,0,36014,13845,13.562347482903,5.2138252041093,1,49859,fhi:git
county,Møre og Romsdal,2021-04-06,821,49,36835,13894,13.8715241165306,5.23227788991655,870,50729,fhi:git
county,Møre og Romsdal,2021-04-07,2459,40,39294,13934,14.7975476757148,5.24734130690206,2499,53228,fhi:git
county,Møre og Romsdal,2021-04-08,3347,75,42641,14009,16.0579790919772,5.27558521374989,3422,56650,fhi:git
county,Møre og Romsdal,2021-04-09,680,27,43321,14036,16.3140571807309,5.28575302021511,707,57357,fhi:git
county,Møre og Romsdal,2021-04-10,0,0,43321,14036,16.3140571807309,5.28575302021511,0,57357,fhi:git
county,Møre og Romsdal,2021-04-11,0,0,43321,14036,16.3140571807309,5.28575302021511,0,57357,fhi:git
county,Møre og Romsdal,2021-04-12,4,0,43325,14036,16.3155635224294,5.28575302021511,4,57361,fhi:git
county,Møre og Romsdal,2021-04-13,1235,5,44560,14041,16.780646521857,5.28763594733829,1240,58601,fhi:git
county,Nordland,2020-12-27,0,0,0,0,0.0,0.0,0,0,fhi:git
county,Nordland,2020-12-28,0,0,0,0,0.0,0.0,0,0,fhi:git
county,Nordland,2020-12-29,0,0,0,0,0.0,0.0,0,0,fhi:git
county,Nordland,2020-12-30,1,0,1,0,0.0004145335461272,0.0,1,1,fhi:git
county,Nordland,2020-12-31,0,0,1,0,0.0004145335461272,0.0,0,1,fhi:git
county,Nordland,2021-01-01,0,0,1,0,0.0004145335461272,0.0,0,1,fhi:git
county,Nordland,2021-01-02,0,0,1,0,0.0004145335461272,0.0,0,1,fhi:git
county,Nordland,2021-01-03,0,0,1,0,0.0004145335461272,0.0,0,1,fhi:git
county,Nordland,2021-01-04,0,0,1,0,0.0004160685681,0.0,0,1,fhi:git
county,Nordland,2021-01-05,200,0,201,0,0.0836297821881046,0.0,200,201,fhi:git
county,Nordland,2021-01-06,686,0,887,0,0.36905281990472,0.0,686,887,fhi:git
county,Nordland,2021-01-07,238,0,1125,0,0.468077139112526,0.0,238,1125,fhi:git
county,Nordland,2021-01-08,114,0,1239,0,0.515508955875928,0.0,114,1239,fhi:git
county,Nordland,2021-01-09,0,0,1239,0,0.515508955875928,0.0,0,1239,fhi:git
county,Nordland,2021-01-10,0,0,1239,0,0.515508955875928,0.0,0,1239,fhi:git
county,Nordland,2021-01-11,0,0,1239,0,0.515508955875928,0.0,0,1239,fhi:git
county,Nordland,2021-01-12,292,0,1531,0,0.637000977761135,0.0,292,1531,fhi:git
county,Nordland,2021-01-13,626,0,2157,0,0.897459901391749,0.0,626,2157,fhi:git
county,Nordland,2021-01-14,271,0,2428,0,1.01021448334686,0.0,271,2428,fhi:git
county,Nordland,2021-01-15,69,0,2497,0,1.03892321454576,0.0,69,2497,fhi:git
county,Nordland,2021-01-16,0,0,2497,0,1.03892321454576,0.0,0,2497,fhi:git
county,Nordland,2021-01-17,1,0,2498,0,1.03933928311386,0.0,1,2498,fhi:git
county,Nordland,2021-01-18,0,0,2498,0,1.03933928311386,0.0,0,2498,fhi:git
county,Nordland,2021-01-19,313,0,2811,0,1.16956874492916,0.0,313,2811,fhi:git
county,Nordland,2021-01-20,786,0,3597,0,1.49659863945578,0.0,786,3597,fhi:git
county,Nordland,2021-01-21,618,0,4215,0,1.7537290145416,0.0,618,4215,fhi:git
county,Nordland,2021-01-22,173,0,4388,0,1.8257088768229,0.0,173,4388,fhi:git
county,Nordland,2021-01-23,4,0,4392,0,1.8273731510953,0.0,4,4392,fhi:git
county,Nordland,2021-01-24,0,0,4392,0,1.8273731510953,0.0,0,4392,fhi:git
county,Nordland,2021-01-25,51,0,4443,0,1.8485926480684,0.0,51,4443,fhi:git
county,Nordland,2021-01-26,119,90,4562,90,1.8981048076723,0.0374461711290021,209,4652,fhi:git
county,Nordland,2021-01-27,626,528,5188,618,2.15856373130292,0.257130375085814,1154,5806,fhi:git
county,Nordland,2021-01-28,472,365,5660,983,2.35494809544613,0.408995402442323,837,6643,fhi:git
county,Nordland,2021-01-29,212,144,5872,1127,2.44315463188333,0.468909276248726,356,6999,fhi:git
county,Nordland,2021-01-30,1,0,5873,1127,2.44357070045143,0.468909276248726,1,7000,fhi:git
county,Nordland,2021-01-31,0,0,5873,1127,2.44357070045143,0.468909276248726,0,7000,fhi:git
county,Nordland,2021-02-01,9,4,5882,1131,2.44731531756433,0.470573550521126,13,7013,fhi:git
county,Nordland,2021-02-02,111,200,5993,1331,2.49349892862344,0.553787264141131,311,7324,fhi:git
county,Nordland,2021-02-03,1433,459,7426,1790,3.08972518671077,0.744762736899041,1892,9216,fhi:git
county,Nordland,2021-02-04,1681,347,9107,2137,3.78913644968691,0.889138530029749,2028,11244,fhi:git
county,Nordland,2021-02-05,329,157,9436,2294,3.92602300859182,0.954461295221452,486,11730,fhi:git
county,Nordland,2021-02-06,0,0,9436,2294,3.92602300859182,0.954461295221452,0,11730,fhi:git
county,Nordland,2021-02-07,1,0,9437,2294,3.92643907715992,0.954461295221452,1,11731,fhi:git
county,Nordland,2021-02-08,7,1,9444,2295,3.92935155713662,0.954877363789553,8,11739,fhi:git
county,Nordland,2021-02-09,73,262,9517,2557,3.95972456260792,1.06388732863176,335,12074,fhi:git
county,Nordland,2021-02-10,2036,635,11553,3192,4.80684016725957,1.32809086937527,2671,14745,fhi:git
county,Nordland,2021-02-11,1224,585,12777,3777,5.31610809461399,1.57149098171379,1809,16554,fhi:git
county,Nordland,2021-02-12,286,238,13063,4015,5.4351037050906,1.67051530092159,524,17078,fhi:git
county,Nordland,2021-02-13,53,3,13116,4018,5.4571553391999,1.67176350662589,56,17134,fhi:git
county,Nordland,2021-02-14,0,0,13116,4018,5.4571553391999,1.67176350662589,0,17134,fhi:git
county,Nordland,2021-02-15,0,1,13116,4019,5.4571553391999,1.67217957519399,1,17135,fhi:git
county,Nordland,2021-02-16,223,71,13339,4090,5.54993862988621,1.70172044352909,294,17429,fhi:git
county,Nordland,2021-02-17,1491,515,14830,4605,6.17029686492334,1.91599575610061,2006,19435,fhi:git
county,Nordland,2021-02-18,848,608,15678,5213,6.52312301067216,2.16896544550542,1456,20891,fhi:git
county,Nordland,2021-02-19,306,231,15984,5444,6.65043999251077,2.26507728473653,537,21428,fhi:git
county,Nordland,2021-02-20,1,1,15985,5445,6.65085606107887,2.26549335330462,2,21430,fhi:git
county,Nordland,2021-02-21,0,0,15985,5445,6.65085606107887,2.26549335330462,0,21430,fhi:git
county,Nordland,2021-02-22,270,0,16255,5445,6.76319457446587,2.26549335330462,270,21700,fhi:git
county,Nordland,2021-02-23,308,56,16563,5501,6.89134369344068,2.28879319311823,364,22064,fhi:git
county,Nordland,2021-02-24,974,1008,17537,6509,7.2965944787701,2.70819030976305,1982,24046,fhi:git
county,Nordland,2021-02-25,599,1870,18136,8379,7.54581955106202,3.48623853211009,2469,26515,fhi:git
county,Nordland,2021-02-26,427,397,18563,8776,7.72348082964072,3.6514177536458,824,27339,fhi:git
county,Nordland,2021-02-27,1,4,18564,8780,7.72389689820883,3.6530820279182,5,27344,fhi:git
county,Nordland,2021-02-28,0,1,18564,8781,7.72389689820883,3.6534980964863,1,27345,fhi:git
county,Nordland,2021-03-01,240,0,18804,8781,7.82375335455283,3.6534980964863,240,27585,fhi:git
county,Nordland,2021-03-02,517,50,19321,8831,8.03886080426054,3.6743015248913,567,28152,fhi:git
county,Nordland,2021-03-03,619,1585,19940,10416,8.29640724791446,4.33377020532984,2204,30356,fhi:git
county,Nordland,2021-03-04,712,1388,20652,11804,8.59264806840167,4.91127337785267,2100,32456,fhi:git
county,Nordland,2021-03-05,448,340,21100,12144,8.77904678691048,5.05273669100668,788,33244,fhi:git
county,Nordland,2021-03-06,13,51,21113,12195,8.78445567829578,5.07395618797978,64,33308,fhi:git
county,Nordland,2021-03-07,0,0,21113,12195,8.78445567829578,5.07395618797978,0,33308,fhi:git
county,Nordland,2021-03-08,360,0,21473,12195,8.93424036281179,5.07395618797978,360,33668,fhi:git
county,Nordland,2021-03-09,652,51,22125,12246,9.20551706921301,5.09517568495288,703,34371,fhi:git
county,Nordland,2021-03-10,1210,1187,23335,13433,9.70896003661403,5.58904907528761,2397,36768,fhi:git
county,Nordland,2021-03-11,730,989,24065,14422,10.0126900913271,6.00054088913853,1719,38487,fhi:git
county,Nordland,2021-03-12,72,261,24137,14683,10.0426470282303,6.10913478541264,333,38820,fhi:git
county,Nordland,2021-03-13,3,2,24140,14685,10.0438952339346,6.10996692254884,5,38825,fhi:git
county,Nordland,2021-03-14,0,0,24140,14685,10.0438952339346,6.10996692254884,0,38825,fhi:git
county,Nordland,2021-03-15,0,1,24140,14686,10.0438952339346,6.11038299111694,1,38826,fhi:git
county,Nordland,2021-03-16,118,5,24258,14691,10.0929913249704,6.11246333395744,123,38949,fhi:git
county,Nordland,2021-03-17,902,64,25160,14755,10.4682851733966,6.13909172231584,966,39915,fhi:git
county,Nordland,2021-03-18,1161,75,26321,14830,10.9513407809607,6.17029686492334,1236,41151,fhi:git
county,Nordland,2021-03-19,226,28,26547,14858,11.0453722773513,6.18194678483014,254,41405,fhi:git
county,Nordland,2021-03-20,40,0,26587,14858,11.0620150200753,6.18194678483014,40,41445,fhi:git
county,Nordland,2021-03-21,0,0,26587,14858,11.0620150200753,6.18194678483014,0,41445,fhi:git
county,Nordland,2021-03-22,36,1,26623,14859,11.0769934885269,6.18236285339824,37,41482,fhi:git
county,Nordland,2021-03-23,560,8,27183,14867,11.3099918866629,6.18569140194304,568,42050,fhi:git
county,Nordland,2021-03-24,2190,49,29373,14916,12.221182050802,6.20607876177994,2239,44289,fhi:git
county,Nordland,2021-03-25,1595,64,30968,14980,12.8848114169215,6.23270715013834,1659,45948,fhi:git
county,Nordland,2021-03-26,342,12,31310,14992,13.0271068672117,6.23769997295554,354,46302,fhi:git
county,Nordland,2021-03-27,0,0,31310,14992,13.0271068672117,6.23769997295554,0,46302,fhi:git
county,Nordland,2021-03-28,0,0,31310,14992,13.0271068672117,6.23769997295554,0,46302,fhi:git
county,Nordland,2021-03-29,9,1,31319,14993,13.0308514843246,6.23811604152364,10,46312,fhi:git
county,Nordland,2021-03-30,1572,124,32891,15117,13.6849112733779,6.28970854396805,1696,48008,fhi:git
county,Nordland,2021-03-31,1163,310,34054,15427,14.1687990180782,6.41868980007905,1473,49481,fhi:git
county,Nordland,2021-04-01,227,164,34281,15591,14.2632465830369,6.48692504524746,391,49872,fhi:git
county,Nordland,2021-04-02,99,10,34380,15601,14.3044373712788,6.49108573092846,109,49981,fhi:git
county,Nordland,2021-04-03,0,0,34380,15601,14.3044373712788,6.49108573092846,0,49981,fhi:git
county,Nordland,2021-04-04,0,0,34380,15601,14.3044373712788,6.49108573092846,0,49981,fhi:git
county,Nordland,2021-04-05,0,0,34380,15601,14.3044373712788,6.49108573092846,0,49981,fhi:git
county,Nordland,2021-04-06,468,13,34848,15614,14.4991574611496,6.49649462231376,481,50462,fhi:git
county,Nordland,2021-04-07,3328,80,38176,15694,15.8838336557865,6.52978010776176,3408,53870,fhi:git
county,Nordland,2021-04-08,2268,422,40444,16116,16.8274771682373,6.70536104349997,2690,56560,fhi:git
county,Nordland,2021-04-09,699,28,41143,16144,17.1183090973392,6.71701096340677,727,57287,fhi:git
county,Nordland,2021-04-10,0,0,41143,16144,17.1183090973392,6.71701096340677,0,57287,fhi:git
county,Nordland,2021-04-11,1,0,41144,16144,17.1187251659073,6.71701096340677,1,57288,fhi:git
county,Nordland,2021-04-12,3,27,41147,16171,17.1199733716116,6.72824481474547,30,57318,fhi:git
county,Nordland,2021-04-13,919,9,42066,16180,17.5023403856956,6.73198943185837,928,58246,fhi:git
county,Oslo,2020-12-27,5,0,5,0,0.0007209867713347,0.0,5,5,fhi:git
county,Oslo,2020-12-28,264,0,269,0,0.0387890882978079,0.0,264,269,fhi:git
county,Oslo,2020-12-29,118,0,387,0,0.0558043761013073,0.0,118,387,fhi:git
county,Oslo,2020-12-30,58,0,445,0,0.06416782264879,0.0,58,445,fhi:git
county,Oslo,2020-12-31,5,0,450,0,0.0648888094201248,0.0,5,450,fhi:git
county,Oslo,2021-01-01,6,0,456,0,0.0657539935457264,0.0,6,456,fhi:git
county,Oslo,2021-01-02,0,0,456,0,0.0657539935457264,0.0,0,456,fhi:git
county,Oslo,2021-01-03,0,0,456,0,0.0657539935457264,0.0,0,456,fhi:git
county,Oslo,2021-01-04,0,0,456,0,0.065422303840691,0.0,0,456,fhi:git
county,Oslo,2021-01-05,479,0,935,0,0.134144416866329,0.0,479,935,fhi:git
county,Oslo,2021-01-06,603,0,1538,0,0.220656805497769,0.0,603,1538,fhi:git
county,Oslo,2021-01-07,966,0,2504,0,0.359248791265549,0.0,966,2504,fhi:git
county,Oslo,2021-01-08,450,0,2954,0,0.423810275318862,0.0,450,2954,fhi:git
county,Oslo,2021-01-09,127,0,3081,0,0.442030960818353,0.0,127,3081,fhi:git
county,Oslo,2021-01-10,100,0,3181,0,0.456377957274645,0.0,100,3181,fhi:git
county,Oslo,2021-01-11,78,0,3259,0,0.467568614510552,0.0,78,3259,fhi:git
county,Oslo,2021-01-12,241,0,3500,0,0.502144875970216,0.0,241,3500,fhi:git
county,Oslo,2021-01-13,489,0,3989,0,0.572301688641483,0.0,489,3989,fhi:git
county,Oslo,2021-01-14,1237,0,5226,0,0.749774034805813,0.0,1237,5226,fhi:git
county,Oslo,2021-01-15,1636,0,6862,0,0.984490896830748,0.0,1636,6862,fhi:git
county,Oslo,2021-01-16,643,0,7505,0,1.07674208404471,0.0,643,7505,fhi:git
county,Oslo,2021-01-17,276,5,7781,5,1.11633979426407,0.0007173498228145,281,7786,fhi:git
county,Oslo,2021-01-18,759,231,8540,236,1.22523349736733,0.0338589116368488,990,8776,fhi:git
county,Oslo,2021-01-19,810,70,9350,306,1.34144416866329,0.0439018091562531,880,9656,fhi:git
county,Oslo,2021-01-20,994,99,10344,405,1.48405331343883,0.0581053356479821,1093,10749,fhi:git
county,Oslo,2021-01-21,1021,21,11365,426,1.63053614725757,0.0611182049038034,1042,11791,fhi:git
county,Oslo,2021-01-22,670,6,12035,432,1.72666102351473,0.0619790246911809,676,12467,fhi:git
county,Oslo,2021-01-23,232,0,12267,432,1.75994605529332,0.0619790246911809,232,12699,fhi:git
county,Oslo,2021-01-24,67,0,12334,432,1.76955854291904,0.0619790246911809,67,12766,fhi:git
county,Oslo,2021-01-25,258,0,12592,432,1.80657379377627,0.0619790246911809,258,13024,fhi:git
county,Oslo,2021-01-26,313,404,12905,836,1.85147989268447,0.1199408903746,717,13741,fhi:git
county,Oslo,2021-01-27,1035,528,13940,1364,1.99997130600709,0.195693031663821,1563,15304,fhi:git
county,Oslo,2021-01-28,871,842,14811,2206,2.12493364514139,0.316494741825799,1713,17017,fhi:git
county,Oslo,2021-01-29,428,504,15239,2710,2.18633878997432,0.38880360396551,932,17949,fhi:git
county,Oslo,2021-01-30,95,152,15334,2862,2.1999684366078,0.410611038579073,247,18196,fhi:git
county,Oslo,2021-01-31,62,45,15396,2907,2.2088635744107,0.417067186984405,107,18303,fhi:git
county,Oslo,2021-02-01,53,48,15449,2955,2.21646748253253,0.423953745283425,101,18404,fhi:git
county,Oslo,2021-02-02,1521,151,16970,3106,2.43468529863273,0.445617709932426,1672,20076,fhi:git
county,Oslo,2021-02-03,2457,456,19427,3562,2.78719100156382,0.511040013773117,2913,22989,fhi:git
county,Oslo,2021-02-04,2049,1234,21476,4796,3.08116095895324,0.688081950043758,3283,26272,fhi:git
county,Oslo,2021-02-05,1383,1568,22859,6364,3.27957991994376,0.913042854478415,2951,29223,fhi:git
county,Oslo,2021-02-06,243,631,23102,6995,3.31444312133255,1.00357240211762,874,30097,fhi:git
county,Oslo,2021-02-07,214,270,23316,7265,3.34514569374901,1.0423092925496,484,30581,fhi:git
county,Oslo,2021-02-08,47,443,23363,7708,3.35188878208347,1.10586648685098,490,31071,fhi:git
county,Oslo,2021-02-09,1163,245,24526,7953,3.51874435087015,1.14101662816889,1408,32479,fhi:git
county,Oslo,2021-02-10,1829,815,26355,8768,3.78115091605572,1.25794464928767,2644,35123,fhi:git
county,Oslo,2021-02-11,1585,745,27940,9513,4.00855080988795,1.36482977288705,2330,37453,fhi:git
county,Oslo,2021-02-12,1358,425,29298,9938,4.20338302176439,1.42580450782629,1783,39236,fhi:git
county,Oslo,2021-02-13,273,193,29571,10131,4.24255032209007,1.45349421098693,466,39702,fhi:git
county,Oslo,2021-02-14,103,0,29674,10131,4.25732772844005,1.45349421098693,103,39805,fhi:git
county,Oslo,2021-02-15,260,444,29934,10575,4.29462991922641,1.51719487525287,704,40509,fhi:git
county,Oslo,2021-02-16,726,772,30660,11347,4.39878911349909,1.62795368789544,1498,42007,fhi:git
county,Oslo,2021-02-17,1460,1082,32120,12429,4.60825526176095,1.78318818955252,2542,44549,fhi:git
county,Oslo,2021-02-18,1070,919,33190,13348,4.76176812384327,1.91503708698584,1989,46538,fhi:git
county,Oslo,2021-02-19,1494,971,34684,14319,4.97611225090027,2.05434642257643,2465,49003,fhi:git
county,Oslo,2021-02-20,100,115,34784,14434,4.99045924735657,2.07084546850117,215,49218,fhi:git
county,Oslo,2021-02-21,4,61,34788,14495,4.99103312721482,2.07959713633951,65,49283,fhi:git
county,Oslo,2021-02-22,601,112,35389,14607,5.07725857591713,2.09566577237055,713,49996,fhi:git
county,Oslo,2021-02-23,339,1526,35728,16133,5.12589489390396,2.31460093829357,1865,51861,fhi:git
county,Oslo,2021-02-24,700,2349,36428,18482,5.226323869098,2.65161188505186,3049,54910,fhi:git
county,Oslo,2021-02-25,600,1977,37028,20459,5.31240584783576,2.93525200499276,2577,57487,fhi:git
county,Oslo,2021-02-26,771,1374,37799,21833,5.42302119051377,3.13237973630221,2145,59632,fhi:git
county,Oslo,2021-02-27,259,103,38058,21936,5.46017991133556,3.14715714265219,362,59994,fhi:git
county,Oslo,2021-02-28,101,62,38159,21998,5.47467037775642,3.15605228045509,163,60157,fhi:git
county,Oslo,2021-03-01,1044,39,39203,22037,5.6244530207601,3.16164760907304,1083,61240,fhi:git
county,Oslo,2021-03-02,773,136,39976,22173,5.73535530336724,3.1811595242536,909,62149,fhi:git
county,Oslo,2021-03-03,1354,172,41330,22345,5.92961363538543,3.20583635815842,1526,63675,fhi:git
county,Oslo,2021-03-04,1181,203,42511,22548,6.09905166353424,3.23496076096469,1384,65059,fhi:git
county,Oslo,2021-03-05,1304,68,43815,22616,6.28613649732429,3.24471671855497,1372,66431,fhi:git
county,Oslo,2021-03-06,102,3,43917,22619,6.3007704337097,3.24514712844866,105,66536,fhi:git
county,Oslo,2021-03-07,69,0,43986,22619,6.31066986126454,3.24514712844866,69,66605,fhi:git
county,Oslo,2021-03-08,667,10,44653,22629,6.40636432762801,3.24658182809429,677,67282,fhi:git
county,Oslo,2021-03-09,776,1326,45429,23955,6.51769702012884,3.43682300110472,2102,69384,fhi:git
county,Oslo,2021-03-10,1188,2392,46617,26347,6.68813933802958,3.78000315633922,3580,72964,fhi:git
county,Oslo,2021-03-11,879,2388,47496,28735,6.81424943688039,4.12260943171547,3267,76231,fhi:git
county,Oslo,2021-03-12,278,1638,47774,30373,6.85413408702888,4.35761323366953,1916,78147,fhi:git
county,Oslo,2021-03-13,16,266,47790,30639,6.85642960646189,4.39577624424327,282,78429,fhi:git
county,Oslo,2021-03-14,1,97,47791,30736,6.85657307642645,4.40969283080587,98,78527,fhi:git
county,Oslo,2021-03-15,24,359,47815,31095,6.86001635557596,4.46119854808396,383,78910,fhi:git
county,Oslo,2021-03-16,1007,119,48822,31214,7.00449060989082,4.47827147386695,1126,80036,fhi:git
county,Oslo,2021-03-17,2736,95,51558,31309,7.39702443293497,4.49190112050042,2831,82867,fhi:git
county,Oslo,2021-03-18,2025,112,53583,31421,7.68755111117488,4.50796975653147,2137,85004,fhi:git
county,Oslo,2021-03-19,2001,186,55584,31607,7.97463451026528,4.53465516994017,2187,87191,fhi:git
county,Oslo,2021-03-20,391,18,55975,31625,8.03073126640938,4.53723762930231,409,87600,fhi:git
county,Oslo,2021-03-21,163,14,56138,31639,8.05411687063313,4.53924620880619,177,87777,fhi:git
county,Oslo,2021-03-22,935,11,57073,31650,8.18826128749946,4.54082437841638,946,88723,fhi:git
county,Oslo,2021-03-23,3317,104,60390,31754,8.66415115995466,4.55574525473092,3421,92144,fhi:git
county,Oslo,2021-03-24,5123,213,65513,31967,9.3991477884105,4.58630435718282,5336,97480,fhi:git
county,Oslo,2021-03-25,5134,48,70647,32015,10.1357225864765,4.59319091548184,5182,102662,fhi:git
county,Oslo,2021-03-26,4159,84,74806,32099,10.7324141690937,4.60524239250513,4243,106905,fhi:git
county,Oslo,2021-03-27,559,1,75365,32100,10.8126138792844,4.60538586246969,560,107465,fhi:git
county,Oslo,2021-03-28,150,0,75515,32100,10.8341343739688,4.60538586246969,150,107615,fhi:git
county,Oslo,2021-03-29,2186,10,77701,32110,11.1477597165033,4.60682056211532,2196,109811,fhi:git
county,Oslo,2021-03-30,4359,211,82060,32321,11.7731452920331,4.6370927246381,4570,114381,fhi:git
county,Oslo,2021-03-31,4178,708,86238,33029,12.372562803977,4.73866945954864,4886,119267,fhi:git
county,Oslo,2021-04-01,2806,293,89044,33322,12.7751395245405,4.78070615916558,3099,122366,fhi:git
county,Oslo,2021-04-02,1664,166,90708,33488,13.0138735455732,4.80452217328302,1830,124196,fhi:git
county,Oslo,2021-04-03,229,1,90937,33489,13.0467281674581,4.80466564324759,230,124426,fhi:git
county,Oslo,2021-04-04,374,36,91311,33525,13.1003859342047,4.80983056197185,410,124836,fhi:git
county,Oslo,2021-04-05,1253,53,92564,33578,13.280153799802,4.81743447009369,1306,126142,fhi:git
county,Oslo,2021-04-06,4476,104,97040,33682,13.9223253611856,4.83235534640823,4580,130722,fhi:git
county,Oslo,2021-04-07,6169,161,103209,33843,14.8073915725743,4.85545401070286,6330,137052,fhi:git
county,Oslo,2021-04-08,6022,143,109231,33986,15.6713676991722,4.87597021563536,6165,143217,fhi:git
county,Oslo,2021-04-09,5060,59,114291,34045,16.3973257198605,4.88443494354457,5119,148336,fhi:git
county,Oslo,2021-04-10,740,0,115031,34045,16.5034934936371,4.88443494354457,740,149076,fhi:git
county,Oslo,2021-04-11,367,5,115398,34050,16.5561469706317,4.88515229336738,372,149448,fhi:git
county,Oslo,2021-04-12,1711,4,117109,34054,16.8016240799989,4.88572617322564,1715,151163,fhi:git
county,Oslo,2021-04-13,2895,35,120004,34089,17.2169696274085,4.89074762198534,2930,154093,fhi:git
county,Rogaland,2020-12-27,0,0,0,0,0.0,0.0,0,0,fhi:git
county,Rogaland,2020-12-28,1,0,1,0,0.0002083802188825,0.0,1,1,fhi:git
county,Rogaland,2020-12-29,0,0,1,0,0.0002083802188825,0.0,0,1,fhi:git
county,Rogaland,2020-12-30,0,0,1,0,0.0002083802188825,0.0,0,1,fhi:git
county,Rogaland,2020-12-31,0,0,1,0,0.0002083802188825,0.0,0,1,fhi:git
county,Rogaland,2021-01-01,0,0,1,0,0.0002083802188825,0.0,0,1,fhi:git
county,Rogaland,2021-01-02,0,0,1,0,0.0002083802188825,0.0,0,1,fhi:git
county,Rogaland,2021-01-03,0,0,1,0,0.0002083802188825,0.0,0,1,fhi:git
county,Rogaland,2021-01-04,0,0,1,0,0.0002071916211708,0.0,0,1,fhi:git
county,Rogaland,2021-01-05,548,0,549,0,0.113748200022791,0.0,548,549,fhi:git
county,Rogaland,2021-01-06,641,0,1190,0,0.246558029193299,0.0,641,1190,fhi:git
county,Rogaland,2021-01-07,212,0,1402,0,0.290482652881517,0.0,212,1402,fhi:git
county,Rogaland,2021-01-08,20,0,1422,0,0.294626485304934,0.0,20,1422,fhi:git
county,Rogaland,2021-01-09,1,0,1423,0,0.294833676926105,0.0,1,1423,fhi:git
county,Rogaland,2021-01-10,0,0,1423,0,0.294833676926105,0.0,0,1423,fhi:git
county,Rogaland,2021-01-11,3,0,1426,0,0.295455251789618,0.0,3,1426,fhi:git
county,Rogaland,2021-01-12,117,0,1543,0,0.319696671466606,0.0,117,1543,fhi:git
county,Rogaland,2021-01-13,761,0,2304,0,0.477369495177615,0.0,761,2304,fhi:git
county,Rogaland,2021-01-14,535,0,2839,0,0.588217012504014,0.0,535,2839,fhi:git
county,Rogaland,2021-01-15,293,0,3132,0,0.648924157507071,0.0,293,3132,fhi:git
county,Rogaland,2021-01-16,0,0,3132,0,0.648924157507071,0.0,0,3132,fhi:git
county,Rogaland,2021-01-17,2,0,3134,0,0.649338540749412,0.0,2,3134,fhi:git
county,Rogaland,2021-01-18,71,0,3205,0,0.664049145852542,0.0,71,3205,fhi:git
county,Rogaland,2021-01-19,513,0,3718,0,0.770338447513183,0.0,513,3718,fhi:git
county,Rogaland,2021-01-20,657,0,4375,0,0.906463342622424,0.0,657,4375,fhi:git
county,Rogaland,2021-01-21,431,0,4806,0,0.995762931347056,0.0,431,4806,fhi:git
county,Rogaland,2021-01-22,272,0,5078,0,1.05211905230552,0.0,272,5078,fhi:git
county,Rogaland,2021-01-23,0,0,5078,0,1.05211905230552,0.0,0,5078,fhi:git
county,Rogaland,2021-01-24,0,0,5078,0,1.05211905230552,0.0,0,5078,fhi:git
county,Rogaland,2021-01-25,150,0,5228,0,1.08319779548115,0.0,150,5228,fhi:git
county,Rogaland,2021-01-26,339,381,5567,381,1.15343575505807,0.07894000766609,720,5948,fhi:git
county,Rogaland,2021-01-27,865,603,6432,984,1.33265650737084,0.203876555232106,1468,7416,fhi:git
county,Rogaland,2021-01-28,524,283,6956,1267,1.44122491686436,0.262511784023454,807,8223,fhi:git
county,Rogaland,2021-01-29,410,22,7366,1289,1.52617348154441,0.267069999689213,432,8655,fhi:git
county,Rogaland,2021-01-30,5,1,7371,1290,1.52720943965026,0.267277191310383,6,8661,fhi:git
county,Rogaland,2021-01-31,2,0,7373,1290,1.5276238228926,0.267277191310383,2,8663,fhi:git
county,Rogaland,2021-02-01,13,6,7386,1296,1.53031731396782,0.268520341037408,19,8682,fhi:git
county,Rogaland,2021-02-02,450,77,7836,1373,1.6235535434947,0.284474095867563,527,9209,fhi:git
county,Rogaland,2021-02-03,2431,635,10267,2008,2.12723637456101,0.416040775311046,3066,12275,fhi:git
county,Rogaland,2021-02-04,1887,561,12154,2569,2.51820696371039,0.532275274787888,2448,14723,fhi:git
county,Rogaland,2021-02-05,654,283,12808,2852,2.65371028395612,0.590910503579235,937,15660,fhi:git
county,Rogaland,2021-02-06,0,0,12808,2852,2.65371028395612,0.590910503579235,0,15660,fhi:git
county,Rogaland,2021-02-07,0,1,12808,2853,2.65371028395612,0.591117695200406,1,15661,fhi:git
county,Rogaland,2021-02-08,7,71,12815,2924,2.65516062530431,0.605828300303536,78,15739,fhi:git
county,Rogaland,2021-02-09,588,395,13403,3319,2.77698929855277,0.687668990666018,983,16722,fhi:git
county,Rogaland,2021-02-10,1923,684,15326,4003,3.17541878606429,0.829388059546872,2607,19329,fhi:git
county,Rogaland,2021-02-11,1181,497,16507,4500,3.42011209066705,0.932362295268779,1678,21007,fhi:git
county,Rogaland,2021-02-12,482,268,16989,4768,3.5199784520714,0.987889649742564,750,21757,fhi:git
county,Rogaland,2021-02-13,1,0,16990,4768,3.52018564369257,0.987889649742564,1,21758,fhi:git
county,Rogaland,2021-02-14,0,0,16990,4768,3.52018564369257,0.987889649742564,0,21758,fhi:git
county,Rogaland,2021-02-15,0,147,16990,4915,3.52018564369257,1.01834681805468,147,21905,fhi:git
county,Rogaland,2021-02-16,480,315,17470,5230,3.61963762185457,1.08361217872349,795,22700,fhi:git
county,Rogaland,2021-02-17,1488,783,18958,6013,3.92793875415678,1.24584321810026,2271,24971,fhi:git
county,Rogaland,2021-02-18,1101,472,20059,6485,4.15605672906588,1.3436376632929,1573,26544,fhi:git
county,Rogaland,2021-02-19,442,411,20501,6896,4.24763542562339,1.42879341959411,853,27397,fhi:git
county,Rogaland,2021-02-20,1,3,20502,6899,4.24784261724456,1.42941499445762,4,27401,fhi:git
county,Rogaland,2021-02-21,0,2,20502,6901,4.24784261724456,1.42982937769997,2,27403,fhi:git
county,Rogaland,2021-02-22,252,13,20754,6914,4.30005490577961,1.43252286877519,265,27668,fhi:git
county,Rogaland,2021-02-23,379,407,21133,7321,4.37858053020336,1.51684985859172,786,28454,fhi:git
county,Rogaland,2021-02-24,821,2168,21954,9489,4.54868485118462,1.9660412932901,2989,31443,fhi:git
county,Rogaland,2021-02-25,1229,1813,23183,11302,4.80332335360358,2.34167970247283,3042,34485,fhi:git
county,Rogaland,2021-02-26,999,674,24182,11976,5.01030778315325,2.48132685514198,1673,36158,fhi:git
county,Rogaland,2021-02-27,1,1,24183,11977,5.01051497477442,2.48153404676315,2,36160,fhi:git
county,Rogaland,2021-02-28,4,0,24187,11977,5.0113437412591,2.48153404676315,4,36164,fhi:git
county,Rogaland,2021-03-01,648,2,24835,11979,5.14560391177781,2.48194843000549,650,36814,fhi:git
county,Rogaland,2021-03-02,794,545,25629,12524,5.31011405898745,2.5948678635436,1339,38153,fhi:git
county,Rogaland,2021-03-03,1269,1460,26898,13984,5.57304022625325,2.89736763045302,2729,40882,fhi:git
county,Rogaland,2021-03-04,1089,1478,27987,15462,5.7986719017083,3.20359684654353,2567,43449,fhi:git
county,Rogaland,2021-03-05,590,424,28577,15886,5.92091495819909,3.29144609391996,1014,44463,fhi:git
county,Rogaland,2021-03-06,4,1,28581,15887,5.92174372468377,3.29165328554113,5,44468,fhi:git
county,Rogaland,2021-03-07,0,0,28581,15887,5.92174372468377,3.29165328554113,0,44468,fhi:git
county,Rogaland,2021-03-08,542,0,29123,15887,6.03404158335837,3.29165328554113,542,45010,fhi:git
county,Rogaland,2021-03-09,1567,466,30690,16353,6.35871085373308,3.38820458100674,2033,47043,fhi:git
county,Rogaland,2021-03-10,2133,1079,32823,17432,6.80065058169048,3.61176434025008,3212,50255,fhi:git
county,Rogaland,2021-03-11,1400,1057,34223,18489,7.09071885132965,3.83076588382766,2457,52712,fhi:git
county,Rogaland,2021-03-12,117,545,34340,19034,7.11496027100664,3.94368531736577,662,53374,fhi:git
county,Rogaland,2021-03-13,0,0,34340,19034,7.11496027100664,3.94368531736577,0,53374,fhi:git
county,Rogaland,2021-03-14,0,0,34340,19034,7.11496027100664,3.94368531736577,0,53374,fhi:git
county,Rogaland,2021-03-15,0,1,34340,19035,7.11496027100664,3.94389250898694,1,53375,fhi:git
county,Rogaland,2021-03-16,584,93,34924,19128,7.23596017777041,3.96316132975582,677,54052,fhi:git
county,Rogaland,2021-03-17,2397,95,37321,19223,7.73259849371691,3.98284453376705,2492,56544,fhi:git
county,Rogaland,2021-03-18,1676,83,38997,19306,8.07985165079924,4.00004143832423,1759,58303,fhi:git
county,Rogaland,2021-03-19,273,25,39270,19331,8.13641496337888,4.00522122885351,298,58601,fhi:git
county,Rogaland,2021-03-20,0,0,39270,19331,8.13641496337888,4.00522122885351,0,58601,fhi:git
county,Rogaland,2021-03-21,0,0,39270,19331,8.13641496337888,4.00522122885351,0,58601,fhi:git
county,Rogaland,2021-03-22,12,17,39282,19348,8.13890126283293,4.00874348641341,29,58630,fhi:git
county,Rogaland,2021-03-23,829,48,40111,19396,8.31066311678356,4.01868868422961,877,59507,fhi:git
county,Rogaland,2021-03-24,3405,80,43516,19476,9.01615058687027,4.03526401392328,3485,62992,fhi:git
county,Rogaland,2021-03-25,3236,166,46752,19642,9.68662267297911,4.06965782303764,3402,66394,fhi:git
county,Rogaland,2021-03-26,806,77,47558,19719,9.8536191196428,4.08561157786779,883,67277,fhi:git
county,Rogaland,2021-03-27,0,0,47558,19719,9.8536191196428,4.08561157786779,0,67277,fhi:git
county,Rogaland,2021-03-28,1,2,47559,19721,9.85382631126397,4.08602596111013,3,67280,fhi:git
county,Rogaland,2021-03-29,233,0,47792,19721,9.90210195899678,4.08602596111013,233,67513,fhi:git
county,Rogaland,2021-03-30,4222,356,52014,20077,10.7768649835801,4.15978617824695,4578,72091,fhi:git
county,Rogaland,2021-03-31,2183,621,54197,20698,11.229164292596,4.28845217499404,2804,74895,fhi:git
county,Rogaland,2021-04-01,569,1,54766,20699,11.3470563250422,4.28865936661521,570,75465,fhi:git
county,Rogaland,2021-04-02,10,21,54776,20720,11.3491282412539,4.2930103906598,31,75496,fhi:git
county,Rogaland,2021-04-03,0,0,54776,20720,11.3491282412539,4.2930103906598,0,75496,fhi:git
county,Rogaland,2021-04-04,0,0,54776,20720,11.3491282412539,4.2930103906598,0,75496,fhi:git
county,Rogaland,2021-04-05,0,0,54776,20720,11.3491282412539,4.2930103906598,0,75496,fhi:git
county,Rogaland,2021-04-06,1372,77,56148,20797,11.6333951455003,4.30896414548996,1449,76945,fhi:git
county,Rogaland,2021-04-07,5904,117,62052,20914,12.856654476893,4.33320556516695,6021,82966,fhi:git
county,Rogaland,2021-04-08,5148,531,67200,21445,13.9232769426804,4.44322431600866,5679,88645,fhi:git
county,Rogaland,2021-04-09,1866,35,69066,21480,14.3098965077852,4.45047602274964,1901,90546,fhi:git
county,Rogaland,2021-04-10,5,1,69071,21481,14.3109324658911,4.45068321437081,6,90552,fhi:git
county,Rogaland,2021-04-11,0,0,69071,21481,14.3109324658911,4.45068321437081,0,90552,fhi:git
county,Rogaland,2021-04-12,13,13,69084,21494,14.3136259569663,4.45337670544603,26,90578,fhi:git
county,Rogaland,2021-04-13,1558,30,70642,21524,14.6364305027505,4.45959245408116,1588,92166,fhi:git
county,Troms og Finnmark,2020-12-27,0,0,0,0,0.0,0.0,0,0,fhi:git
county,Troms og Finnmark,2020-12-28,1,0,1,0,0.0004109966257177,0.0,1,1,fhi:git
county,Troms og Finnmark,2020-12-29,0,0,1,0,0.0004109966257177,0.0,0,1,fhi:git
county,Troms og Finnmark,2020-12-30,0,0,1,0,0.0004109966257177,0.0,0,1,fhi:git
county,Troms og Finnmark,2020-12-31,0,0,1,0,0.0004109966257177,0.0,0,1,fhi:git
county,Troms og Finnmark,2021-01-01,0,0,1,0,0.0004109966257177,0.0,0,1,fhi:git
county,Troms og Finnmark,2021-01-02,0,0,1,0,0.0004109966257177,0.0,0,1,fhi:git
county,Troms og Finnmark,2021-01-03,0,0,1,0,0.0004109966257177,0.0,0,1,fhi:git
county,Troms og Finnmark,2021-01-04,0,0,1,0,0.0004129364738528,0.0,0,1,fhi:git
county,Troms og Finnmark,2021-01-05,53,0,54,0,0.0222985695880546,0.0,53,54,fhi:git
county,Troms og Finnmark,2021-01-06,530,0,584,0,0.241154900730072,0.0,530,584,fhi:git
county,Troms og Finnmark,2021-01-07,188,0,772,0,0.31878695781441,0.0,188,772,fhi:git
county,Troms og Finnmark,2021-01-08,247,0,1019,0,0.420782266856067,0.0,247,1019,fhi:git
county,Troms og Finnmark,2021-01-09,0,0,1019,0,0.420782266856067,0.0,0,1019,fhi:git
county,Troms og Finnmark,2021-01-10,0,0,1019,0,0.420782266856067,0.0,0,1019,fhi:git
county,Troms og Finnmark,2021-01-11,0,0,1019,0,0.420782266856067,0.0,0,1019,fhi:git
county,Troms og Finnmark,2021-01-12,191,0,1210,0,0.499653133361964,0.0,191,1210,fhi:git
county,Troms og Finnmark,2021-01-13,569,0,1779,0,0.734613986984242,0.0,569,1779,fhi:git
county,Troms og Finnmark,2021-01-14,330,0,2109,0,0.870883023355687,0.0,330,2109,fhi:git
county,Troms og Finnmark,2021-01-15,37,0,2146,0,0.886161672888243,0.0,37,2146,fhi:git
county,Troms og Finnmark,2021-01-16,2,0,2148,0,0.886987545835949,0.0,2,2148,fhi:git
county,Troms og Finnmark,2021-01-17,0,0,2148,0,0.886987545835949,0.0,0,2148,fhi:git
county,Troms og Finnmark,2021-01-18,0,1,2148,1,0.886987545835949,0.0004129364738528,1,2149,fhi:git
county,Troms og Finnmark,2021-01-19,251,0,2399,1,0.990634600773017,0.0004129364738528,251,2400,fhi:git
county,Troms og Finnmark,2021-01-20,923,0,3322,1,1.37177496613921,0.0004129364738528,923,3323,fhi:git
county,Troms og Finnmark,2021-01-21,248,0,3570,1,1.47418321165472,0.0004129364738528,248,3571,fhi:git
county,Troms og Finnmark,2021-01-22,82,0,3652,1,1.50804400251065,0.0004129364738528,82,3653,fhi:git
county,Troms og Finnmark,2021-01-23,12,0,3664,1,1.51299924019689,0.0004129364738528,12,3665,fhi:git
county,Troms og Finnmark,2021-01-24,0,0,3664,1,1.51299924019689,0.0004129364738528,0,3665,fhi:git
county,Troms og Finnmark,2021-01-25,6,0,3670,1,1.51547685904001,0.0004129364738528,6,3671,fhi:git
county,Troms og Finnmark,2021-01-26,85,0,3755,1,1.5505764593175,0.0004129364738528,85,3756,fhi:git
county,Troms og Finnmark,2021-01-27,667,357,4422,358,1.82600508737736,0.147831257639325,1024,4780,fhi:git
county,Troms og Finnmark,2021-01-28,234,276,4656,634,1.92263222225893,0.261801724422715,510,5290,fhi:git
county,Troms og Finnmark,2021-01-29,104,243,4760,877,1.96557761553963,0.36214528756896,347,5637,fhi:git
county,Troms og Finnmark,2021-01-30,0,0,4760,877,1.96557761553963,0.36214528756896,0,5637,fhi:git
county,Troms og Finnmark,2021-01-31,0,0,4760,877,1.96557761553963,0.36214528756896,0,5637,fhi:git
county,Troms og Finnmark,2021-02-01,0,1,4760,878,1.96557761553963,0.362558224042813,1,5638,fhi:git
county,Troms og Finnmark,2021-02-02,119,24,4879,902,2.01471705592812,0.372468699415282,143,5781,fhi:git
county,Troms og Finnmark,2021-02-03,1160,562,6039,1464,2.49372336559744,0.604538997720591,1722,7503,fhi:git
county,Troms og Finnmark,2021-02-04,1149,380,7188,1844,2.96818737405438,0.761454857784678,1529,9032,fhi:git
county,Troms og Finnmark,2021-02-05,287,140,7475,1984,3.08670014205015,0.819265964124079,427,9459,fhi:git
county,Troms og Finnmark,2021-02-06,1,1,7476,1985,3.087113078524,0.819678900597932,2,9461,fhi:git
county,Troms og Finnmark,2021-02-07,0,0,7476,1985,3.087113078524,0.819678900597932,0,9461,fhi:git
county,Troms og Finnmark,2021-02-08,0,0,7476,1985,3.087113078524,0.819678900597932,0,9461,fhi:git
county,Troms og Finnmark,2021-02-09,71,29,7547,2014,3.11643156816755,0.831654058339665,100,9561,fhi:git
county,Troms og Finnmark,2021-02-10,1408,813,8955,2827,3.69784612335238,1.16737141158204,2221,11782,fhi:git
county,Troms og Finnmark,2021-02-11,995,466,9950,3293,4.10871791483598,1.35979980839748,1461,13243,fhi:git
county,Troms og Finnmark,2021-02-12,293,114,10243,3407,4.22970830167487,1.4068745664167,407,13650,fhi:git
county,Troms og Finnmark,2021-02-13,5,2,10248,3409,4.23177298404413,1.40770043936441,7,13657,fhi:git
county,Troms og Finnmark,2021-02-14,0,0,10248,3409,4.23177298404413,1.40770043936441,0,13657,fhi:git
county,Troms og Finnmark,2021-02-15,0,6,10248,3415,4.23177298404413,1.41017805820753,6,13663,fhi:git
county,Troms og Finnmark,2021-02-16,133,52,10381,3467,4.28669353506657,1.43165075484787,185,13848,fhi:git
county,Troms og Finnmark,2021-02-17,969,582,11350,4049,4.68682897822999,1.67197978263024,1551,15399,fhi:git
county,Troms og Finnmark,2021-02-18,1297,262,12647,4311,5.22240758481715,1.78016913877969,1559,16958,fhi:git
county,Troms og Finnmark,2021-02-19,232,133,12879,4444,5.31820884675102,1.83508968980212,365,17323,fhi:git
county,Troms og Finnmark,2021-02-20,0,0,12879,4444,5.31820884675102,1.83508968980212,0,17323,fhi:git
county,Troms og Finnmark,2021-02-21,0,0,12879,4444,5.31820884675102,1.83508968980212,0,17323,fhi:git
county,Troms og Finnmark,2021-02-22,107,0,12986,4444,5.36239304945327,1.83508968980212,107,17430,fhi:git
county,Troms og Finnmark,2021-02-23,79,78,13065,4522,5.39501503088765,1.86729873476264,157,17587,fhi:git
county,Troms og Finnmark,2021-02-24,430,993,13495,5515,5.57257771464438,2.27734465329854,1423,19010,fhi:git
county,Troms og Finnmark,2021-02-25,567,1055,14062,6570,5.80671269531895,2.71299263321331,1622,20632,fhi:git
county,Troms og Finnmark,2021-02-26,282,405,14344,6975,5.92316078094546,2.88023190512372,687,21319,fhi:git
county,Troms og Finnmark,2021-02-27,0,0,14344,6975,5.92316078094546,2.88023190512372,0,21319,fhi:git
county,Troms og Finnmark,2021-02-28,3,0,14347,6975,5.92439959036702,2.88023190512372,3,21322,fhi:git
county,Troms og Finnmark,2021-03-01,340,0,14687,6975,6.06479799147699,2.88023190512372,340,21662,fhi:git
county,Troms og Finnmark,2021-03-02,554,72,15241,7047,6.29356479799148,2.90996333124112,626,22288,fhi:git
county,Troms og Finnmark,2021-03-03,599,1179,15840,8226,6.54091374582934,3.39681543391365,1778,24066,fhi:git
county,Troms og Finnmark,2021-03-04,879,933,16719,9159,6.90388490634601,3.78208516401837,1812,25878,fhi:git
county,Troms og Finnmark,2021-03-05,705,374,17424,9533,7.19500512041228,3.93652340523934,1079,26957,fhi:git
county,Troms og Finnmark,2021-03-06,0,1,17424,9534,7.19500512041228,3.93693634171319,1,26958,fhi:git
county,Troms og Finnmark,2021-03-07,0,0,17424,9534,7.19500512041228,3.93693634171319,0,26958,fhi:git
county,Troms og Finnmark,2021-03-08,423,0,17847,9534,7.36967724885204,3.93693634171319,423,27381,fhi:git
county,Troms og Finnmark,2021-03-09,623,51,18470,9585,7.62693667206237,3.95799610187969,674,28055,fhi:git
county,Troms og Finnmark,2021-03-10,939,698,19409,10283,8.01468402101021,4.24622576062898,1637,29692,fhi:git
county,Troms og Finnmark,2021-03-11,806,1041,20215,11324,8.34751081893561,4.67609262990982,1847,31539,fhi:git
county,Troms og Finnmark,2021-03-12,68,209,20283,11533,8.37559049915761,4.76239635294506,277,31816,fhi:git
county,Troms og Finnmark,2021-03-13,0,0,20283,11533,8.37559049915761,4.76239635294506,0,31816,fhi:git
county,Troms og Finnmark,2021-03-14,0,0,20283,11533,8.37559049915761,4.76239635294506,0,31816,fhi:git
county,Troms og Finnmark,2021-03-15,2,5,20285,11538,8.37641637210531,4.76446103531433,7,31823,fhi:git
county,Troms og Finnmark,2021-03-16,19,2,20304,11540,8.38426216510852,4.76528690826203,21,31844,fhi:git
county,Troms og Finnmark,2021-03-17,546,45,20850,11585,8.60972547983218,4.78386904958541,591,32435,fhi:git
county,Troms og Finnmark,2021-03-18,1111,122,21961,11707,9.06849790228271,4.83424729939546,1233,33668,fhi:git
county,Troms og Finnmark,2021-03-19,406,33,22367,11740,9.23615011066698,4.84787420303261,439,34107,fhi:git
county,Troms og Finnmark,2021-03-20,0,0,22367,11740,9.23615011066698,4.84787420303261,0,34107,fhi:git
county,Troms og Finnmark,2021-03-21,1,0,22368,11740,9.23656304714083,4.84787420303261,1,34108,fhi:git
county,Troms og Finnmark,2021-03-22,3,0,22371,11740,9.23780185656239,4.84787420303261,3,34111,fhi:git
county,Troms og Finnmark,2021-03-23,429,14,22800,11754,9.41495160384526,4.85365531366655,443,34554,fhi:git
county,Troms og Finnmark,2021-03-24,1875,42,24675,11796,10.1892074923194,4.87099864556837,1917,36471,fhi:git
county,Troms og Finnmark,2021-03-25,1993,38,26668,11834,11.0121898847081,4.88669023157477,2031,38502,fhi:git
county,Troms og Finnmark,2021-03-26,557,15,27225,11849,11.2421955006442,4.89288427868257,572,39074,fhi:git
county,Troms og Finnmark,2021-03-27,1,0,27226,11849,11.242608437118,4.89288427868257,1,39075,fhi:git
county,Troms og Finnmark,2021-03-28,0,0,27226,11849,11.242608437118,4.89288427868257,0,39075,fhi:git
county,Troms og Finnmark,2021-03-29,176,0,27402,11849,11.3152852565161,4.89288427868257,176,39251,fhi:git
county,Troms og Finnmark,2021-03-30,1620,149,29022,11998,11.9842423441578,4.95441181328664,1769,41020,fhi:git
county,Troms og Finnmark,2021-03-31,1429,290,30451,12288,12.5743285652935,5.07416339070397,1719,42739,fhi:git
county,Troms og Finnmark,2021-04-01,165,35,30616,12323,12.6424630834792,5.08861616728883,200,42939,fhi:git
county,Troms og Finnmark,2021-04-02,27,14,30643,12337,12.6536123682733,5.09439727792277,41,42980,fhi:git
county,Troms og Finnmark,2021-04-03,1,0,30644,12337,12.6540253047471,5.09439727792277,1,42981,fhi:git
county,Troms og Finnmark,2021-04-04,0,0,30644,12337,12.6540253047471,5.09439727792277,0,42981,fhi:git
county,Troms og Finnmark,2021-04-05,0,0,30644,12337,12.6540253047471,5.09439727792277,0,42981,fhi:git
county,Troms og Finnmark,2021-04-06,719,13,31363,12350,12.9509266294473,5.09976545208285,732,43713,fhi:git
county,Troms og Finnmark,2021-04-07,2671,60,34034,12410,14.0538799511083,5.12454164051402,2731,46444,fhi:git
county,Troms og Finnmark,2021-04-08,2496,320,36530,12730,15.0845693898451,5.25668131214694,2816,49260,fhi:git
county,Troms og Finnmark,2021-04-09,1995,61,38525,12791,15.9083776551815,5.28187043705196,2056,51316,fhi:git
county,Troms og Finnmark,2021-04-10,2,1,38527,12792,15.9092035281292,5.28228337352582,3,51319,fhi:git
county,Troms og Finnmark,2021-04-11,1,0,38528,12792,15.9096164646031,5.28228337352582,1,51320,fhi:git
county,Troms og Finnmark,2021-04-12,2,4,38530,12796,15.9104423375508,5.28393511942123,6,51326,fhi:git
county,Troms og Finnmark,2021-04-13,502,17,39032,12813,16.1177364474249,5.29095503947673,519,51845,fhi:git
county,Trøndelag,2020-12-27,0,0,0,0,0.0,0.0,0,0,fhi:git
county,Trøndelag,2020-12-28,0,0,0,0,0.0,0.0,0,0,fhi:git
county,Trøndelag,2020-12-29,0,0,0,0,0.0,0.0,0,0,fhi:git
county,Trøndelag,2020-12-30,0,0,0,0,0.0,0.0,0,0,fhi:git
county,Trøndelag,2020-12-31,0,0,0,0,0.0,0.0,0,0,fhi:git
county,Trøndelag,2021-01-01,0,0,0,0,0.0,0.0,0,0,fhi:git
county,Trøndelag,2021-01-02,0,0,0,0,0.0,0.0,0,0,fhi:git
county,Trøndelag,2021-01-03,0,0,0,0,0.0,0.0,0,0,fhi:git
county,Trøndelag,2021-01-04,3,0,3,0,0.0006367750316264,0.0,3,3,fhi:git
county,Trøndelag,2021-01-05,407,0,410,0,0.0870259209889541,0.0,407,410,fhi:git
county,Trøndelag,2021-01-06,675,0,1085,0,0.230300303104915,0.0,675,1085,fhi:git
county,Trøndelag,2021-01-07,483,0,1568,0,0.332821083196781,0.0,483,1568,fhi:git
county,Trøndelag,2021-01-08,141,0,1709,0,0.362749509683226,0.0,141,1709,fhi:git
county,Trøndelag,2021-01-09,0,0,1709,0,0.362749509683226,0.0,0,1709,fhi:git
county,Trøndelag,2021-01-10,0,0,1709,0,0.362749509683226,0.0,0,1709,fhi:git
county,Trøndelag,2021-01-11,95,0,1804,0,0.382914052351398,0.0,95,1804,fhi:git
county,Trøndelag,2021-01-12,500,0,2304,0,0.489043224289147,0.0,500,2304,fhi:git
county,Trøndelag,2021-01-13,861,0,3165,0,0.67179765836595,0.0,861,3165,fhi:git
county,Trøndelag,2021-01-14,671,0,3836,0,0.81422300710641,0.0,671,3836,fhi:git
county,Trøndelag,2021-01-15,253,0,4089,0,0.86792436810691,0.0,253,4089,fhi:git
county,Trøndelag,2021-01-16,0,0,4089,0,0.86792436810691,0.0,0,4089,fhi:git
county,Trøndelag,2021-01-17,0,0,4089,0,0.86792436810691,0.0,0,4089,fhi:git
county,Trøndelag,2021-01-18,152,0,4241,0,0.900187636375986,0.0,152,4241,fhi:git
county,Trøndelag,2021-01-19,568,0,4809,0,1.02075037569727,0.0,568,4809,fhi:git
county,Trøndelag,2021-01-20,738,0,5547,0,1.17739703347739,0.0,738,5547,fhi:git
county,Trøndelag,2021-01-21,535,0,6082,0,1.29095524745078,0.0,535,6082,fhi:git
county,Trøndelag,2021-01-22,283,0,6365,0,1.35102435876754,0.0,283,6365,fhi:git
county,Trøndelag,2021-01-23,1,0,6366,0,1.35123661711142,0.0,1,6366,fhi:git
county,Trøndelag,2021-01-24,0,0,6366,0,1.35123661711142,0.0,0,6366,fhi:git
county,Trøndelag,2021-01-25,1,0,6367,0,1.35144887545529,0.0,1,6367,fhi:git
county,Trøndelag,2021-01-26,313,184,6680,184,1.41788573708833,0.0390555352730916,497,6864,fhi:git
county,Trøndelag,2021-01-27,1013,605,7693,789,1.6329034394342,0.167471833317768,1618,8482,fhi:git
county,Trøndelag,2021-01-28,727,483,8420,1272,1.78721525543169,0.269992613409633,1210,9692,fhi:git
county,Trøndelag,2021-01-29,423,229,8843,1501,1.87700053489103,0.318599774157122,652,10344,fhi:git
county,Trøndelag,2021-01-30,1,0,8844,1501,1.8772127932349,0.318599774157122,1,10345,fhi:git
county,Trøndelag,2021-01-31,2,1,8846,1502,1.87763730992265,0.318812032500998,3,10348,fhi:git
county,Trøndelag,2021-02-01,14,86,8860,1588,1.88060892673691,0.33706625007429,100,10448,fhi:git
county,Trøndelag,2021-02-02,836,392,9696,1980,2.05805690221683,0.420271520873485,1228,11676,fhi:git
county,Trøndelag,2021-02-03,2124,811,11820,2791,2.50889362460838,0.592413037756514,2935,14611,fhi:git
county,Trøndelag,2021-02-04,2144,607,13964,3398,2.96397551387745,0.721253852488941,2751,17362,fhi:git
county,Trøndelag,2021-02-05,1292,320,15256,3718,3.23821329416459,0.789176522529101,1612,18974,fhi:git
county,Trøndelag,2021-02-06,7,0,15263,3718,3.23969910257172,0.789176522529101,7,18981,fhi:git
county,Trøndelag,2021-02-07,1,0,15264,3718,3.2399113609156,0.789176522529101,1,18982,fhi:git
county,Trøndelag,2021-02-08,3,150,15267,3868,3.24054813594722,0.821015274110425,153,19135,fhi:git
county,Trøndelag,2021-02-09,836,523,16103,4391,3.41799611142714,0.932026387957311,1359,20494,fhi:git
county,Trøndelag,2021-02-10,2232,628,18335,5019,3.89175673495725,1.06532462791112,2860,23354,fhi:git
county,Trøndelag,2021-02-11,2362,586,20697,5605,4.39311094319118,1.18970801742216,2948,26302,fhi:git
county,Trøndelag,2021-02-12,888,352,21585,5957,4.58159635255262,1.26442295446634,1240,27542,fhi:git
county,Trøndelag,2021-02-13,2,0,21587,5957,4.58202086924037,1.26442295446634,2,27544,fhi:git
county,Trøndelag,2021-02-14,0,0,21587,5957,4.58202086924037,1.26442295446634,0,27544,fhi:git
county,Trøndelag,2021-02-15,0,2,21587,5959,4.58202086924037,1.26484747115409,2,27546,fhi:git
county,Trøndelag,2021-02-16,345,210,21932,6169,4.65524999787742,1.30942172336795,555,28101,fhi:git
county,Trøndelag,2021-02-17,2224,922,24156,7091,5.12731255465652,1.50512391642115,3146,31247,fhi:git
county,Trøndelag,2021-02-18,2121,752,26277,7843,5.57751250201646,1.66474219101553,2873,34120,fhi:git
county,Trøndelag,2021-02-19,1262,410,27539,8253,5.84538253198733,1.75176811200448,1672,35792,fhi:git
county,Trøndelag,2021-02-20,1,1,27540,8254,5.84559479033121,1.75198037034836,2,35794,fhi:git
county,Trøndelag,2021-02-21,0,4,27540,8258,5.84559479033121,1.75282940372386,4,35798,fhi:git
county,Trøndelag,2021-02-22,17,2,27557,8260,5.84920318217709,1.75325392041161,19,35817,fhi:git
county,Trøndelag,2021-02-23,334,674,27891,8934,5.92009746903151,1.8963160441837,1008,36825,fhi:git
county,Trøndelag,2021-02-24,1011,2046,28902,10980,6.13469065468964,2.33059661575297,3057,39882,fhi:git
county,Trøndelag,2021-02-25,474,1983,29376,12963,6.23530110968662,2.75150491165808,2457,42339,fhi:git
county,Trøndelag,2021-02-26,618,1154,29994,14117,6.36647676620168,2.9964510404904,1772,44111,fhi:git
county,Trøndelag,2021-02-27,4,1,29998,14118,6.36732579957718,2.99666329883428,5,44116,fhi:git
county,Trøndelag,2021-02-28,1,0,29999,14118,6.36753805792106,2.99666329883428,1,44117,fhi:git
county,Trøndelag,2021-03-01,526,0,30525,14118,6.47918594679957,2.99666329883428,526,44643,fhi:git
county,Trøndelag,2021-03-02,819,785,31344,14903,6.6530255304336,3.16328609877654,1604,46247,fhi:git
county,Trøndelag,2021-03-03,2043,2142,33387,17045,7.08666932697124,3.61794347135786,4185,50432,fhi:git
county,Trøndelag,2021-03-04,1875,2282,35262,19327,7.4846537217378,4.10231701208174,4157,54589,fhi:git
county,Trøndelag,2021-03-05,1049,982,36311,20309,7.7073127244632,4.31075470576748,2031,56620,fhi:git
county,Trøndelag,2021-03-06,2,0,36313,20309,7.70773724115095,4.31075470576748,2,56622,fhi:git
county,Trøndelag,2021-03-07,0,1,36313,20310,7.70773724115095,4.31096696411136,1,56623,fhi:git
county,Trøndelag,2021-03-08,435,0,36748,20310,7.80006962073679,4.31096696411136,435,57058,fhi:git
county,Trøndelag,2021-03-09,1172,301,37920,20611,8.04883639975888,4.37485672561788,1473,58531,fhi:git
county,Trøndelag,2021-03-10,1687,1500,39607,22111,8.40691622587684,4.69324424143113,3187,61718,fhi:git
county,Trøndelag,2021-03-11,824,1207,40431,23318,8.58181710123025,4.94944006248886,2031,63749,fhi:git
county,Trøndelag,2021-03-12,122,500,40553,23818,8.60771261918306,5.05556923442661,622,64371,fhi:git
county,Trøndelag,2021-03-13,0,1,40553,23819,8.60771261918306,5.05578149277048,1,64372,fhi:git
county,Trøndelag,2021-03-14,0,0,40553,23819,8.60771261918306,5.05578149277048,0,64372,fhi:git
county,Trøndelag,2021-03-15,3,6,40556,23825,8.60834939421469,5.05705504283373,9,64381,fhi:git
county,Trøndelag,2021-03-16,607,12,41163,23837,8.73719020894711,5.05960214296024,619,65000,fhi:git
county,Trøndelag,2021-03-17,1979,122,43142,23959,9.15724947147672,5.08549766091305,2101,67101,fhi:git
county,Trøndelag,2021-03-18,1500,123,44642,24082,9.47563698728997,5.11160543720974,1623,68724,fhi:git
county,Trøndelag,2021-03-19,542,88,45184,24170,9.59068100967049,5.13028417147078,630,69354,fhi:git
county,Trøndelag,2021-03-20,0,0,45184,24170,9.59068100967049,5.13028417147078,0,69354,fhi:git
county,Trøndelag,2021-03-21,0,0,45184,24170,9.59068100967049,5.13028417147078,0,69354,fhi:git
county,Trøndelag,2021-03-22,1,0,45185,24170,9.59089326801437,5.13028417147078,1,69355,fhi:git
county,Trøndelag,2021-03-23,1046,216,46231,24386,9.81291549570814,5.17613197374789,1262,70617,fhi:git
county,Trøndelag,2021-03-24,3150,569,49381,24955,10.481529278916,5.29690697141305,3719,74336,fhi:git
county,Trøndelag,2021-03-25,2885,304,52266,25259,11.0938946009968,5.3614335079512,3189,77525,fhi:git
county,Trøndelag,2021-03-26,1985,227,54251,25486,11.5152274135896,5.40961615201094,2212,79737,fhi:git
county,Trøndelag,2021-03-27,0,3,54251,25489,11.5152274135896,5.41025292704256,3,79740,fhi:git
county,Trøndelag,2021-03-28,0,0,54251,25489,11.5152274135896,5.41025292704256,0,79740,fhi:git
county,Trøndelag,2021-03-29,3,0,54254,25489,11.5158641886213,5.41025292704256,3,79743,fhi:git
county,Trøndelag,2021-03-30,1875,535,56129,26024,11.9138485833878,5.52381114101595,2410,82153,fhi:git
county,Trøndelag,2021-03-31,2568,422,58697,26446,12.4589280104601,5.61338416213141,2990,85143,fhi:git
county,Trøndelag,2021-04-01,163,156,58860,26602,12.4935261205118,5.64649646377599,319,85462,fhi:git
county,Trøndelag,2021-04-02,157,95,59017,26697,12.5268506805003,5.66666100644416,252,85714,fhi:git
county,Trøndelag,2021-04-03,0,0,59017,26697,12.5268506805003,5.66666100644416,0,85714,fhi:git
county,Trøndelag,2021-04-04,0,0,59017,26697,12.5268506805003,5.66666100644416,0,85714,fhi:git
county,Trøndelag,2021-04-05,1,0,59018,26697,12.5270629388441,5.66666100644416,1,85715,fhi:git
county,Trøndelag,2021-04-06,2092,41,61110,26738,12.9711073942317,5.67536359854306,2133,87848,fhi:git
county,Trøndelag,2021-04-07,4434,229,65544,26967,13.9122608909756,5.72397075929055,4663,92511,fhi:git
county,Trøndelag,2021-04-08,4725,115,70269,27082,14.9151815657874,5.74838046883623,4840,97351,fhi:git
county,Trøndelag,2021-04-09,2600,32,72869,27114,15.4670532598636,5.75517273584025,2632,99983,fhi:git
county,Trøndelag,2021-04-10,0,0,72869,27114,15.4670532598636,5.75517273584025,0,99983,fhi:git
county,Trøndelag,2021-04-11,0,0,72869,27114,15.4670532598636,5.75517273584025,0,99983,fhi:git
county,Trøndelag,2021-04-12,277,4,73146,27118,15.5258488211172,5.75602176921575,281,100264,fhi:git
county,Trøndelag,2021-04-13,1371,8,74517,27126,15.8168550105705,5.75771983596675,1379,101643,fhi:git
county,Vestfold og Telemark,2020-12-27,0,0,0,0,0.0,0.0,0,0,fhi:git
county,Vestfold og Telemark,2020-12-28,0,0,0,0,0.0,0.0,0,0,fhi:git
county,Vestfold og Telemark,2020-12-29,0,0,0,0,0.0,0.0,0,0,fhi:git
county,Vestfold og Telemark,2020-12-30,0,0,0,0,0.0,0.0,0,0,fhi:git
county,Vestfold og Telemark,2020-12-31,0,0,0,0,0.0,0.0,0,0,fhi:git
county,Vestfold og Telemark,2021-01-01,0,0,0,0,0.0,0.0,0,0,fhi:git
county,Vestfold og Telemark,2021-01-02,0,0,0,0,0.0,0.0,0,0,fhi:git
county,Vestfold og Telemark,2021-01-03,0,0,0,0,0.0,0.0,0,0,fhi:git
county,Vestfold og Telemark,2021-01-04,1,0,1,0,0.0002370331040433,0.0,1,1,fhi:git
county,Vestfold og Telemark,2021-01-05,218,0,219,0,0.051910249785485,0.0,218,219,fhi:git
county,Vestfold og Telemark,2021-01-06,1026,0,1245,0,0.295106214533922,0.0,1026,1245,fhi:git
county,Vestfold og Telemark,2021-01-07,442,0,1687,0,0.399874846521065,0.0,442,1687,fhi:git
county,Vestfold og Telemark,2021-01-08,63,0,1750,0,0.414807932075794,0.0,63,1750,fhi:git
county,Vestfold og Telemark,2021-01-09,0,0,1750,0,0.414807932075794,0.0,0,1750,fhi:git
county,Vestfold og Telemark,2021-01-10,3,0,1753,0,0.415519031387924,0.0,3,1753,fhi:git
county,Vestfold og Telemark,2021-01-11,3,0,1756,0,0.416230130700054,0.0,3,1756,fhi:git
county,Vestfold og Telemark,2021-01-12,420,0,2176,0,0.515784034398244,0.0,420,2176,fhi:git
county,Vestfold og Telemark,2021-01-13,1164,0,3340,0,0.791690567504658,0.0,1164,3340,fhi:git
county,Vestfold og Telemark,2021-01-14,584,0,3924,0,0.930117900265951,0.0,584,3924,fhi:git
county,Vestfold og Telemark,2021-01-15,157,0,4081,0,0.967332097600751,0.0,157,4081,fhi:git
county,Vestfold og Telemark,2021-01-16,3,0,4084,0,0.968043196912881,0.0,3,4084,fhi:git
county,Vestfold og Telemark,2021-01-17,42,0,4126,0,0.9779985872827,0.0,42,4126,fhi:git
county,Vestfold og Telemark,2021-01-18,7,0,4133,0,0.979657819011003,0.0,7,4133,fhi:git
county,Vestfold og Telemark,2021-01-19,233,0,4366,0,1.03488653225309,0.0,233,4366,fhi:git
county,Vestfold og Telemark,2021-01-20,1606,0,5972,0,1.41556169734665,0.0,1606,5972,fhi:git
county,Vestfold og Telemark,2021-01-21,832,0,6804,0,1.61277323991069,0.0,832,6804,fhi:git
county,Vestfold og Telemark,2021-01-22,181,0,6985,0,1.65567623174253,0.0,181,6985,fhi:git
county,Vestfold og Telemark,2021-01-23,3,0,6988,0,1.65638733105466,0.0,3,6988,fhi:git
county,Vestfold og Telemark,2021-01-24,0,0,6988,0,1.65638733105466,0.0,0,6988,fhi:git
county,Vestfold og Telemark,2021-01-25,44,0,7032,0,1.66681678763256,0.0,44,7032,fhi:git
county,Vestfold og Telemark,2021-01-26,103,179,7135,179,1.69123119734902,0.0424289256237526,282,7314,fhi:git
county,Vestfold og Telemark,2021-01-27,1625,899,8760,1078,2.0764099914194,0.255521686158689,2524,9838,fhi:git
county,Vestfold og Telemark,2021-01-28,655,449,9415,1527,2.23166667456777,0.361949549874135,1104,10942,fhi:git
county,Vestfold og Telemark,2021-01-29,86,91,9501,1618,2.25205152151549,0.383519562342077,177,11119,fhi:git
county,Vestfold og Telemark,2021-01-30,0,0,9501,1618,2.25205152151549,0.383519562342077,0,11119,fhi:git
county,Vestfold og Telemark,2021-01-31,1,2,9502,1620,2.25228855461954,0.383993628550163,3,11122,fhi:git
county,Vestfold og Telemark,2021-02-01,50,1,9552,1621,2.2641402098217,0.384230661654207,51,11173,fhi:git
county,Vestfold og Telemark,2021-02-02,464,327,10016,1948,2.3741235700978,0.461740486676369,791,11964,fhi:git
county,Vestfold og Telemark,2021-02-03,3214,847,13230,2795,3.135947966493,0.662507525801054,4061,16025,fhi:git
county,Vestfold og Telemark,2021-02-04,1902,709,15132,3504,3.58678493038338,0.830563996567761,2611,18636,fhi:git
county,Vestfold og Telemark,2021-02-05,964,245,16096,3749,3.81528484268113,0.888637107058372,1209,19845,fhi:git
county,Vestfold og Telemark,2021-02-06,0,4,16096,3753,3.81528484268113,0.889585239474545,4,19849,fhi:git
county,Vestfold og Telemark,2021-02-07,2,1,16098,3754,3.81575890888922,0.889822272578588,3,19852,fhi:git
county,Vestfold og Telemark,2021-02-08,17,46,16115,3800,3.81978847165795,0.900725795364581,63,19915,fhi:git
county,Vestfold og Telemark,2021-02-09,356,208,16471,4008,3.90417225669737,0.950028681005589,564,20479,fhi:git
county,Vestfold og Telemark,2021-02-10,2892,1395,19363,5403,4.58967199359063,1.28068986114601,4287,24766,fhi:git
county,Vestfold og Telemark,2021-02-11,1539,882,20902,6285,4.95446594071328,1.48975305891221,2421,27187,fhi:git
county,Vestfold og Telemark,2021-02-12,602,213,21504,6498,5.09715986934735,1.54024111007343,815,28002,fhi:git
county,Vestfold og Telemark,2021-02-13,2,2,21506,6500,5.09763393555544,1.54071517628152,4,28006,fhi:git
county,Vestfold og Telemark,2021-02-14,0,0,21506,6500,5.09763393555544,1.54071517628152,0,28006,fhi:git
county,Vestfold og Telemark,2021-02-15,4,2,21510,6502,5.09858206797161,1.54118924248961,6,28012,fhi:git
county,Vestfold og Telemark,2021-02-16,579,75,22089,6577,5.23582423521269,1.55896672529285,654,28666,fhi:git
county,Vestfold og Telemark,2021-02-17,3043,1532,25132,8109,5.95711597081649,1.92210144068721,4575,33241,fhi:git
county,Vestfold og Telemark,2021-02-18,1822,629,26954,8738,6.3889902863834,2.07119526313045,2451,35692,fhi:git
county,Vestfold og Telemark,2021-02-19,283,83,27237,8821,6.45607065482765,2.09086901076604,366,36058,fhi:git
county,Vestfold og Telemark,2021-02-20,0,1,27237,8822,6.45607065482765,2.09110604387009,1,36059,fhi:git
county,Vestfold og Telemark,2021-02-21,1,1,27238,8823,6.4563076879317,2.09134307697413,2,36061,fhi:git
county,Vestfold og Telemark,2021-02-22,51,0,27289,8823,6.46839637623791,2.09134307697413,51,36112,fhi:git
county,Vestfold og Telemark,2021-02-23,626,385,27915,9208,6.61677909936902,2.1826008220308,1011,37123,fhi:git
county,Vestfold og Telemark,2021-02-24,670,2870,28585,12078,6.77559127907804,2.86288583063511,3540,40663,fhi:git
county,Vestfold og Telemark,2021-02-25,703,1998,29288,14076,6.94222555122048,3.33647797251364,2701,43364,fhi:git
county,Vestfold og Telemark,2021-02-26,543,845,29831,14921,7.070934526716,3.53677094543024,1388,44752,fhi:git
county,Vestfold og Telemark,2021-02-27,3,2,29834,14923,7.07164562602813,3.53724501163833,5,44757,fhi:git
county,Vestfold og Telemark,2021-02-28,1,0,29835,14923,7.07188265913217,3.53724501163833,1,44758,fhi:git
county,Vestfold og Telemark,2021-03-01,609,0,30444,14923,7.21623581949455,3.53724501163833,609,45367,fhi:git
county,Vestfold og Telemark,2021-03-02,845,354,31289,15277,7.41652879241115,3.62115473046966,1199,46566,fhi:git
county,Vestfold og Telemark,2021-03-03,1975,2815,33264,18092,7.88466917289669,4.28840291835158,4790,51356,fhi:git
county,Vestfold og Telemark,2021-03-04,1012,1433,34276,19525,8.12454667418852,4.62807135644564,2445,53801,fhi:git
county,Vestfold og Telemark,2021-03-05,1476,591,35752,20116,8.47440753575644,4.76815792093524,2067,55868,fhi:git
county,Vestfold og Telemark,2021-03-06,3,1,35755,20117,8.47511863506857,4.76839495403928,4,55872,fhi:git
county,Vestfold og Telemark,2021-03-07,1,0,35756,20117,8.47535566817262,4.76839495403928,1,55873,fhi:git
county,Vestfold og Telemark,2021-03-08,236,0,35992,20117,8.53129548072684,4.76839495403928,236,56109,fhi:git
county,Vestfold og Telemark,2021-03-09,934,142,36926,20259,8.75268439990329,4.80205365481343,1076,57185,fhi:git
county,Vestfold og Telemark,2021-03-10,1593,2261,38519,22520,9.13027813464428,5.33798550305536,3854,61039,fhi:git
county,Vestfold og Telemark,2021-03-11,300,836,38819,23356,9.20138806585728,5.53614517803556,1136,62175,fhi:git
county,Vestfold og Telemark,2021-03-12,36,126,38855,23482,9.20992125760284,5.56601134914502,162,62337,fhi:git
county,Vestfold og Telemark,2021-03-13,1,1,38856,23483,9.21015829070688,5.56624838224907,2,62339,fhi:git
county,Vestfold og Telemark,2021-03-14,0,0,38856,23483,9.21015829070688,5.56624838224907,0,62339,fhi:git
county,Vestfold og Telemark,2021-03-15,2,3,38858,23486,9.21063235691497,5.5669594815612,5,62344,fhi:git
county,Vestfold og Telemark,2021-03-16,402,25,39260,23511,9.30591966474038,5.57288530916228,427,62771,fhi:git
county,Vestfold og Telemark,2021-03-17,3103,166,42363,23677,10.0414333865868,5.61223280443347,3269,66040,fhi:git
county,Vestfold og Telemark,2021-03-18,911,53,43274,23730,10.2573705443702,5.62479555894776,964,67004,fhi:git
county,Vestfold og Telemark,2021-03-19,27,32,43301,23762,10.2637704381794,5.63238061827715,59,67063,fhi:git
county,Vestfold og Telemark,2021-03-20,0,0,43301,23762,10.2637704381794,5.63238061827715,0,67063,fhi:git
county,Vestfold og Telemark,2021-03-21,0,1,43301,23763,10.2637704381794,5.63261765138119,1,67064,fhi:git
county,Vestfold og Telemark,2021-03-22,0,1,43301,23764,10.2637704381794,5.63285468448524,1,67065,fhi:git
county,Vestfold og Telemark,2021-03-23,660,58,43961,23822,10.420212286848,5.64660260451975,718,67783,fhi:git
county,Vestfold og Telemark,2021-03-24,4609,817,48570,24639,11.5126978633836,5.84025865052313,5426,73209,fhi:git
county,Vestfold og Telemark,2021-03-25,2945,271,51515,24910,12.2107603547912,5.90449462171887,3216,76425,fhi:git
county,Vestfold og Telemark,2021-03-26,898,152,52413,25062,12.423616082222,5.94052365353345,1050,77475,fhi:git
county,Vestfold og Telemark,2021-03-27,0,0,52413,25062,12.423616082222,5.94052365353345,0,77475,fhi:git
county,Vestfold og Telemark,2021-03-28,0,0,52413,25062,12.423616082222,5.94052365353345,0,77475,fhi:git
county,Vestfold og Telemark,2021-03-29,184,3,52597,25065,12.467230173366,5.94123475284558,187,77662,fhi:git
county,Vestfold og Telemark,2021-03-30,3017,80,55614,25145,13.1823590482647,5.96019740116905,3097,80759,fhi:git
county,Vestfold og Telemark,2021-03-31,3394,490,59008,25635,13.9868494033877,6.07634362215027,3884,84643,fhi:git
county,Vestfold og Telemark,2021-04-01,425,17,59433,25652,14.0875884726061,6.08037318491901,442,85085,fhi:git
county,Vestfold og Telemark,2021-04-02,2,3,59435,25655,14.0880625388142,6.08108428423114,5,85090,fhi:git
county,Vestfold og Telemark,2021-04-03,1,0,59436,25655,14.0882995719182,6.08108428423114,1,85091,fhi:git
county,Vestfold og Telemark,2021-04-04,0,0,59436,25655,14.0882995719182,6.08108428423114,0,85091,fhi:git
county,Vestfold og Telemark,2021-04-05,1,1,59437,25656,14.0885366050223,6.08132131733518,2,85093,fhi:git
county,Vestfold og Telemark,2021-04-06,966,40,60403,25696,14.3175105835281,6.09080264149691,1006,86099,fhi:git
county,Vestfold og Telemark,2021-04-07,6279,148,66682,25844,15.805841443816,6.12588354089532,6427,92526,fhi:git
county,Vestfold og Telemark,2021-04-08,3652,60,70334,25904,16.6714863397822,6.14010552713792,3712,96238,fhi:git
county,Vestfold og Telemark,2021-04-09,1255,14,71589,25918,16.9689628853566,6.14342399059453,1269,97507,fhi:git
county,Vestfold og Telemark,2021-04-10,2,0,71591,25918,16.9694369515647,6.14342399059453,2,97509,fhi:git
county,Vestfold og Telemark,2021-04-11,1,0,71592,25918,16.9696739846687,6.14342399059453,1,97510,fhi:git
county,Vestfold og Telemark,2021-04-12,12,0,71604,25918,16.9725183819172,6.14342399059453,12,97522,fhi:git
county,Vestfold og Telemark,2021-04-13,1139,14,72743,25932,17.2424990874226,6.14674245405113,1153,98675,fhi:git
county,Vestland,2020-12-27,0,0,0,0,0.0,0.0,0,0,fhi:git
county,Vestland,2020-12-28,0,0,0,0,0.0,0.0,0,0,fhi:git
county,Vestland,2020-12-29,0,0,0,0,0.0,0.0,0,0,fhi:git
county,Vestland,2020-12-30,0,0,0,0,0.0,0.0,0,0,fhi:git
county,Vestland,2020-12-31,0,0,0,0,0.0,0.0,0,0,fhi:git
county,Vestland,2021-01-01,0,0,0,0,0.0,0.0,0,0,fhi:git
county,Vestland,2021-01-02,0,0,0,0,0.0,0.0,0,0,fhi:git
county,Vestland,2021-01-03,0,0,0,0,0.0,0.0,0,0,fhi:git
county,Vestland,2021-01-04,2,0,2,0,0.0003130767460681,0.0,2,2,fhi:git
county,Vestland,2021-01-05,416,0,418,0,0.0654330399282428,0.0,416,418,fhi:git
county,Vestland,2021-01-06,1256,0,1674,0,0.262045236459039,0.0,1256,1674,fhi:git
county,Vestland,2021-01-07,715,0,2389,0,0.373970173178402,0.0,715,2389,fhi:git
county,Vestland,2021-01-08,139,0,2528,0,0.395729007030138,0.0,139,2528,fhi:git
county,Vestland,2021-01-09,0,0,2528,0,0.395729007030138,0.0,0,2528,fhi:git
county,Vestland,2021-01-10,0,0,2528,0,0.395729007030138,0.0,0,2528,fhi:git
county,Vestland,2021-01-11,65,0,2593,0,0.405904001277353,0.0,65,2593,fhi:git
county,Vestland,2021-01-12,856,0,3449,0,0.53990084859452,0.0,856,3449,fhi:git
county,Vestland,2021-01-13,1127,0,4576,0,0.716319595003921,0.0,1127,4576,fhi:git
county,Vestland,2021-01-14,999,0,5575,0,0.872701429664961,0.0,999,5575,fhi:git
county,Vestland,2021-01-15,425,0,6000,0,0.939230238204442,0.0,425,6000,fhi:git
county,Vestland,2021-01-16,2,0,6002,0,0.93954331495051,0.0,2,6002,fhi:git
county,Vestland,2021-01-17,1,0,6003,0,0.939699853323544,0.0,1,6003,fhi:git
county,Vestland,2021-01-18,62,0,6065,0,0.949405232451657,0.0,62,6065,fhi:git
county,Vestland,2021-01-19,368,0,6433,0,1.0070113537282,0.0,368,6433,fhi:git
county,Vestland,2021-01-20,1236,0,7669,0,1.20049278279831,0.0,1236,7669,fhi:git
county,Vestland,2021-01-21,783,0,8452,0,1.32306232888399,0.0,783,8452,fhi:git
county,Vestland,2021-01-22,312,0,8764,0,1.37190230127062,0.0,312,8764,fhi:git
county,Vestland,2021-01-23,0,0,8764,0,1.37190230127062,0.0,0,8764,fhi:git
county,Vestland,2021-01-24,0,0,8764,0,1.37190230127062,0.0,0,8764,fhi:git
county,Vestland,2021-01-25,2,0,8766,0,1.37221537801669,0.0,2,8766,fhi:git
county,Vestland,2021-01-26,152,174,8918,174,1.39600921071787,0.0272376769079288,326,9092,fhi:git
county,Vestland,2021-01-27,1591,1211,10509,1385,1.64506176221508,0.216805646652192,2802,11894,fhi:git
county,Vestland,2021-01-28,1958,695,12467,2080,1.9515638966158,0.325599815910873,2653,14547,fhi:git
county,Vestland,2021-01-29,481,176,12948,2256,2.02685885404519,0.35315056956487,657,15204,fhi:git
county,Vestland,2021-01-30,3,0,12951,2256,2.02732846916429,0.35315056956487,3,15207,fhi:git
county,Vestland,2021-01-31,1,0,12952,2256,2.02748500753732,0.35315056956487,1,15208,fhi:git
county,Vestland,2021-02-01,13,59,12965,2315,2.02952000638677,0.362386333573881,72,15280,fhi:git
county,Vestland,2021-02-02,720,582,13685,2897,2.1422276349713,0.453491666679712,1302,16582,fhi:git
county,Vestland,2021-02-03,2830,1049,16515,3946,2.58523123065773,0.617700419992455,3879,20461,fhi:git
county,Vestland,2021-02-04,2589,1127,19104,5073,2.99050907844294,0.794119166401856,3716,24177,fhi:git
county,Vestland,2021-02-05,911,487,20015,5560,3.13311553627699,0.87035335406945,1398,25575,fhi:git
county,Vestland,2021-02-06,0,2,20015,5562,3.13311553627699,0.870666430815518,2,25577,fhi:git
county,Vestland,2021-02-07,2,1,20017,5563,3.13342861302305,0.870822969188552,3,25580,fhi:git
county,Vestland,2021-02-08,8,49,20025,5612,3.13468092000733,0.878493349467222,57,25637,fhi:git
county,Vestland,2021-02-09,891,307,20916,5919,3.27415661038069,0.926550629988682,1198,26835,fhi:git
county,Vestland,2021-02-10,2758,971,23674,6890,3.70588944320866,1.07854939020477,3729,30564,fhi:git
county,Vestland,2021-02-11,2703,836,26377,7726,4.12901266551976,1.20941547006125,3539,34103,fhi:git
county,Vestland,2021-02-12,630,458,27007,8184,4.22763184053123,1.28111004491086,1088,35191,fhi:git
county,Vestland,2021-02-13,0,0,27007,8184,4.22763184053123,1.28111004491086,0,35191,fhi:git
county,Vestland,2021-02-14,0,2,27007,8186,4.22763184053123,1.28142312165693,2,35193,fhi:git
county,Vestland,2021-02-15,94,1,27101,8187,4.24234644759643,1.28157966002996,95,35288,fhi:git
county,Vestland,2021-02-16,1087,55,28188,8242,4.41250365908447,1.29018927054684,1142,36430,fhi:git
county,Vestland,2021-02-17,2708,1329,30896,9571,4.83640957326074,1.49822876830912,4037,40467,fhi:git
county,Vestland,2021-02-18,2008,2000,32904,11571,5.15073862631316,1.81130551437727,4008,44475,fhi:git
county,Vestland,2021-02-19,1157,541,34061,12112,5.33185352391358,1.8959927741887,1698,46173,fhi:git
county,Vestland,2021-02-20,3,5,34064,12117,5.33232313903269,1.89677546605387,8,46181,fhi:git
county,Vestland,2021-02-21,0,1,34064,12118,5.33232313903269,1.89693200442691,1,46182,fhi:git
county,Vestland,2021-02-22,49,2,34113,12120,5.33999351931136,1.89724508117297,51,46233,fhi:git
county,Vestland,2021-02-23,542,591,34655,12711,5.42483731749582,1.98975925963611,1133,47366,fhi:git
county,Vestland,2021-02-24,1414,2401,36069,15112,5.646182576966,2.36560789329092,3815,51181,fhi:git
county,Vestland,2021-02-25,1258,2646,37327,17758,5.84310785024287,2.77980842833908,3904,55085,fhi:git
county,Vestland,2021-02-26,1426,875,38753,18633,6.06633157018946,2.9167795047439,2301,57386,fhi:git
county,Vestland,2021-02-27,5,0,38758,18633,6.06711426205463,2.9167795047439,5,57391,fhi:git
county,Vestland,2021-02-28,0,7,38758,18640,6.06711426205463,2.91787527335513,7,57398,fhi:git
county,Vestland,2021-03-01,440,11,39198,18651,6.13599114618962,2.91959719545851,451,57849,fhi:git
county,Vestland,2021-03-02,1351,757,40549,19408,6.34747448815866,3.0380967438453,2108,59957,fhi:git
county,Vestland,2021-03-03,1743,2045,42292,21453,6.62032087235705,3.35821771669998,3788,63745,fhi:git
county,Vestland,2021-03-04,1802,2848,44094,24301,6.90240302056445,3.80403900310103,4650,68395,fhi:git
county,Vestland,2021-03-05,1245,903,45339,25204,7.09729329499187,3.94539315395079,2148,70543,fhi:git
county,Vestland,2021-03-06,1,6,45340,25210,7.0974498333649,3.946332384189,7,70550,fhi:git
county,Vestland,2021-03-07,2,0,45342,25210,7.09776291011097,3.946332384189,2,70552,fhi:git
county,Vestland,2021-03-08,636,15,45978,25225,7.19732131536064,3.94868045978451,651,71203,fhi:git
county,Vestland,2021-03-09,1500,527,47478,25752,7.43212887491175,4.03117618237347,2027,73230,fhi:git
county,Vestland,2021-03-10,2499,1850,49977,27602,7.8233182691239,4.3207721724865,4349,77579,fhi:git
county,Vestland,2021-03-11,1402,1548,51379,29150,8.04278506811767,4.56309357394325,2950,80529,fhi:git
county,Vestland,2021-03-12,180,976,51559,30126,8.07096197526381,4.71587502602451,1156,81685,fhi:git
county,Vestland,2021-03-13,8,10,51567,30136,8.07221428224808,4.71744040975485,18,81703,fhi:git
county,Vestland,2021-03-14,0,0,51567,30136,8.07221428224808,4.71744040975485,0,81703,fhi:git
county,Vestland,2021-03-15,7,8,51574,30144,8.07331005085932,4.71869271673912,15,81718,fhi:git
county,Vestland,2021-03-16,1195,34,52769,30178,8.26037340663504,4.72401502142228,1229,82947,fhi:git
county,Vestland,2021-03-17,2430,222,55199,30400,8.64076165310783,4.75876654023584,2652,85599,fhi:git
county,Vestland,2021-03-18,2318,145,57517,30545,9.00361760180082,4.78146460432578,2463,88062,fhi:git
county,Vestland,2021-03-19,587,115,58104,30660,9.09550562677182,4.7994665172247,702,88764,fhi:git
county,Vestland,2021-03-20,1,2,58105,30662,9.09566216514485,4.79977959397077,3,88767,fhi:git
county,Vestland,2021-03-21,0,0,58105,30662,9.09566216514485,4.79977959397077,0,88767,fhi:git
county,Vestland,2021-03-22,9,13,58114,30675,9.09707101050216,4.80181459282021,22,88789,fhi:git
county,Vestland,2021-03-23,2050,341,60164,31016,9.41797467522201,4.85519417802483,2391,91180,fhi:git
county,Vestland,2021-03-24,4022,514,64186,31530,10.0475720115651,4.93565490176435,4536,95716,fhi:git
county,Vestland,2021-03-25,3132,375,67318,31905,10.5378501959078,4.99435679165212,3507,99223,fhi:git
county,Vestland,2021-03-26,996,188,68314,32093,10.6937624154497,5.02378600578253,1184,100407,fhi:git
county,Vestland,2021-03-27,2,0,68316,32093,10.6940754921958,5.02378600578253,2,100409,fhi:git
county,Vestland,2021-03-28,0,0,68316,32093,10.6940754921958,5.02378600578253,0,100409,fhi:git
county,Vestland,2021-03-29,115,2,68431,32095,10.7120774050947,5.0240990825286,117,100526,fhi:git
county,Vestland,2021-03-30,3577,571,72008,32666,11.2720151654376,5.11348249353105,4148,104674,fhi:git
county,Vestland,2021-03-31,3686,1158,75694,33824,11.8490156084412,5.29475392950451,4844,109518,fhi:git
county,Vestland,2021-04-01,951,232,76645,34056,11.9978836011966,5.33107083204842,1183,110701,fhi:git
county,Vestland,2021-04-02,53,90,76698,34146,12.0061801349674,5.34515928562148,143,110844,fhi:git
county,Vestland,2021-04-03,0,0,76698,34146,12.0061801349674,5.34515928562148,0,110844,fhi:git
county,Vestland,2021-04-04,0,2,76698,34148,12.0061801349674,5.34547236236755,2,110846,fhi:git
county,Vestland,2021-04-05,1,1,76699,34149,12.0063366733404,5.34562890074058,2,110848,fhi:git
county,Vestland,2021-04-06,3081,100,79780,34249,12.4886314006584,5.36128273804399,3181,114029,fhi:git
county,Vestland,2021-04-07,8091,155,87871,34404,13.7551833768771,5.38554618586427,8246,122275,fhi:git
county,Vestland,2021-04-08,6296,300,94167,34704,14.7407489734996,5.43250769777449,6596,128871,fhi:git
county,Vestland,2021-04-09,2021,103,96188,34807,15.0571130254015,5.448631150197,2124,130995,fhi:git
county,Vestland,2021-04-10,41,2,96229,34809,15.0635310986959,5.44894422694307,43,131038,fhi:git
county,Vestland,2021-04-11,5,0,96234,34809,15.064313790561,5.44894422694307,5,131043,fhi:git
county,Vestland,2021-04-12,49,9,96283,34818,15.0719841708397,5.45035307230038,58,131101,fhi:git
county,Vestland,2021-04-13,4585,62,100868,34880,15.7897126112009,5.46005845142849,4647,135748,fhi:git
county,Viken,2020-12-27,0,0,0,0,0.0,0.0,0,0,fhi:git
county,Viken,2020-12-28,65,0,65,0,0.0052370152236004,0.0,65,65,fhi:git
county,Viken,2020-12-29,689,0,754,0,0.0607493765937647,0.0,689,754,fhi:git
county,Viken,2020-12-30,219,0,973,0,0.0783940894240492,0.0,219,973,fhi:git
county,Viken,2020-12-31,67,0,1040,0,0.0837922435776065,0.0,67,1040,fhi:git
county,Viken,2021-01-01,0,0,1040,0,0.0837922435776065,0.0,0,1040,fhi:git
county,Viken,2021-01-02,0,0,1040,0,0.0837922435776065,0.0,0,1040,fhi:git
county,Viken,2021-01-03,0,0,1040,0,0.0837922435776065,0.0,0,1040,fhi:git
county,Viken,2021-01-04,0,0,1040,0,0.0830416230165828,0.0,0,1040,fhi:git
county,Viken,2021-01-05,526,0,1566,0,0.125041520811508,0.0,526,1566,fhi:git
county,Viken,2021-01-06,1649,0,3215,0,0.256710401921455,0.0,1649,3215,fhi:git
county,Viken,2021-01-07,1924,0,5139,0,0.410337404502134,0.0,1924,5139,fhi:git
county,Viken,2021-01-08,282,0,5421,0,0.432854459973938,0.0,282,5421,fhi:git
county,Viken,2021-01-09,6,0,5427,0,0.433333546260572,0.0,6,5427,fhi:git
county,Viken,2021-01-10,5,0,5432,0,0.433732784832767,0.0,5,5432,fhi:git
county,Viken,2021-01-11,59,0,5491,0,0.438443799984669,0.0,59,5491,fhi:git
county,Viken,2021-01-12,788,0,6279,0,0.501363798962619,0.0,788,6279,fhi:git
county,Viken,2021-01-13,1945,0,8224,0,0.656667603546516,0.0,1945,8224,fhi:git
county,Viken,2021-01-14,1951,0,10175,0,0.812450494417048,0.0,1951,10175,fhi:git
county,Viken,2021-01-15,1051,0,11226,0,0.89637044229246,0.0,1051,11226,fhi:git
county,Viken,2021-01-16,91,0,11317,0,0.903636584306411,0.0,91,11317,fhi:git
county,Viken,2021-01-17,23,0,11340,0,0.905473081738508,0.0,23,11340,fhi:git
county,Viken,2021-01-18,144,51,11484,51,0.916971152617727,0.0040722334363901,195,11535,fhi:git
county,Viken,2021-01-19,649,384,12133,435,0.968792319288653,0.0347337557809745,1033,12568,fhi:git
county,Viken,2021-01-20,1492,342,13625,777,1.08792510923167,0.06204167411912,1834,14402,fhi:git
county,Viken,2021-01-21,1997,100,15622,877,1.2473809949664,0.0700264455630222,2097,16499,fhi:git
county,Viken,2021-01-22,820,1,16442,878,1.3128561208064,0.0701062932774612,821,17320,fhi:git
county,Viken,2021-01-23,98,0,16540,878,1.32068119682142,0.0701062932774612,98,17418,fhi:git
county,Viken,2021-01-24,0,0,16540,878,1.32068119682142,0.0701062932774612,0,17418,fhi:git
county,Viken,2021-01-25,62,0,16602,878,1.32563175511664,0.0701062932774612,62,17480,fhi:git
county,Viken,2021-01-26,563,402,17165,1280,1.37058601834581,0.102205074481948,965,18445,fhi:git
county,Viken,2021-01-27,1942,1218,19107,2498,1.52565027978639,0.199459590668677,3160,21605,fhi:git
county,Viken,2021-01-28,3105,1712,22212,4210,1.77357743311955,0.336158877788282,4817,26422,fhi:git
county,Viken,2021-01-29,1041,427,23253,4637,1.85669890385058,0.370253851853745,1468,27890,fhi:git
county,Viken,2021-01-30,11,18,23264,4655,1.85757722870941,0.371691110713647,29,27919,fhi:git
county,Viken,2021-01-31,10,3,23274,4658,1.8583757058538,0.371930653856964,13,27932,fhi:git
county,Viken,2021-02-01,37,47,23311,4705,1.86133007128804,0.375683496435598,84,28016,fhi:git
county,Viken,2021-02-02,1024,687,24335,5392,1.9430941308736,0.430538876255206,1711,29727,fhi:git
county,Viken,2021-02-03,4777,1723,29112,7115,2.32452666274881,0.568116488233641,6500,36227,fhi:git
county,Viken,2021-02-04,6643,1750,35755,8865,2.85495502976723,0.707849988501929,8393,44620,fhi:git
county,Viken,2021-02-05,3146,1102,38901,9967,3.10615593939239,0.795842169813731,4248,48868,fhi:git
county,Viken,2021-02-06,38,90,38939,10057,3.10919015254107,0.803028464113243,128,48996,fhi:git
county,Viken,2021-02-07,16,20,38955,10077,3.1104677159721,0.804625418402024,36,49032,fhi:git
county,Viken,2021-02-08,15,95,38970,10172,3.11166543168868,0.812210951273731,110,49142,fhi:git
county,Viken,2021-02-09,796,566,39766,10738,3.17522421238215,0.857404757646217,1362,50504,fhi:git
county,Viken,2021-02-10,3447,1325,43213,12063,3.45045928405345,0.963202979277921,4772,55276,fhi:git
county,Viken,2021-02-11,4851,1917,48064,13980,3.83780054679715,1.11627104785753,6768,62044,fhi:git
county,Viken,2021-02-12,2428,979,50492,14959,4.03167079745509,1.19444196029333,3407,65451,fhi:git
county,Viken,2021-02-13,25,97,50517,15056,4.03366699031607,1.20218718859391,122,65573,fhi:git
county,Viken,2021-02-14,6,1,50523,15057,4.0341460766027,1.20226703630835,7,65580,fhi:git
county,Viken,2021-02-15,358,125,50881,15182,4.06273155837187,1.21224800061323,483,66063,fhi:git
county,Viken,2021-02-16,1427,359,52308,15541,4.17667424687636,1.24091333009684,1786,67849,fhi:git
county,Viken,2021-02-17,4430,1813,56738,17354,4.53039962184123,1.38567723637479,6243,74092,fhi:git
county,Viken,2021-02-18,4894,2928,61632,20282,4.9211743363058,1.61947134425224,7822,81914,fhi:git
county,Viken,2021-02-19,3798,1282,65430,21564,5.2244359557452,1.72183611416307,5080,86994,fhi:git
county,Viken,2021-02-20,30,10,65460,21574,5.22683138717837,1.72263459130746,40,87034,fhi:git
county,Viken,2021-02-21,1,9,65461,21583,5.22691123489281,1.72335322073741,10,87044,fhi:git
county,Viken,2021-02-22,704,9,66165,21592,5.28312402585788,1.72407185016736,713,87757,fhi:git
county,Viken,2021-02-23,2126,756,68291,22348,5.45288026675524,1.78443672228326,2882,90639,fhi:git
county,Viken,2021-02-24,2512,4211,70803,26559,5.65345772542607,2.12067544778598,6723,97362,fhi:git
county,Viken,2021-02-25,2543,6272,73346,32831,5.8565104632445,2.62148031274753,8815,106177,fhi:git
county,Viken,2021-02-26,1936,2722,75282,35553,6.01109563839845,2.83882579145055,4658,110835,fhi:git
county,Viken,2021-02-27,165,89,75447,35642,6.02427051128089,2.84593223803562,254,111089,fhi:git
county,Viken,2021-02-28,416,1,75863,35643,6.05748716048752,2.84601208575006,417,111506,fhi:git
county,Viken,2021-03-01,1521,2,77384,35645,6.17893553414927,2.84617178117894,1523,113029,fhi:git
county,Viken,2021-03-02,3018,520,80402,36165,6.41991593632624,2.88769259268723,3538,116567,fhi:git
county,Viken,2021-03-03,4962,2698,85364,38863,6.81612029537267,3.10312172624371,7660,124227,fhi:git
county,Viken,2021-03-04,4397,3261,89761,42124,7.16721069576105,3.36350512302936,7658,131885,fhi:git
county,Viken,2021-03-05,2723,1782,92484,43906,7.3846360221785,3.5057937501597,4505,136390,fhi:git
county,Viken,2021-03-06,210,2,92694,43908,7.4014040422107,3.50595344558857,212,136602,fhi:git
county,Viken,2021-03-07,17,0,92711,43908,7.40276145335616,3.50595344558857,17,136619,fhi:git
county,Viken,2021-03-08,1135,22,93846,43930,7.49338860924445,3.50771009530623,1157,137776,fhi:git
county,Viken,2021-03-09,2898,716,96744,44646,7.72478728568874,3.56488105884457,3614,141390,fhi:git
county,Viken,2021-03-10,5398,3207,102142,47853,8.15580524823058,3.82095267905051,8605,149995,fhi:git
county,Viken,2021-03-11,3420,4770,105562,52623,8.42888443161203,4.20182627692465,8190,158185,fhi:git
county,Viken,2021-03-12,1220,3305,106782,55928,8.52629864322764,4.46572297314562,4525,162710,fhi:git
county,Viken,2021-03-13,17,8,106799,55936,8.5276560543731,4.46636175486113,25,162735,fhi:git
county,Viken,2021-03-14,2,5,106801,55941,8.52781574980198,4.46676099343332,7,162742,fhi:git
county,Viken,2021-03-15,35,48,106836,55989,8.53061041980734,4.4705936837264,83,162825,fhi:git
county,Viken,2021-03-16,774,304,107610,56293,8.59241255078315,4.49486738891586,1078,163903,fhi:git
county,Viken,2021-03-17,3983,413,111593,56706,8.91044599739377,4.52784449497918,4396,168299,fhi:git
county,Viken,2021-03-18,5906,438,117499,57144,9.38202659887063,4.56281779390347,6344,174643,fhi:git
county,Viken,2021-03-19,2030,365,119529,57509,9.54411745918185,4.59196220967371,2395,177038,fhi:git
county,Viken,2021-03-20,6,2,119535,57511,9.54459654546848,4.59212190510259,8,177046,fhi:git
county,Viken,2021-03-21,6,1,119541,57512,9.54507563175512,4.59220175281703,7,177053,fhi:git
county,Viken,2021-03-22,400,24,119941,57536,9.57701471753072,4.59411809796356,424,177477,fhi:git
county,Viken,2021-03-23,2470,81,122411,57617,9.77423857219511,4.60058576283312,2551,180028,fhi:git
county,Viken,2021-03-24,7382,748,129793,58365,10.363674400184,4.66031185323351,8130,188158,fhi:git
county,Viken,2021-03-25,10224,621,140017,58986,11.1800374326085,4.70989728390015,10845,199003,fhi:git
county,Viken,2021-03-26,5901,314,145918,59300,11.6512187955132,4.734969466234,6215,205218,fhi:git
county,Viken,2021-03-27,4,1,145922,59301,11.651538186371,4.73504931394844,5,205223,fhi:git
county,Viken,2021-03-28,5,0,145927,59301,11.6519374249431,4.73504931394844,5,205228,fhi:git
county,Viken,2021-03-29,1332,4,147259,59305,11.7582945805759,4.73536870480619,1336,206564,fhi:git
county,Viken,2021-03-30,6078,1603,153337,60908,12.2436089889363,4.86336459105195,7681,214245,fhi:git
county,Viken,2021-03-31,9894,1812,163231,62720,13.033622275596,5.00804864961545,11706,225951,fhi:git
county,Viken,2021-04-01,3678,478,166909,63198,13.3273021693027,5.04621585711731,4156,230107,fhi:git
county,Viken,2021-04-02,2258,264,169167,63462,13.507598308506,5.06729565372921,2522,232629,fhi:git
county,Viken,2021-04-03,4,0,169171,63462,13.5079176993638,5.06729565372921,4,232633,fhi:git
county,Viken,2021-04-04,13,0,169184,63462,13.5089557196515,5.06729565372921,13,232646,fhi:git
county,Viken,2021-04-05,50,1,169234,63463,13.5129481053734,5.06737550144365,51,232697,fhi:git
county,Viken,2021-04-06,3382,2070,172616,65533,13.7829930756062,5.23266027033242,5452,238149,fhi:git
county,Viken,2021-04-07,11130,2513,183746,68046,14.6716981373125,5.43331757671768,13643,251792,fhi:git
county,Viken,2021-04-08,14919,1989,198665,70035,15.8629461890283,5.5921346807369,16908,268700,fhi:git
county,Viken,2021-04-09,8446,264,207111,70299,16.5373399851803,5.6132144773488,8710,277410,fhi:git
county,Viken,2021-04-10,244,42,207355,70341,16.5568228275034,5.61656808135524,286,277696,fhi:git
county,Viken,2021-04-11,13,0,207368,70341,16.5578608477911,5.61656808135524,13,277709,fhi:git
county,Viken,2021-04-12,1355,7,208723,70348,16.666054500856,5.61712701535631,1362,279071,fhi:git
county,Viken,2021-04-13,6998,163,215721,70511,17.2248288065002,5.63014219280987,7161,286232,fhi:git
nation,Norge,2020-12-27,5,0,5,0,9.31518486915891e-05,0.0,5,5,fhi:git
nation,Norge,2020-12-28,604,0,609,0,0.0113458951706356,0.0,604,609,fhi:git
nation,Norge,2020-12-29,1067,0,1676,0,0.0312244996814207,0.0,1067,1676,fhi:git
nation,Norge,2020-12-30,427,0,2103,0,0.0391796675596824,0.0,427,2103,fhi:git
nation,Norge,2020-12-31,72,0,2175,0,0.0405210541808413,0.0,72,2175,fhi:git
nation,Norge,2021-01-01,6,0,2181,0,0.0406328363992712,0.0,6,2181,fhi:git
nation,Norge,2021-01-02,0,0,2181,0,0.0406328363992712,0.0,0,2181,fhi:git
nation,Norge,2021-01-03,3,0,2184,0,0.0406887275084861,0.0,3,2184,fhi:git
nation,Norge,2021-01-04,6,0,2190,0,0.0406204806237525,0.0,6,2190,fhi:git
nation,Norge,2021-01-05,3385,0,5575,0,0.103406018026219,0.0,3385,5575,fhi:git
nation,Norge,2021-01-06,9069,0,14644,0,0.271619323403759,0.0,9069,14644,fhi:git
nation,Norge,2021-01-07,6554,0,21198,0,0.393183994640322,0.0,6554,21198,fhi:git
nation,Norge,2021-01-08,1616,0,22814,0,0.423157828744425,0.0,1616,22814,fhi:git
nation,Norge,2021-01-09,135,0,22949,0,0.425661830974656,0.0,135,22949,fhi:git
nation,Norge,2021-01-10,108,0,23057,0,0.427665032758841,0.0,108,23057,fhi:git
nation,Norge,2021-01-11,356,0,23413,0,0.434268179380784,0.0,356,23413,fhi:git
nation,Norge,2021-01-12,4261,0,27674,0,0.513301909032752,0.0,4261,27674,fhi:git
nation,Norge,2021-01-13,9790,0,37464,0,0.694888441136194,0.0,9790,37464,fhi:git
nation,Norge,2021-01-14,8476,0,45940,0,0.852102684865384,0.0,8476,45940,fhi:git
nation,Norge,2021-01-15,4480,0,50420,0,0.935198462579727,0.0,4480,50420,fhi:git
nation,Norge,2021-01-16,747,0,51167,0,0.949053941587007,0.0,747,51167,fhi:git
nation,Norge,2021-01-17,349,5,51516,5,0.955527251056272,9.27408233419007e-05,354,51521,fhi:git
nation,Norge,2021-01-18,1284,283,52800,288,0.979343094490472,0.0053418714244934,1567,53088,fhi:git
nation,Norge,2021-01-19,4591,772,57391,1060,1.06449771848301,0.019661054548483,5363,58451,fhi:git
nation,Norge,2021-01-20,10065,693,67456,1753,1.25118499587025,0.0325149326636704,10758,69209,fhi:git
nation,Norge,2021-01-21,8447,169,75903,1922,1.40786134282406,0.0356495724926266,8616,77825,fhi:git
nation,Norge,2021-01-22,3317,7,79220,1929,1.46938560502908,0.0357794096453053,3324,81149,fhi:git
nation,Norge,2021-01-23,359,0,79579,1929,1.47604439614502,0.0357794096453053,359,81508,fhi:git
nation,Norge,2021-01-24,67,0,79646,1929,1.47728712317781,0.0357794096453053,67,81575,fhi:git
nation,Norge,2021-01-25,581,0,80227,1929,1.48806360685013,0.0357794096453053,581,82156,fhi:git
nation,Norge,2021-01-26,2280,2142,82507,4071,1.53035342229404,0.0755095783649756,4422,86578,fhi:git
nation,Norge,2021-01-27,11417,7598,93924,11669,1.74211781831294,0.216438533515328,19015,105593,fhi:git
nation,Norge,2021-01-28,10903,6577,104827,18246,1.94434845769229,0.338429812539264,17480,123073,fhi:git
nation,Norge,2021-01-29,3813,2108,108640,20354,2.01507260957282,0.37752934366021,5921,128994,fhi:git
nation,Norge,2021-01-30,150,172,108790,20526,2.01785483427308,0.380719627983171,322,129316,fhi:git
nation,Norge,2021-01-31,106,51,108896,20577,2.01982093972792,0.381665584381258,157,129473,fhi:git
nation,Norge,2021-02-01,199,304,109095,20881,2.02351202449693,0.387304226440446,503,129976,fhi:git
nation,Norge,2021-02-02,6354,3144,115449,24025,2.14136706279982,0.445619656157833,9498,139474,fhi:git
nation,Norge,2021-02-03,25151,8334,140600,32359,2.60787195237425,0.600200060504113,33485,172959,fhi:git
nation,Norge,2021-02-04,25981,8694,166581,41053,3.08977181862343,0.76145780413101,34675,207634,fhi:git
nation,Norge,2021-02-05,10628,4873,177209,45926,3.28690171271898,0.851843010560027,15501,223135,fhi:git
nation,Norge,2021-02-06,810,737,178019,46663,3.30192572610037,0.865513007920623,1547,224682,fhi:git
nation,Norge,2021-02-07,324,296,178343,46959,3.30793533145292,0.871003264662463,620,225302,fhi:git
nation,Norge,2021-02-08,121,922,178464,47881,3.3101796593778,0.88810467248671,1043,226345,fhi:git
nation,Norge,2021-02-09,5549,3242,184013,51123,3.41310342512264,0.948237822341598,8791,235136,fhi:git
nation,Norge,2021-02-10,23004,8670,207017,59793,3.83978540515405,1.10905041001645,31674,266810,fhi:git
nation,Norge,2021-02-11,20949,8588,227966,68381,4.22835090679195,1.2683420481885,29537,296347,fhi:git
nation,Norge,2021-02-12,8052,3613,236018,71994,4.37770072870175,1.33535656713536,11665,308012,fhi:git
nation,Norge,2021-02-13,895,306,236913,72300,4.39430133607995,1.34103230552388,1201,309213,fhi:git
nation,Norge,2021-02-14,110,4,237023,72304,4.39634163419347,1.34110649818256,114,309327,fhi:git
nation,Norge,2021-02-15,805,751,237828,73055,4.41127290675151,1.35503616984851,1556,310883,fhi:git
nation,Norge,2021-02-16,6114,2177,243942,75232,4.52467638553399,1.39541552433158,8291,319174,fhi:git
nation,Norge,2021-02-17,21836,10208,265778,85440,4.92969410923274,1.5847551892664,32044,351218,fhi:git
nation,Norge,2021-02-18,18896,10830,284674,96270,5.28018022880645,1.78563181262496,29726,380944,fhi:git
nation,Norge,2021-02-19,10737,4799,295411,101069,5.47933187285085,1.87464445486851,15536,396480,fhi:git
nation,Norge,2021-02-20,502,176,295913,101245,5.48864305151437,1.87790893185015,678,397158,fhi:git
nation,Norge,2021-02-21,58,105,295971,101350,5.48971884506514,1.87985648914033,163,397321,fhi:git
nation,Norge,2021-02-22,2575,142,298546,101492,5.53748036908622,1.88249032852324,2717,400038,fhi:git
nation,Norge,2021-02-23,5750,5206,304296,106698,5.64413231592941,1.97905207378683,10956,410994,fhi:git
nation,Norge,2021-02-24,11111,22362,315407,129060,5.85022097355978,2.39382613210114,33473,444467,fhi:git
nation,Norge,2021-02-25,11162,25153,326569,154213,6.05725558758824,2.86036811800491,36315,480782,fhi:git
nation,Norge,2021-02-26,8350,9936,334919,164149,6.21213276256921,3.04466268214993,18286,499068,fhi:git
nation,Norge,2021-02-27,444,203,335363,164352,6.22036814768197,3.04842795957761,647,499715,fhi:git
nation,Norge,2021-02-28,539,159,335902,164511,6.23036560843823,3.05137711775989,698,500413,fhi:git
nation,Norge,2021-03-01,5928,63,341830,164574,6.34031912859239,3.05254565213399,5991,506404,fhi:git
nation,Norge,2021-03-02,10533,3825,352363,168399,6.53568694704443,3.12349238199055,14358,520762,fhi:git
nation,Norge,2021-03-03,17686,18073,370049,186472,6.86372978736941,3.45871336204218,35759,556521,fhi:git
nation,Norge,2021-03-04,16257,18505,386306,204977,7.16526730038326,3.80194714923056,34762,591283,fhi:git
nation,Norge,2021-03-05,11900,6545,398206,211522,7.38599045993699,3.92334488698511,18445,609728,fhi:git
nation,Norge,2021-03-06,382,480,398588,212002,7.39307585884031,3.93224800602593,862,610590,fhi:git
nation,Norge,2021-03-07,92,2,398680,212004,7.3947822899898,3.93228510235526,94,610684,fhi:git
nation,Norge,2021-03-08,4933,47,403613,212051,7.48628038629892,3.93315686609468,4980,615664,fhi:git
nation,Norge,2021-03-09,12466,4272,416079,216323,7.71750180705494,4.012394625558,16738,632402,fhi:git
nation,Norge,2021-03-10,21039,17228,437118,233551,8.10773664351299,4.33194240646485,38267,670669,fhi:git
nation,Norge,2021-03-11,11974,16612,449092,250163,8.32983236725218,4.64006451793598,28586,699255,fhi:git
nation,Norge,2021-03-12,2320,8318,451412,258481,8.37286410928282,4.79434815164757,10638,709893,fhi:git
nation,Norge,2021-03-13,45,304,451457,258785,8.37369877669289,4.79998679370676,349,710242,fhi:git
nation,Norge,2021-03-14,3,109,451460,258894,8.3737544211869,4.80200854365561,112,710354,fhi:git
nation,Norge,2021-03-15,99,438,451559,259332,8.37559068948907,4.81013263978036,537,710891,fhi:git
nation,Norge,2021-03-16,5650,628,457209,259960,8.48038781986542,4.8217808871921,6278,717169,fhi:git
nation,Norge,2021-03-17,23031,1560,480240,261520,8.90757060034288,4.85071602407478,24591,741760,fhi:git
nation,Norge,2021-03-18,20996,1414,501236,262934,9.29700786572019,4.87694312891587,22410,764170,fhi:git
nation,Norge,2021-03-19,6759,970,507995,263904,9.42237491071377,4.89493484864419,7729,771899,fhi:git
nation,Norge,2021-03-20,456,22,508451,263926,9.43083287380255,4.8953429082669,478,772377,fhi:git
nation,Norge,2021-03-21,188,69,508639,263995,9.43431992876021,4.89662273162902,257,772634,fhi:git
nation,Norge,2021-03-22,1505,85,510144,264080,9.46223491658612,4.89819932562583,1590,774224,fhi:git
nation,Norge,2021-03-23,13097,955,523241,265035,9.7051602292479,4.91591282288413,14052,788276,fhi:git
nation,Norge,2021-03-24,39101,3679,562342,268714,10.4304120159462,4.9841515206991,42780,831056,fhi:git
nation,Norge,2021-03-25,38711,2335,601053,271049,11.1484300184239,5.02746148519977,41046,872102,fhi:git
nation,Norge,2021-03-26,17332,1152,618385,272201,11.4699068084563,5.04882897089775,18484,890586,fhi:git
nation,Norge,2021-03-27,593,6,618978,272207,11.4809058701046,5.04894025988576,599,891185,fhi:git
nation,Norge,2021-03-28,329,3,619307,272210,11.4870082162805,5.04899590437976,332,891517,fhi:git
nation,Norge,2021-03-29,4749,27,624056,272237,11.5750934502906,5.04949670482581,4776,896293,fhi:git
nation,Norge,2021-03-30,32134,4026,656190,276263,12.1711201737444,5.1241716157807,36160,932453,fhi:git
nation,Norge,2021-03-31,36662,6989,692852,283252,12.8511329868165,5.25380473864801,43651,976104,fhi:git
nation,Norge,2021-04-01,9412,1472,702264,284724,13.0257083126753,5.28110763703987,10884,986988,fhi:git
nation,Norge,2021-04-02,4301,684,706565,285408,13.105483968914,5.29379458167304,4985,991973,fhi:git
nation,Norge,2021-04-03,262,7,706827,285415,13.1103435880571,5.29392441882572,269,992242,fhi:git
nation,Norge,2021-04-04,388,43,707215,285458,13.1175402759485,5.29472198990646,431,992673,fhi:git
nation,Norge,2021-04-05,1316,58,708531,285516,13.1419496606521,5.29579778345723,1374,994047,fhi:git
nation,Norge,2021-04-06,18512,2540,727043,288056,13.4853132849931,5.34291012171491,21052,1015099,fhi:git
nation,Norge,2021-04-07,58373,3661,785416,291717,14.5680253011805,5.41081495256585,62034,1077133,fhi:git
nation,Norge,2021-04-08,56999,4135,842415,295852,15.6252521391135,5.4875116134696,61134,1138267,fhi:git
nation,Norge,2021-04-09,27016,639,869431,296491,16.1263493557944,5.4993638906927,27655,1165922,fhi:git
nation,Norge,2021-04-10,1038,46,870469,296537,16.1456023507202,5.50021710626744,1084,1167006,fhi:git
nation,Norge,2021-04-11,553,5,871022,296542,16.1558594857818,5.50030984709079,558,1167564,fhi:git
nation,Norge,2021-04-12,3458,82,874480,296624,16.2199990392051,5.50183079659359,3540,1171104,fhi:git
nation,Norge,2021-04-13,23031,356,897511,296980,16.6471818196825,5.50843394321554,23387,1194491,fhi:git
