granularity_geo,location_name,date,new_dose_1,new_dose_2,total_dose_1,total_dose_2,total_pr100_dose_1,total_pr100_dose_2,new_doses,total_doses,source
county,Agder,2020-12-27,0,0,0,0,0.0,0.0,0,0,fhi:git
county,Agder,2020-12-28,0,0,0,0,0.0,0.0,0,0,fhi:git
county,Agder,2020-12-29,0,0,0,0,0.0,0.0,0,0,fhi:git
county,Agder,2020-12-30,0,0,0,0,0.0,0.0,0,0,fhi:git
county,Agder,2020-12-31,0,0,0,0,0.0,0.0,0,0,fhi:git
county,Agder,2021-01-01,0,0,0,0,0.0,0.0,0,0,fhi:git
county,Agder,2021-01-02,0,0,0,0,0.0,0.0,0,0,fhi:git
county,Agder,2021-01-03,3,0,3,0,0.0009764639635974,0.0,3,3,fhi:git
county,Agder,2021-01-04,0,0,3,0,0.0009713673290312,0.0,0,3,fhi:git
county,Agder,2021-01-05,79,0,82,0,0.026550706993521,0.0,79,82,fhi:git
county,Agder,2021-01-06,791,0,873,0,0.282667892748095,0.0,791,873,fhi:git
county,Agder,2021-01-07,230,0,1103,0,0.357139387973825,0.0,230,1103,fhi:git
county,Agder,2021-01-08,49,0,1152,0,0.373005054348002,0.0,49,1152,fhi:git
county,Agder,2021-01-09,0,0,1152,0,0.373005054348002,0.0,0,1152,fhi:git
county,Agder,2021-01-10,0,0,1152,0,0.373005054348002,0.0,0,1152,fhi:git
county,Agder,2021-01-11,1,0,1153,0,0.373328843457679,0.0,1,1153,fhi:git
county,Agder,2021-01-12,226,0,1379,0,0.4465051822447,0.0,226,1379,fhi:git
county,Agder,2021-01-13,850,0,2229,0,0.721725925470223,0.0,850,2229,fhi:git
county,Agder,2021-01-14,513,0,2742,0,0.887829738734567,0.0,513,2742,fhi:git
county,Agder,2021-01-15,119,0,2861,0,0.92636064278614,0.0,119,2861,fhi:git
county,Agder,2021-01-16,1,0,2862,0,0.926684431895818,0.0,1,2862,fhi:git
county,Agder,2021-01-17,2,0,2864,0,0.927332010115172,0.0,2,2864,fhi:git
county,Agder,2021-01-18,15,0,2879,0,0.932188846760328,0.0,15,2879,fhi:git
county,Agder,2021-01-19,346,0,3225,0,1.0442198787086,0.0,346,3225,fhi:git
county,Agder,2021-01-20,460,0,3685,0,1.19316286916006,0.0,460,3685,fhi:git
county,Agder,2021-01-21,337,0,4022,0,1.30227979912124,0.0,337,4022,fhi:git
county,Agder,2021-01-22,67,0,4089,0,1.3239736694696,0.0,67,4089,fhi:git
county,Agder,2021-01-23,2,0,4091,0,1.32462124768896,0.0,2,4091,fhi:git
county,Agder,2021-01-24,0,0,4091,0,1.32462124768896,0.0,0,4091,fhi:git
county,Agder,2021-01-25,3,0,4094,0,1.32559261501799,0.0,3,4094,fhi:git
county,Agder,2021-01-26,63,66,4157,66,1.34599132892764,0.0213700812386876,129,4223,fhi:git
county,Agder,2021-01-27,567,681,4724,747,1.52957975411455,0.241870464928783,1248,5471,fhi:git
county,Agder,2021-01-28,952,248,5676,995,1.83782698652714,0.3221701641287,1200,6671,fhi:git
county,Agder,2021-01-29,204,61,5880,1056,1.90387996490126,0.341921299819002,265,6936,fhi:git
county,Agder,2021-01-30,32,0,5912,1056,1.91424121641093,0.341921299819002,32,6968,fhi:git
county,Agder,2021-01-31,24,0,5936,1056,1.92201215504318,0.341921299819002,24,6992,fhi:git
county,Agder,2021-02-01,1,2,5937,1058,1.92233594415285,0.342568878038356,3,6995,fhi:git
county,Agder,2021-02-02,203,170,6140,1228,1.9880651334173,0.397613026683461,373,7368,fhi:git
county,Agder,2021-02-03,1333,593,7473,1821,2.41967601661686,0.589619968721972,1926,9294,fhi:git
county,Agder,2021-02-04,1710,500,9183,2321,2.97335539416467,0.751514523560515,2210,11504,fhi:git
county,Agder,2021-02-05,619,135,9802,2456,3.17378085305479,0.795226053366921,754,12258,fhi:git
county,Agder,2021-02-06,512,2,10314,2458,3.33956087720946,0.795873631586275,514,12772,fhi:git
county,Agder,2021-02-07,83,2,10397,2460,3.36643537331265,0.796521209805629,85,12857,fhi:git
county,Agder,2021-02-08,13,2,10410,2462,3.37064463173846,0.797168788024984,15,12872,fhi:git
county,Agder,2021-02-09,189,254,10599,2716,3.43184077346743,0.879411221882963,443,13315,fhi:git
county,Agder,2021-02-10,1151,371,11750,3087,3.80452203870575,0.999536981573162,1522,14837,fhi:git
county,Agder,2021-02-11,1010,409,12760,3496,4.13154903947961,1.13196672743109,1419,16256,fhi:git
county,Agder,2021-02-12,356,69,13116,3565,4.24681796252465,1.15430817599881,425,16681,fhi:git
county,Agder,2021-02-13,509,3,13625,3568,4.41162661935029,1.15527954332784,512,17193,fhi:git
county,Agder,2021-02-14,0,0,13625,3568,4.41162661935029,1.15527954332784,0,17193,fhi:git
county,Agder,2021-02-15,1,1,13626,3569,4.41195040845996,1.15560333243752,2,17195,fhi:git
county,Agder,2021-02-16,141,117,13767,3686,4.45760467292443,1.19348665826974,258,17453,fhi:git
county,Agder,2021-02-17,1219,435,14986,4121,4.8523035976208,1.33433492097927,1654,19107,fhi:git
county,Agder,2021-02-18,1089,820,16075,4941,5.20490993805914,1.59984199091448,1909,21016,fhi:git
county,Agder,2021-02-19,721,343,16796,5284,5.43836188613632,1.71090165553372,1064,22080,fhi:git
county,Agder,2021-02-20,355,37,17151,5321,5.55330702007169,1.72288185259177,392,22472,fhi:git
county,Agder,2021-02-21,52,23,17203,5344,5.5701440537749,1.73032900211434,75,22547,fhi:git
county,Agder,2021-02-22,223,1,17426,5345,5.64234902523289,1.73065279122402,224,22771,fhi:git
county,Agder,2021-02-23,294,201,17720,5546,5.73754302347795,1.79573440226911,495,23266,fhi:git
county,Agder,2021-02-24,976,1111,18696,6657,6.05356119452278,2.15546410312036,2087,25353,fhi:git
county,Agder,2021-02-25,717,1568,19413,8225,6.28571798616125,2.66316542709403,2285,27638,fhi:git
county,Agder,2021-02-26,399,466,19812,8691,6.41490984092241,2.81405115220355,865,28503,fhi:git
county,Agder,2021-02-27,0,1,19812,8692,6.41490984092241,2.81437494131322,1,28504,fhi:git
county,Agder,2021-02-28,10,82,19822,8774,6.41814773201918,2.84092564830674,92,28596,fhi:git
county,Agder,2021-03-01,263,0,20085,8774,6.50330426786425,2.84092564830674,263,28859,fhi:git
county,Agder,2021-03-02,578,192,20663,8966,6.69045437325761,2.90309315736475,770,29629,fhi:git
county,Agder,2021-03-03,635,878,21298,9844,6.89606045790256,3.18737999566123,1513,31142,fhi:git
county,Agder,2021-03-04,796,1068,22094,10912,7.15379658920552,3.53318676479635,1864,33006,fhi:git
county,Agder,2021-03-05,961,382,23055,11294,7.4649579236052,3.656874204693,1343,34349,fhi:git
county,Agder,2021-03-06,36,405,23091,11699,7.47661433155357,3.78800879411222,441,34790,fhi:git
county,Agder,2021-03-07,3,0,23094,11699,7.4775856988826,3.78800879411222,3,34793,fhi:git
county,Agder,2021-03-08,225,0,23319,11699,7.55043824855995,3.78800879411222,225,35018,fhi:git
county,Agder,2021-03-09,723,141,24042,11840,7.78453777485648,3.83366305857669,864,35882,fhi:git
county,Agder,2021-03-10,1032,784,25074,12624,8.11868813604323,4.08751372056352,1816,37698,fhi:git
county,Agder,2021-03-11,647,813,25721,13437,8.32817969000431,4.35075426673099,1460,39158,fhi:git
county,Agder,2021-03-12,98,325,25819,13762,8.35991102275266,4.45598572737605,423,39581,fhi:git
county,Agder,2021-03-13,0,0,25819,13762,8.35991102275266,4.45598572737605,0,39581,fhi:git
county,Agder,2021-03-14,0,0,25819,13762,8.35991102275266,4.45598572737605,0,39581,fhi:git
county,Agder,2021-03-15,0,3,25819,13765,8.35991102275266,4.45695709470508,3,39584,fhi:git
county,Agder,2021-03-16,240,14,26059,13779,8.43762040907516,4.46149014224056,254,39838,fhi:git
county,Agder,2021-03-17,1608,47,27667,13826,8.95827329743591,4.47670823039538,1655,41493,fhi:git
county,Agder,2021-03-18,1249,89,28916,13915,9.36268589542259,4.50552546115664,1338,42831,fhi:git
county,Agder,2021-03-19,264,41,29180,13956,9.44816622037734,4.5188008146534,305,43136,fhi:git
county,Agder,2021-03-20,0,0,29180,13956,9.44816622037734,4.5188008146534,0,43136,fhi:git
county,Agder,2021-03-21,17,53,29197,14009,9.45367063524185,4.53596163746629,70,43206,fhi:git
county,Agder,2021-03-22,9,1,29206,14010,9.45658473722895,4.53628542657596,10,43216,fhi:git
county,Agder,2021-03-23,314,14,29520,14024,9.55825451766755,4.54081847411144,328,43544,fhi:git
county,Agder,2021-03-24,2267,75,31787,14099,10.2922844293055,4.56510265733722,2342,45886,fhi:git
county,Agder,2021-03-25,2037,53,33824,14152,10.9518428457177,4.58226348015011,2090,47976,fhi:git
county,Agder,2021-03-26,775,12,34599,14164,11.2027794057175,4.58614894946623,787,48763,fhi:git
county,Agder,2021-03-27,0,0,34599,14164,11.2027794057175,4.58614894946623,0,48763,fhi:git
county,Agder,2021-03-28,173,1,34772,14165,11.2587949216916,4.58647273857591,174,48937,fhi:git
county,Agder,2021-03-29,107,0,34879,14165,11.2934403564271,4.58647273857591,107,49044,fhi:git
county,Agder,2021-03-30,686,71,35565,14236,11.5155596856655,4.60946176536298,757,49801,fhi:git
county,Agder,2021-03-31,3365,401,38930,14637,12.6051100397289,4.7393011983435,3766,53567,fhi:git
county,Agder,2021-04-01,235,47,39165,14684,12.681200480503,4.75451928649832,282,53849,fhi:git
county,Agder,2021-04-02,1,0,39166,14684,12.6815242696127,4.75451928649832,1,53850,fhi:git
county,Agder,2021-04-03,12,0,39178,14684,12.6854097389288,4.75451928649832,12,53862,fhi:git
county,Agder,2021-04-04,1,5,39179,14689,12.6857335280385,4.7561382320467,6,53868,fhi:git
county,Innlandet,2020-12-27,0,0,0,0,0.0,0.0,0,0,fhi:git
county,Innlandet,2020-12-28,272,0,272,0,0.0732393607711674,0.0,272,272,fhi:git
county,Innlandet,2020-12-29,260,0,532,0,0.143247573273019,0.0,260,532,fhi:git
county,Innlandet,2020-12-30,149,0,681,0,0.183367664283695,0.0,149,681,fhi:git
county,Innlandet,2020-12-31,0,0,681,0,0.183367664283695,0.0,0,681,fhi:git
county,Innlandet,2021-01-01,0,0,681,0,0.183367664283695,0.0,0,681,fhi:git
county,Innlandet,2021-01-02,0,0,681,0,0.183367664283695,0.0,0,681,fhi:git
county,Innlandet,2021-01-03,0,0,681,0,0.183367664283695,0.0,0,681,fhi:git
county,Innlandet,2021-01-04,0,0,681,0,0.183754583745949,0.0,0,681,fhi:git
county,Innlandet,2021-01-05,271,0,952,0,0.256878654517098,0.0,271,952,fhi:git
county,Innlandet,2021-01-06,703,0,1655,0,0.446569509690963,0.0,703,1655,fhi:git
county,Innlandet,2021-01-07,696,0,2351,0,0.634371551228673,0.0,696,2351,fhi:git
county,Innlandet,2021-01-08,75,0,2426,0,0.654608840187478,0.0,75,2426,fhi:git
county,Innlandet,2021-01-09,0,0,2426,0,0.654608840187478,0.0,0,2426,fhi:git
county,Innlandet,2021-01-10,0,0,2426,0,0.654608840187478,0.0,0,2426,fhi:git
county,Innlandet,2021-01-11,50,0,2476,0,0.668100366160015,0.0,50,2476,fhi:git
county,Innlandet,2021-01-12,403,0,2879,0,0.77684206549866,0.0,403,2879,fhi:git
county,Innlandet,2021-01-13,993,0,3872,0,1.04478377131324,0.0,993,3872,fhi:git
county,Innlandet,2021-01-14,957,0,4829,0,1.30301157842759,0.0,957,4829,fhi:git
county,Innlandet,2021-01-15,280,0,5109,0,1.3785641238738,0.0,280,5109,fhi:git
county,Innlandet,2021-01-16,4,0,5113,0,1.3796434459516,0.0,4,5113,fhi:git
county,Innlandet,2021-01-17,0,0,5113,0,1.3796434459516,0.0,0,5113,fhi:git
county,Innlandet,2021-01-18,62,0,5175,0,1.39637293815754,0.0,62,5175,fhi:git
county,Innlandet,2021-01-19,331,318,5506,318,1.48568684009574,0.0858061051853331,649,5824,fhi:git
county,Innlandet,2021-01-20,663,252,6169,570,1.66458447449157,0.153803396086918,915,6739,fhi:git
county,Innlandet,2021-01-21,833,48,7002,618,1.88935329719403,0.166755261020553,881,7620,fhi:git
county,Innlandet,2021-01-22,239,0,7241,618,1.95384279134276,0.166755261020553,239,7859,fhi:git
county,Innlandet,2021-01-23,6,0,7247,618,1.95546177445946,0.166755261020553,6,7865,fhi:git
county,Innlandet,2021-01-24,0,0,7247,618,1.95546177445946,0.166755261020553,0,7865,fhi:git
county,Innlandet,2021-01-25,1,0,7248,618,1.95573160497891,0.166755261020553,1,7866,fhi:git
county,Innlandet,2021-01-26,152,131,7400,749,1.99674584393542,0.202103059068599,283,8149,fhi:git
county,Innlandet,2021-01-27,934,604,8334,1353,2.24876754910241,0.365080692816842,1538,9687,fhi:git
county,Innlandet,2021-01-28,903,708,9237,2061,2.49242450816642,0.556120700587961,1611,11298,fhi:git
county,Innlandet,2021-01-29,319,132,9556,2193,2.5785004438712,0.591738329155457,451,11749,fhi:git
county,Innlandet,2021-01-30,2,0,9558,2193,2.57904010491011,0.591738329155457,2,11751,fhi:git
county,Innlandet,2021-01-31,1,0,9559,2193,2.57930993542956,0.591738329155457,1,11752,fhi:git
county,Innlandet,2021-02-01,9,49,9568,2242,2.58173841010461,0.604960024608543,58,11810,fhi:git
county,Innlandet,2021-02-02,610,341,10178,2583,2.74633502696956,0.696972231741243,951,12761,fhi:git
county,Innlandet,2021-02-03,2310,872,12488,3455,3.36964352690075,0.932264444702282,3182,15943,fhi:git
county,Innlandet,2021-02-04,2656,997,15144,4452,4.0863133865619,1.20128547259466,3653,19596,fhi:git
county,Innlandet,2021-02-05,815,271,15959,4723,4.30622525991425,1.27440954336581,1086,20682,fhi:git
county,Innlandet,2021-02-06,7,4,15966,4727,4.3081140735504,1.27548886544361,11,20693,fhi:git
county,Innlandet,2021-02-07,0,0,15966,4727,4.3081140735504,1.27548886544361,0,20693,fhi:git
county,Innlandet,2021-02-08,2,62,15968,4789,4.3086537345893,1.29221835764956,64,20757,fhi:git
county,Innlandet,2021-02-09,257,269,16225,5058,4.37800017808814,1.36480276738181,526,21283,fhi:git
county,Innlandet,2021-02-10,2056,589,18281,5647,4.93277172607885,1.52373294333829,2645,23928,fhi:git
county,Innlandet,2021-02-11,2237,847,20518,6494,5.53638259809014,1.75227939331306,3084,27012,fhi:git
county,Innlandet,2021-02-12,430,283,20948,6777,5.65240972145396,1.82864143031762,713,27725,fhi:git
county,Innlandet,2021-02-13,0,5,20948,6782,5.65240972145396,1.82999058291487,5,27730,fhi:git
county,Innlandet,2021-02-14,1,1,20949,6783,5.65267955197341,1.83026041343432,2,27732,fhi:git
county,Innlandet,2021-02-15,86,14,21035,6797,5.67588497664617,1.83403804070663,100,27832,fhi:git
county,Innlandet,2021-02-16,530,92,21565,6889,5.81889515195506,1.8588624484961,622,28454,fhi:git
county,Innlandet,2021-02-17,1572,782,23137,7671,6.24306872853161,2.06986991470657,2354,30808,fhi:git
county,Innlandet,2021-02-18,1467,902,24604,8573,6.63891010056583,2.31325704325113,2369,33177,fhi:git
county,Innlandet,2021-02-19,541,296,25145,8869,6.78488841158868,2.39312687700855,837,34014,fhi:git
county,Innlandet,2021-02-20,0,3,25145,8872,6.78488841158868,2.3939363685669,3,34017,fhi:git
county,Innlandet,2021-02-21,0,1,25145,8873,6.78488841158868,2.39420619908635,1,34018,fhi:git
county,Innlandet,2021-02-22,284,3,25429,8876,6.86152027911269,2.39501569064471,287,34305,fhi:git
county,Innlandet,2021-02-23,320,306,25749,9182,6.94786604533692,2.47758382959663,626,34931,fhi:git
county,Innlandet,2021-02-24,852,2319,26601,11501,7.17776164790895,3.10332080420288,3171,38102,fhi:git
county,Innlandet,2021-02-25,1749,2452,28350,13953,7.64969522642828,3.76494523789608,4201,42303,fhi:git
county,Innlandet,2021-02-26,676,814,29026,14767,7.83210065757698,3.98458728072897,1490,43793,fhi:git
county,Innlandet,2021-02-27,3,1,29029,14768,7.83291014913533,3.98485711124843,4,43797,fhi:git
county,Innlandet,2021-02-28,3,6,29032,14774,7.83371964069368,3.98647609436513,9,43806,fhi:git
county,Innlandet,2021-03-01,189,7,29221,14781,7.88471760886987,3.98836490800128,196,44002,fhi:git
county,Innlandet,2021-03-02,528,159,29749,14940,8.02718812313986,4.03126796059395,687,44689,fhi:git
county,Innlandet,2021-03-03,1597,1970,31346,16910,8.45810746270268,4.5628340839119,3567,48256,fhi:git
county,Innlandet,2021-03-04,1520,2263,32866,19173,8.86824985226779,5.1734605494289,3783,52039,fhi:git
county,Innlandet,2021-03-05,547,421,33413,19594,9.01584714640734,5.28705919811766,968,53007,fhi:git
county,Innlandet,2021-03-06,7,3,33420,19597,9.0177359600435,5.28786868967602,10,53017,fhi:git
county,Innlandet,2021-03-07,0,0,33420,19597,9.0177359600435,5.28786868967602,0,53017,fhi:git
county,Innlandet,2021-03-08,111,0,33531,19597,9.04768714770253,5.28786868967602,111,53128,fhi:git
county,Innlandet,2021-03-09,936,311,34467,19908,9.30024851390841,5.37178598122519,1247,54375,fhi:git
county,Innlandet,2021-03-10,2026,1306,36493,21214,9.8469251463156,5.72418463962785,3332,57707,fhi:git
county,Innlandet,2021-03-11,1014,968,37507,22182,10.1205332930386,5.98538058245616,1982,59689,fhi:git
county,Innlandet,2021-03-12,43,180,37550,22362,10.132136005375,6.03395007595729,223,59912,fhi:git
county,Innlandet,2021-03-13,0,0,37550,22362,10.132136005375,6.03395007595729,0,59912,fhi:git
county,Innlandet,2021-03-14,0,7,37550,22369,10.132136005375,6.03583888959345,7,59919,fhi:git
county,Innlandet,2021-03-15,25,3,37575,22372,10.1388817683613,6.0366483811518,28,59947,fhi:git
county,Innlandet,2021-03-16,361,9,37936,22381,10.236290585883,6.03907685582686,370,60317,fhi:git
county,Innlandet,2021-03-17,1802,153,39738,22534,10.7225251819332,6.08036092530282,1955,62272,fhi:git
county,Innlandet,2021-03-18,1650,104,41388,22638,11.1677455390269,6.10842329932569,1754,64026,fhi:git
county,Innlandet,2021-03-19,190,20,41578,22658,11.2190133377226,6.11381990971471,210,64236,fhi:git
county,Innlandet,2021-03-20,0,0,41578,22658,11.2190133377226,6.11381990971471,0,64236,fhi:git
county,Innlandet,2021-03-21,1,0,41579,22658,11.219283168242,6.11381990971471,1,64237,fhi:git
county,Innlandet,2021-03-22,98,9,41677,22667,11.2457265591482,6.11624838438977,107,64344,fhi:git
county,Innlandet,2021-03-23,809,51,42486,22718,11.4640194493838,6.13000974088175,860,65204,fhi:git
county,Innlandet,2021-03-24,3237,520,45723,23238,12.3374608408459,6.27032161099613,3757,68961,fhi:git
county,Innlandet,2021-03-25,3196,319,48919,23557,13.1998391810104,6.35639754670092,3515,72476,fhi:git
county,Innlandet,2021-03-26,671,52,49590,23609,13.3808954595618,6.37042873371236,723,73199,fhi:git
county,Innlandet,2021-03-27,0,0,49590,23609,13.3808954595618,6.37042873371236,0,73199,fhi:git
county,Innlandet,2021-03-28,0,0,49590,23609,13.3808954595618,6.37042873371236,0,73199,fhi:git
county,Innlandet,2021-03-29,397,2,49987,23611,13.4880181757838,6.37096839475126,399,73598,fhi:git
county,Innlandet,2021-03-30,2793,227,52780,23838,14.2416548166097,6.43221992266657,3020,76618,fhi:git
county,Innlandet,2021-03-31,2833,559,55613,24397,15.0060846782136,6.58305518303953,3392,80010,fhi:git
county,Innlandet,2021-04-01,88,18,55701,24415,15.0298297639253,6.58791213238965,106,80116,fhi:git
county,Innlandet,2021-04-02,6,1,55707,24416,15.031448747042,6.5881819629091,7,80123,fhi:git
county,Innlandet,2021-04-03,0,6,55707,24422,15.031448747042,6.5898009460258,6,80129,fhi:git
county,Innlandet,2021-04-04,0,0,55707,24422,15.031448747042,6.5898009460258,0,80129,fhi:git
county,Møre og Romsdal,2020-12-27,0,0,0,0,0.0,0.0,0,0,fhi:git
county,Møre og Romsdal,2020-12-28,1,0,1,0,0.0003770198840286,0.0,1,1,fhi:git
county,Møre og Romsdal,2020-12-29,0,0,1,0,0.0003770198840286,0.0,0,1,fhi:git
county,Møre og Romsdal,2020-12-30,0,0,1,0,0.0003770198840286,0.0,0,1,fhi:git
county,Møre og Romsdal,2020-12-31,0,0,1,0,0.0003770198840286,0.0,0,1,fhi:git
county,Møre og Romsdal,2021-01-01,0,0,1,0,0.0003770198840286,0.0,0,1,fhi:git
county,Møre og Romsdal,2021-01-02,0,0,1,0,0.0003770198840286,0.0,0,1,fhi:git
county,Møre og Romsdal,2021-01-03,0,0,1,0,0.0003770198840286,0.0,0,1,fhi:git
county,Møre og Romsdal,2021-01-04,0,0,1,0,0.0003765854246377,0.0,0,1,fhi:git
county,Møre og Romsdal,2021-01-05,186,0,187,0,0.0704214744072545,0.0,186,187,fhi:git
county,Møre og Romsdal,2021-01-06,496,0,683,0,0.257207845027566,0.0,496,683,fhi:git
county,Møre og Romsdal,2021-01-07,457,0,1140,0,0.429307384087006,0.0,457,1140,fhi:git
county,Møre og Romsdal,2021-01-08,36,0,1176,0,0.442864459373964,0.0,36,1176,fhi:git
county,Møre og Romsdal,2021-01-09,1,0,1177,0,0.443241044798602,0.0,1,1177,fhi:git
county,Møre og Romsdal,2021-01-10,0,0,1177,0,0.443241044798602,0.0,0,1177,fhi:git
county,Møre og Romsdal,2021-01-11,1,0,1178,0,0.44361763022324,0.0,1,1178,fhi:git
county,Møre og Romsdal,2021-01-12,225,0,1403,0,0.528349350766728,0.0,225,1403,fhi:git
county,Møre og Romsdal,2021-01-13,387,0,1790,0,0.674087910101528,0.0,387,1790,fhi:git
county,Møre og Romsdal,2021-01-14,410,0,2200,0,0.828487934202995,0.0,410,2200,fhi:git
county,Møre og Romsdal,2021-01-15,151,0,2351,0,0.885352333323291,0.0,151,2351,fhi:git
county,Møre og Romsdal,2021-01-16,1,0,2352,0,0.885728918747929,0.0,1,2352,fhi:git
county,Møre og Romsdal,2021-01-17,2,0,2354,0,0.886482089597204,0.0,2,2354,fhi:git
county,Møre og Romsdal,2021-01-18,11,0,2365,0,0.890624529268219,0.0,11,2365,fhi:git
county,Møre og Romsdal,2021-01-19,203,0,2568,0,0.967071370469677,0.0,203,2568,fhi:git
county,Møre og Romsdal,2021-01-20,501,0,3069,0,1.15574066821318,0.0,501,3069,fhi:git
county,Møre og Romsdal,2021-01-21,800,0,3869,0,1.45700900792336,0.0,800,3869,fhi:git
county,Møre og Romsdal,2021-01-22,212,0,4081,0,1.53684511794656,0.0,212,4081,fhi:git
county,Møre og Romsdal,2021-01-23,0,0,4081,0,1.53684511794656,0.0,0,4081,fhi:git
county,Møre og Romsdal,2021-01-24,0,0,4081,0,1.53684511794656,0.0,0,4081,fhi:git
county,Møre og Romsdal,2021-01-25,3,0,4084,0,1.53797487422047,0.0,3,4084,fhi:git
county,Møre og Romsdal,2021-01-26,78,129,4162,129,1.56734853734221,0.0485795197782665,207,4291,fhi:git
county,Møre og Romsdal,2021-01-27,543,358,4705,487,1.7718344229205,0.183397101798572,901,5192,fhi:git
county,Møre og Romsdal,2021-01-28,493,509,5198,996,1.95749103726689,0.375079082939174,1002,6194,fhi:git
county,Møre og Romsdal,2021-01-29,99,78,5297,1074,1.99477299430603,0.404452746060916,177,6371,fhi:git
county,Møre og Romsdal,2021-01-30,0,1,5297,1075,1.99477299430603,0.404829331485554,1,6372,fhi:git
county,Møre og Romsdal,2021-01-31,0,0,5297,1075,1.99477299430603,0.404829331485554,0,6372,fhi:git
county,Møre og Romsdal,2021-02-01,0,0,5297,1075,1.99477299430603,0.404829331485554,0,6372,fhi:git
county,Møre og Romsdal,2021-02-02,291,193,5588,1268,2.10435935287561,0.477510318440635,484,6856,fhi:git
county,Møre og Romsdal,2021-02-03,1063,312,6651,1580,2.50466965926551,0.595004970927605,1375,8231,fhi:git
county,Møre og Romsdal,2021-02-04,1545,463,8196,2043,3.08649414033079,0.769364022534872,2008,10239,fhi:git
county,Møre og Romsdal,2021-02-05,219,155,8415,2198,3.16896634832645,0.827734763353719,374,10613,fhi:git
county,Møre og Romsdal,2021-02-06,1,2,8416,2200,3.16934293375109,0.828487934202995,3,10616,fhi:git
county,Møre og Romsdal,2021-02-07,0,1,8416,2201,3.16934293375109,0.828864519627632,1,10617,fhi:git
county,Møre og Romsdal,2021-02-08,1,2,8417,2203,3.16971951917573,0.829617690476908,3,10620,fhi:git
county,Møre og Romsdal,2021-02-09,326,183,8743,2386,3.29248636760763,0.898532823185611,509,11129,fhi:git
county,Møre og Romsdal,2021-02-10,1258,436,10001,2822,3.76623083180189,1.06272406832766,1694,12823,fhi:git
county,Møre og Romsdal,2021-02-11,1254,804,11255,3626,4.23846895429759,1.36549874973639,2058,14881,fhi:git
county,Møre og Romsdal,2021-02-12,295,207,11550,3833,4.34956165456572,1.4434519326364,502,15383,fhi:git
county,Møre og Romsdal,2021-02-13,24,0,11574,3833,4.35859970475703,1.4434519326364,24,15407,fhi:git
county,Møre og Romsdal,2021-02-14,0,0,11574,3833,4.35859970475703,1.4434519326364,0,15407,fhi:git
county,Møre og Romsdal,2021-02-15,1,8,11575,3841,4.35897629018166,1.4464646160335,9,15416,fhi:git
county,Møre og Romsdal,2021-02-16,354,58,11929,3899,4.49228753050342,1.46830657066249,412,15828,fhi:git
county,Møre og Romsdal,2021-02-17,1204,424,13133,4323,4.94569638176724,1.62797879070888,1628,17456,fhi:git
county,Møre og Romsdal,2021-02-18,1165,522,14298,4845,5.38441840147019,1.82455638236978,1687,19143,fhi:git
county,Møre og Romsdal,2021-02-19,499,94,14797,4939,5.57233452836441,1.85995541228572,593,19736,fhi:git
county,Møre og Romsdal,2021-02-20,11,0,14808,4939,5.57647696803543,1.85995541228572,11,19747,fhi:git
county,Møre og Romsdal,2021-02-21,0,0,14808,4939,5.57647696803543,1.85995541228572,0,19747,fhi:git
county,Møre og Romsdal,2021-02-22,15,0,14823,4939,5.582125749405,1.85995541228572,15,19762,fhi:git
county,Møre og Romsdal,2021-02-23,392,223,15215,5162,5.72974723586298,1.94393396197994,615,20377,fhi:git
county,Møre og Romsdal,2021-02-24,729,876,15944,6038,6.00427801042388,2.27382279396258,1605,21982,fhi:git
county,Møre og Romsdal,2021-02-25,704,1475,16648,7513,6.26939414936884,2.82928629530323,2179,24161,fhi:git
county,Møre og Romsdal,2021-02-26,260,203,16908,7716,6.36730635977465,2.90573313650468,463,24624,fhi:git
county,Møre og Romsdal,2021-02-27,2,1,16910,7717,6.36805953062393,2.90610972192932,3,24627,fhi:git
county,Møre og Romsdal,2021-02-28,0,0,16910,7717,6.36805953062393,2.90610972192932,0,24627,fhi:git
county,Møre og Romsdal,2021-03-01,101,1,17011,7718,6.40609465851234,2.90648630735396,102,24729,fhi:git
county,Møre og Romsdal,2021-03-02,741,251,17752,7969,6.68514445816889,3.00100924893803,992,25721,fhi:git
county,Møre og Romsdal,2021-03-03,869,1116,18621,9085,7.01239719217907,3.42127858283373,1985,27706,fhi:git
county,Møre og Romsdal,2021-03-04,988,1303,19609,10388,7.38446359172115,3.91196939113669,2291,29997,fhi:git
county,Møre og Romsdal,2021-03-05,815,274,20424,10662,7.69138071280089,4.01515379748742,1089,31086,fhi:git
county,Møre og Romsdal,2021-03-06,3,6,20427,10668,7.69251046907481,4.01741331003525,9,31095,fhi:git
county,Møre og Romsdal,2021-03-07,0,0,20427,10668,7.69251046907481,4.01741331003525,0,31095,fhi:git
county,Møre og Romsdal,2021-03-08,157,0,20584,10668,7.75163438074293,4.01741331003525,157,31252,fhi:git
county,Møre og Romsdal,2021-03-09,670,238,21254,10906,8.0039466152502,4.10704064109903,908,32160,fhi:git
county,Møre og Romsdal,2021-03-10,1286,946,22540,11852,8.48823547133432,4.46329045280631,2232,34392,fhi:git
county,Møre og Romsdal,2021-03-11,539,973,23079,12825,8.69121501521405,4.82970807097882,1512,35904,fhi:git
county,Møre og Romsdal,2021-03-12,66,249,23145,13074,8.71606965324014,4.92347784171361,315,36219,fhi:git
county,Møre og Romsdal,2021-03-13,0,16,23145,13090,8.71606965324014,4.92950320850782,16,36235,fhi:git
county,Møre og Romsdal,2021-03-14,0,0,23145,13090,8.71606965324014,4.92950320850782,0,36235,fhi:git
county,Møre og Romsdal,2021-03-15,0,1,23145,13091,8.71606965324014,4.92987979393246,1,36236,fhi:git
county,Møre og Romsdal,2021-03-16,334,10,23479,13101,8.84184918506914,4.93364564817883,344,36580,fhi:git
county,Møre og Romsdal,2021-03-17,1536,128,25015,13229,9.42028439731269,4.98184858253246,1664,38244,fhi:git
county,Møre og Romsdal,2021-03-18,1485,60,26500,13289,9.97951375289971,5.00444370801073,1545,39789,fhi:git
county,Møre og Romsdal,2021-03-19,205,37,26705,13326,10.0567137649504,5.01837736872232,242,40031,fhi:git
county,Møre og Romsdal,2021-03-20,18,0,26723,13326,10.0634923025939,5.01837736872232,18,40049,fhi:git
county,Møre og Romsdal,2021-03-21,0,0,26723,13326,10.0634923025939,5.01837736872232,0,40049,fhi:git
county,Møre og Romsdal,2021-03-22,1,7,26724,13333,10.0638688880186,5.02101346669479,8,40057,fhi:git
county,Møre og Romsdal,2021-03-23,598,19,27322,13352,10.2890669719519,5.0281685897629,617,40674,fhi:git
county,Møre og Romsdal,2021-03-24,1808,48,29130,13400,10.9699334196969,5.04624469014551,1856,42530,fhi:git
county,Møre og Romsdal,2021-03-25,2316,70,31446,13470,11.8421052631579,5.07260566987015,2386,44916,fhi:git
county,Møre og Romsdal,2021-03-26,225,19,31671,13489,11.9268369837014,5.07976079293827,244,45160,fhi:git
county,Møre og Romsdal,2021-03-27,25,1,31696,13490,11.9362516193173,5.08013737836291,26,45186,fhi:git
county,Møre og Romsdal,2021-03-28,0,0,31696,13490,11.9362516193173,5.08013737836291,0,45186,fhi:git
county,Møre og Romsdal,2021-03-29,7,5,31703,13495,11.9388877172898,5.0820203054861,12,45198,fhi:git
county,Møre og Romsdal,2021-03-30,2218,94,33921,13589,12.7741541891363,5.11741933540204,2312,47510,fhi:git
county,Møre og Romsdal,2021-03-31,1769,180,35690,13769,13.4403338053204,5.18520471183683,1949,49459,fhi:git
county,Møre og Romsdal,2021-04-01,99,26,35789,13795,13.4776157623595,5.19499593287741,125,49584,fhi:git
county,Møre og Romsdal,2021-04-02,19,1,35808,13796,13.4847708854276,5.19537251830205,20,49604,fhi:git
county,Møre og Romsdal,2021-04-03,14,0,35822,13796,13.4900430813726,5.19537251830205,14,49618,fhi:git
county,Møre og Romsdal,2021-04-04,0,0,35822,13796,13.4900430813726,5.19537251830205,0,49618,fhi:git
county,Nordland,2020-12-27,0,0,0,0,0.0,0.0,0,0,fhi:git
county,Nordland,2020-12-28,0,0,0,0,0.0,0.0,0,0,fhi:git
county,Nordland,2020-12-29,0,0,0,0,0.0,0.0,0,0,fhi:git
county,Nordland,2020-12-30,1,0,1,0,0.0004145335461272,0.0,1,1,fhi:git
county,Nordland,2020-12-31,0,0,1,0,0.0004145335461272,0.0,0,1,fhi:git
county,Nordland,2021-01-01,0,0,1,0,0.0004145335461272,0.0,0,1,fhi:git
county,Nordland,2021-01-02,0,0,1,0,0.0004145335461272,0.0,0,1,fhi:git
county,Nordland,2021-01-03,0,0,1,0,0.0004145335461272,0.0,0,1,fhi:git
county,Nordland,2021-01-04,0,0,1,0,0.0004160685681,0.0,0,1,fhi:git
county,Nordland,2021-01-05,200,0,201,0,0.0836297821881046,0.0,200,201,fhi:git
county,Nordland,2021-01-06,686,0,887,0,0.36905281990472,0.0,686,887,fhi:git
county,Nordland,2021-01-07,238,0,1125,0,0.468077139112526,0.0,238,1125,fhi:git
county,Nordland,2021-01-08,114,0,1239,0,0.515508955875928,0.0,114,1239,fhi:git
county,Nordland,2021-01-09,0,0,1239,0,0.515508955875928,0.0,0,1239,fhi:git
county,Nordland,2021-01-10,0,0,1239,0,0.515508955875928,0.0,0,1239,fhi:git
county,Nordland,2021-01-11,0,0,1239,0,0.515508955875928,0.0,0,1239,fhi:git
county,Nordland,2021-01-12,292,0,1531,0,0.637000977761135,0.0,292,1531,fhi:git
county,Nordland,2021-01-13,627,0,2158,0,0.897875969959849,0.0,627,2158,fhi:git
county,Nordland,2021-01-14,272,0,2430,0,1.01104662048306,0.0,272,2430,fhi:git
county,Nordland,2021-01-15,69,0,2499,0,1.03975535168196,0.0,69,2499,fhi:git
county,Nordland,2021-01-16,0,0,2499,0,1.03975535168196,0.0,0,2499,fhi:git
county,Nordland,2021-01-17,1,0,2500,0,1.04017142025006,0.0,1,2500,fhi:git
county,Nordland,2021-01-18,0,0,2500,0,1.04017142025006,0.0,0,2500,fhi:git
county,Nordland,2021-01-19,313,0,2813,0,1.17040088206536,0.0,313,2813,fhi:git
county,Nordland,2021-01-20,786,0,3599,0,1.49743077659198,0.0,786,3599,fhi:git
county,Nordland,2021-01-21,616,0,4215,0,1.7537290145416,0.0,616,4215,fhi:git
county,Nordland,2021-01-22,173,0,4388,0,1.8257088768229,0.0,173,4388,fhi:git
county,Nordland,2021-01-23,4,0,4392,0,1.8273731510953,0.0,4,4392,fhi:git
county,Nordland,2021-01-24,0,0,4392,0,1.8273731510953,0.0,0,4392,fhi:git
county,Nordland,2021-01-25,51,0,4443,0,1.8485926480684,0.0,51,4443,fhi:git
county,Nordland,2021-01-26,119,90,4562,90,1.8981048076723,0.0374461711290021,209,4652,fhi:git
county,Nordland,2021-01-27,626,528,5188,618,2.15856373130292,0.257130375085814,1154,5806,fhi:git
county,Nordland,2021-01-28,471,365,5659,983,2.35453202687803,0.408995402442323,836,6642,fhi:git
county,Nordland,2021-01-29,212,144,5871,1127,2.44273856331523,0.468909276248726,356,6998,fhi:git
county,Nordland,2021-01-30,1,0,5872,1127,2.44315463188333,0.468909276248726,1,6999,fhi:git
county,Nordland,2021-01-31,0,0,5872,1127,2.44315463188333,0.468909276248726,0,6999,fhi:git
county,Nordland,2021-02-01,9,4,5881,1131,2.44689924899624,0.470573550521126,13,7012,fhi:git
county,Nordland,2021-02-02,111,200,5992,1331,2.49308286005534,0.553787264141131,311,7323,fhi:git
county,Nordland,2021-02-03,1419,456,7411,1787,3.08348415818927,0.743514531194741,1875,9198,fhi:git
county,Nordland,2021-02-04,1670,347,9081,2134,3.77831866691631,0.887890324325449,2017,11215,fhi:git
county,Nordland,2021-02-05,329,155,9410,2289,3.91520522582122,0.952380952380952,484,11699,fhi:git
county,Nordland,2021-02-06,0,0,9410,2289,3.91520522582122,0.952380952380952,0,11699,fhi:git
county,Nordland,2021-02-07,1,0,9411,2289,3.91562129438932,0.952380952380952,1,11700,fhi:git
county,Nordland,2021-02-08,7,1,9418,2290,3.91853377436602,0.952797020949052,8,11708,fhi:git
county,Nordland,2021-02-09,70,262,9488,2552,3.94765857413302,1.06180698579126,332,12040,fhi:git
county,Nordland,2021-02-10,2030,633,11518,3185,4.79227776737606,1.32517838939857,2663,14703,fhi:git
county,Nordland,2021-02-11,1222,583,12740,3768,5.30071355759429,1.56774636460089,1805,16508,fhi:git
county,Nordland,2021-02-12,287,238,13027,4006,5.420125236639,1.66677068380869,525,17033,fhi:git
county,Nordland,2021-02-13,53,3,13080,4009,5.4421768707483,1.66801888951299,56,17089,fhi:git
county,Nordland,2021-02-14,0,0,13080,4009,5.4421768707483,1.66801888951299,0,17089,fhi:git
county,Nordland,2021-02-15,0,1,13080,4010,5.4421768707483,1.66843495808109,1,17090,fhi:git
county,Nordland,2021-02-16,223,71,13303,4081,5.5349601614346,1.69797582641619,294,17384,fhi:git
county,Nordland,2021-02-17,1490,515,14793,4596,6.15490232790364,1.91225113898771,2005,19389,fhi:git
county,Nordland,2021-02-18,849,607,15642,5203,6.50814454222056,2.16480475982442,1456,20845,fhi:git
county,Nordland,2021-02-19,306,231,15948,5434,6.63546152405917,2.26091659905552,537,21382,fhi:git
county,Nordland,2021-02-20,1,1,15949,5435,6.63587759262727,2.26133266762362,2,21384,fhi:git
county,Nordland,2021-02-21,0,0,15949,5435,6.63587759262727,2.26133266762362,0,21384,fhi:git
county,Nordland,2021-02-22,270,0,16219,5435,6.74821610601427,2.26133266762362,270,21654,fhi:git
county,Nordland,2021-02-23,308,56,16527,5491,6.87636522498908,2.28463250743723,364,22018,fhi:git
county,Nordland,2021-02-24,974,1008,17501,6499,7.2816160103185,2.70402962408205,1982,24000,fhi:git
county,Nordland,2021-02-25,591,1849,18092,8348,7.52751253406561,3.47334040649899,2440,26440,fhi:git
county,Nordland,2021-02-26,423,396,18515,8744,7.70350953837192,3.6381035594666,819,27259,fhi:git
county,Nordland,2021-02-27,1,4,18516,8748,7.70392560694002,3.639767833739,5,27264,fhi:git
county,Nordland,2021-02-28,0,1,18516,8749,7.70392560694002,3.6401839023071,1,27265,fhi:git
county,Nordland,2021-03-01,240,0,18756,8749,7.80378206328403,3.6401839023071,240,27505,fhi:git
county,Nordland,2021-03-02,517,50,19273,8799,8.01888951299174,3.6609873307121,567,28072,fhi:git
county,Nordland,2021-03-03,621,1582,19894,10381,8.27726809378186,4.31920780544634,2203,30275,fhi:git
county,Nordland,2021-03-04,719,1366,20613,11747,8.57642139424577,4.88755746947097,2085,32360,fhi:git
county,Nordland,2021-03-05,440,339,21053,12086,8.75949156420978,5.02860471405688,779,33139,fhi:git
county,Nordland,2021-03-06,13,51,21066,12137,8.76490045559508,5.04982421102998,64,33203,fhi:git
county,Nordland,2021-03-07,0,0,21066,12137,8.76490045559508,5.04982421102998,0,33203,fhi:git
county,Nordland,2021-03-08,360,0,21426,12137,8.91468514011109,5.04982421102998,360,33563,fhi:git
county,Nordland,2021-03-09,652,51,22078,12188,9.18596184651231,5.07104370800308,703,34266,fhi:git
county,Nordland,2021-03-10,1210,1184,23288,13372,9.68940481391333,5.56366889263351,2394,36660,fhi:git
county,Nordland,2021-03-11,730,989,24018,14361,9.99313486862635,5.97516070648443,1719,38379,fhi:git
county,Nordland,2021-03-12,70,252,24088,14613,10.0222596683934,6.08000998564564,322,38701,fhi:git
county,Nordland,2021-03-13,3,2,24091,14615,10.0235078740977,6.08084212278183,5,38706,fhi:git
county,Nordland,2021-03-14,0,0,24091,14615,10.0235078740977,6.08084212278183,0,38706,fhi:git
county,Nordland,2021-03-15,0,1,24091,14616,10.0235078740977,6.08125819134993,1,38707,fhi:git
county,Nordland,2021-03-16,118,5,24209,14621,10.0726039651335,6.08333853419043,123,38830,fhi:git
county,Nordland,2021-03-17,902,64,25111,14685,10.4478978135597,6.10996692254884,966,39796,fhi:git
county,Nordland,2021-03-18,1162,73,26273,14758,10.9313694896919,6.14033992802014,1235,41031,fhi:git
county,Nordland,2021-03-19,226,28,26499,14786,11.0254009860825,6.15198984792694,254,41285,fhi:git
county,Nordland,2021-03-20,39,0,26538,14786,11.0416276602384,6.15198984792694,39,41324,fhi:git
county,Nordland,2021-03-21,0,0,26538,14786,11.0416276602384,6.15198984792694,0,41324,fhi:git
county,Nordland,2021-03-22,36,2,26574,14788,11.05660612869,6.15282198506314,38,41362,fhi:git
county,Nordland,2021-03-23,560,8,27134,14796,11.289604526826,6.15615053360794,568,41930,fhi:git
county,Nordland,2021-03-24,2159,48,29293,14844,12.187896565354,6.17612182487674,2207,44137,fhi:git
county,Nordland,2021-03-25,1587,62,30880,14906,12.8481973829287,6.20191807609894,1649,45786,fhi:git
county,Nordland,2021-03-26,337,11,31217,14917,12.9884124903784,6.20649483034804,348,46134,fhi:git
county,Nordland,2021-03-27,0,0,31217,14917,12.9884124903784,6.20649483034804,0,46134,fhi:git
county,Nordland,2021-03-28,0,0,31217,14917,12.9884124903784,6.20649483034804,0,46134,fhi:git
county,Nordland,2021-03-29,9,1,31226,14918,12.9921571074913,6.20691089891614,10,46144,fhi:git
county,Nordland,2021-03-30,1475,93,32701,15011,13.6058582454388,6.24560527574944,1568,47712,fhi:git
county,Nordland,2021-03-31,1084,299,33785,15310,14.0568765732593,6.37000977761135,1383,49095,fhi:git
county,Nordland,2021-04-01,212,149,33997,15459,14.1450831096965,6.43200399425825,361,49456,fhi:git
county,Nordland,2021-04-02,97,6,34094,15465,14.1854417608022,6.43450040566686,103,49559,fhi:git
county,Nordland,2021-04-03,0,0,34094,15465,14.1854417608022,6.43450040566686,0,49559,fhi:git
county,Nordland,2021-04-04,0,0,34094,15465,14.1854417608022,6.43450040566686,0,49559,fhi:git
county,Oslo,2020-12-27,5,0,5,0,0.0007209867713347,0.0,5,5,fhi:git
county,Oslo,2020-12-28,264,0,269,0,0.0387890882978079,0.0,264,269,fhi:git
county,Oslo,2020-12-29,118,0,387,0,0.0558043761013073,0.0,118,387,fhi:git
county,Oslo,2020-12-30,58,0,445,0,0.06416782264879,0.0,58,445,fhi:git
county,Oslo,2020-12-31,5,0,450,0,0.0648888094201248,0.0,5,450,fhi:git
county,Oslo,2021-01-01,6,0,456,0,0.0657539935457264,0.0,6,456,fhi:git
county,Oslo,2021-01-02,0,0,456,0,0.0657539935457264,0.0,0,456,fhi:git
county,Oslo,2021-01-03,0,0,456,0,0.0657539935457264,0.0,0,456,fhi:git
county,Oslo,2021-01-04,0,0,456,0,0.065422303840691,0.0,0,456,fhi:git
county,Oslo,2021-01-05,479,0,935,0,0.134144416866329,0.0,479,935,fhi:git
county,Oslo,2021-01-06,603,0,1538,0,0.220656805497769,0.0,603,1538,fhi:git
county,Oslo,2021-01-07,966,0,2504,0,0.359248791265549,0.0,966,2504,fhi:git
county,Oslo,2021-01-08,450,0,2954,0,0.423810275318862,0.0,450,2954,fhi:git
county,Oslo,2021-01-09,127,0,3081,0,0.442030960818353,0.0,127,3081,fhi:git
county,Oslo,2021-01-10,100,0,3181,0,0.456377957274645,0.0,100,3181,fhi:git
county,Oslo,2021-01-11,78,0,3259,0,0.467568614510552,0.0,78,3259,fhi:git
county,Oslo,2021-01-12,241,0,3500,0,0.502144875970216,0.0,241,3500,fhi:git
county,Oslo,2021-01-13,489,0,3989,0,0.572301688641483,0.0,489,3989,fhi:git
county,Oslo,2021-01-14,1238,0,5227,0,0.749917504770376,0.0,1238,5227,fhi:git
county,Oslo,2021-01-15,1636,0,6863,0,0.984634366795311,0.0,1636,6863,fhi:git
county,Oslo,2021-01-16,643,0,7506,0,1.07688555400927,0.0,643,7506,fhi:git
county,Oslo,2021-01-17,276,5,7782,5,1.11648326422863,0.0007173498228145,281,7787,fhi:git
county,Oslo,2021-01-18,759,231,8541,236,1.22537696733189,0.0338589116368488,990,8777,fhi:git
county,Oslo,2021-01-19,811,70,9352,306,1.34173110859242,0.0439018091562531,881,9658,fhi:git
county,Oslo,2021-01-20,991,99,10343,405,1.48390984347427,0.0581053356479821,1090,10748,fhi:git
county,Oslo,2021-01-21,1022,21,11365,426,1.63053614725757,0.0611182049038034,1043,11791,fhi:git
county,Oslo,2021-01-22,670,6,12035,432,1.72666102351473,0.0619790246911809,676,12467,fhi:git
county,Oslo,2021-01-23,232,0,12267,432,1.75994605529332,0.0619790246911809,232,12699,fhi:git
county,Oslo,2021-01-24,67,0,12334,432,1.76955854291904,0.0619790246911809,67,12766,fhi:git
county,Oslo,2021-01-25,258,0,12592,432,1.80657379377627,0.0619790246911809,258,13024,fhi:git
county,Oslo,2021-01-26,312,404,12904,836,1.8513364227199,0.1199408903746,716,13740,fhi:git
county,Oslo,2021-01-27,1035,528,13939,1364,1.99982783604252,0.195693031663821,1563,15303,fhi:git
county,Oslo,2021-01-28,870,842,14809,2206,2.12464670521226,0.316494741825799,1712,17015,fhi:git
county,Oslo,2021-01-29,427,504,15236,2710,2.18590838008063,0.38880360396551,931,17946,fhi:git
county,Oslo,2021-01-30,94,152,15330,2862,2.19939455674954,0.410611038579073,246,18192,fhi:git
county,Oslo,2021-01-31,61,45,15391,2907,2.20814622458788,0.417067186984405,106,18298,fhi:git
county,Oslo,2021-02-01,53,48,15444,2955,2.21575013270972,0.423953745283425,101,18399,fhi:git
county,Oslo,2021-02-02,1522,151,16966,3106,2.43411141877448,0.445617709932426,1673,20072,fhi:git
county,Oslo,2021-02-03,2456,456,19422,3562,2.78647365174101,0.511040013773117,2912,22984,fhi:git
county,Oslo,2021-02-04,2049,1235,21471,4797,3.08044360913043,0.688225420008321,3284,26268,fhi:git
county,Oslo,2021-02-05,1383,1568,22854,6365,3.27886257012095,0.913186324442978,2951,29219,fhi:git
county,Oslo,2021-02-06,243,630,23097,6995,3.31372577150973,1.00357240211762,873,30092,fhi:git
county,Oslo,2021-02-07,214,270,23311,7265,3.3444283439262,1.0423092925496,484,30576,fhi:git
county,Oslo,2021-02-08,46,443,23357,7708,3.35102796229609,1.10586648685098,489,31065,fhi:git
county,Oslo,2021-02-09,1164,245,24521,7953,3.51802700104733,1.14101662816889,1409,32474,fhi:git
county,Oslo,2021-02-10,1829,812,26350,8765,3.78043356623291,1.25751423939398,2641,35115,fhi:git
county,Oslo,2021-02-11,1583,745,27933,9510,4.00754652013601,1.36439936299336,2328,37443,fhi:git
county,Oslo,2021-02-12,1358,425,29291,9935,4.20237873201245,1.4253740979326,1783,39226,fhi:git
county,Oslo,2021-02-13,273,193,29564,10128,4.24154603233813,1.45306380109324,466,39692,fhi:git
county,Oslo,2021-02-14,103,0,29667,10128,4.25632343868811,1.45306380109324,103,39795,fhi:git
county,Oslo,2021-02-15,260,444,29927,10572,4.29362562947447,1.51676446535918,704,40499,fhi:git
county,Oslo,2021-02-16,723,771,30650,11343,4.39735441385346,1.62737980803719,1494,41993,fhi:git
county,Oslo,2021-02-17,1460,1083,32110,12426,4.60682056211532,1.78275777965883,2543,44536,fhi:git
county,Oslo,2021-02-18,1071,919,33181,13345,4.76047689416221,1.91460667709215,1990,46526,fhi:git
county,Oslo,2021-02-19,1494,971,34675,14316,4.97482102121921,2.05391601268274,2465,48991,fhi:git
county,Oslo,2021-02-20,99,114,34774,14430,4.98902454771094,2.07027158864292,213,49204,fhi:git
county,Oslo,2021-02-21,4,61,34778,14491,4.98959842756919,2.07902325648126,65,49269,fhi:git
county,Oslo,2021-02-22,603,112,35381,14603,5.07611081620063,2.0950918925123,715,49984,fhi:git
county,Oslo,2021-02-23,339,1527,35720,16130,5.12474713418746,2.31417052839988,1866,51850,fhi:git
county,Oslo,2021-02-24,688,2350,36408,18480,5.22345446980675,2.65132494512274,3038,54888,fhi:git
county,Oslo,2021-02-25,599,1977,37007,20457,5.30939297857993,2.93496506506363,2576,57464,fhi:git
county,Oslo,2021-02-26,765,1373,37772,21830,5.41914750147057,3.13194932640852,2138,59602,fhi:git
county,Oslo,2021-02-27,259,103,38031,21933,5.45630622229236,3.1467267327585,362,59964,fhi:git
county,Oslo,2021-02-28,101,62,38132,21995,5.47079668871322,3.1556218705614,163,60127,fhi:git
county,Oslo,2021-03-01,1042,38,39174,22033,5.62029239178778,3.16107372921479,1080,61207,fhi:git
county,Oslo,2021-03-02,765,136,39939,22169,5.73004691467841,3.18058564439535,901,62108,fhi:git
county,Oslo,2021-03-03,1360,169,41299,22338,5.92516606648398,3.20483206840648,1529,63637,fhi:git
county,Oslo,2021-03-04,1181,203,42480,22541,6.09460409463279,3.23395647121275,1384,65021,fhi:git
county,Oslo,2021-03-05,1302,68,43782,22609,6.28140198849371,3.24371242880303,1370,66391,fhi:git
county,Oslo,2021-03-06,102,3,43884,22612,6.29603592487913,3.24414283869672,105,66496,fhi:git
county,Oslo,2021-03-07,69,0,43953,22612,6.30593535243397,3.24414283869672,69,66565,fhi:git
county,Oslo,2021-03-08,663,10,44616,22622,6.40105593893918,3.24557753834235,673,67238,fhi:git
county,Oslo,2021-03-09,775,1327,45391,23949,6.51224516147545,3.43596218131734,2102,69340,fhi:git
county,Oslo,2021-03-10,1190,2389,46581,26338,6.68297441930532,3.77871192665815,3579,72919,fhi:git
county,Oslo,2021-03-11,875,2370,47456,28708,6.80851063829787,4.11873574267227,3245,76164,fhi:git
county,Oslo,2021-03-12,278,1635,47734,30343,6.84839528844637,4.35330913473264,1913,78077,fhi:git
county,Oslo,2021-03-13,15,266,47749,30609,6.85054733791481,4.39147214530638,281,78358,fhi:git
county,Oslo,2021-03-14,1,97,47750,30706,6.85069080787937,4.40538873186898,98,78456,fhi:git
county,Oslo,2021-03-15,24,358,47774,31064,6.85413408702888,4.45675097918251,382,78838,fhi:git
county,Oslo,2021-03-16,1008,119,48782,31183,6.9987518113083,4.4738239049655,1127,79965,fhi:git
county,Oslo,2021-03-17,2734,93,51516,31276,7.39099869442332,4.48716661166985,2827,82792,fhi:git
county,Oslo,2021-03-18,2025,113,53541,31389,7.68152537266323,4.50337871766546,2138,84930,fhi:git
county,Oslo,2021-03-19,1994,186,55535,31575,7.96760448200169,4.53006413107416,2180,87110,fhi:git
county,Oslo,2021-03-20,394,18,55929,31593,8.02413164803948,4.53264659043629,412,87522,fhi:git
county,Oslo,2021-03-21,162,14,56091,31607,8.04737378229868,4.53465516994017,176,87698,fhi:git
county,Oslo,2021-03-22,935,11,57026,31618,8.18151819916501,4.53623333955037,946,88644,fhi:git
county,Oslo,2021-03-23,3317,104,60343,31722,8.65740807162021,4.55115421586491,3421,92065,fhi:git
county,Oslo,2021-03-24,5123,213,65466,31935,9.39240470007604,4.58171331831681,5336,97401,fhi:git
county,Oslo,2021-03-25,5127,48,70593,31983,10.1279752083901,4.58859987661583,5175,102576,fhi:git
county,Oslo,2021-03-26,4148,81,74741,32064,10.7230886213971,4.60022094374543,4229,106805,fhi:git
county,Oslo,2021-03-27,534,1,75275,32065,10.7997015824737,4.60036441370999,535,107340,fhi:git
county,Oslo,2021-03-28,151,0,75426,32065,10.8213655471227,4.60036441370999,151,107491,fhi:git
county,Oslo,2021-03-29,2181,9,77607,32074,11.1342735398344,4.60165564339106,2190,109681,fhi:git
county,Oslo,2021-03-30,4348,209,81955,32283,11.758080945754,4.63164086598471,4557,114238,fhi:git
county,Oslo,2021-03-31,4176,705,86131,32988,12.3572115177688,4.73278719100156,4881,119119,fhi:git
county,Oslo,2021-04-01,2793,285,88924,33273,12.757923128793,4.773676130902,3078,122197,fhi:git
county,Oslo,2021-04-02,1663,165,90587,33438,12.9965136798611,4.79734867505488,1828,124025,fhi:git
county,Oslo,2021-04-03,227,0,90814,33438,13.0290813618169,4.79734867505488,227,124252,fhi:git
county,Oslo,2021-04-04,374,36,91188,33474,13.0827391285634,4.80251359377914,410,124662,fhi:git
county,Rogaland,2020-12-27,0,0,0,0,0.0,0.0,0,0,fhi:git
county,Rogaland,2020-12-28,1,0,1,0,0.0002083802188825,0.0,1,1,fhi:git
county,Rogaland,2020-12-29,0,0,1,0,0.0002083802188825,0.0,0,1,fhi:git
county,Rogaland,2020-12-30,0,0,1,0,0.0002083802188825,0.0,0,1,fhi:git
county,Rogaland,2020-12-31,0,0,1,0,0.0002083802188825,0.0,0,1,fhi:git
county,Rogaland,2021-01-01,0,0,1,0,0.0002083802188825,0.0,0,1,fhi:git
county,Rogaland,2021-01-02,0,0,1,0,0.0002083802188825,0.0,0,1,fhi:git
county,Rogaland,2021-01-03,0,0,1,0,0.0002083802188825,0.0,0,1,fhi:git
county,Rogaland,2021-01-04,0,0,1,0,0.0002071916211708,0.0,0,1,fhi:git
county,Rogaland,2021-01-05,548,0,549,0,0.113748200022791,0.0,548,549,fhi:git
county,Rogaland,2021-01-06,641,0,1190,0,0.246558029193299,0.0,641,1190,fhi:git
county,Rogaland,2021-01-07,212,0,1402,0,0.290482652881517,0.0,212,1402,fhi:git
county,Rogaland,2021-01-08,20,0,1422,0,0.294626485304934,0.0,20,1422,fhi:git
county,Rogaland,2021-01-09,1,0,1423,0,0.294833676926105,0.0,1,1423,fhi:git
county,Rogaland,2021-01-10,0,0,1423,0,0.294833676926105,0.0,0,1423,fhi:git
county,Rogaland,2021-01-11,2,0,1425,0,0.295248060168447,0.0,2,1425,fhi:git
county,Rogaland,2021-01-12,117,0,1542,0,0.319489479845435,0.0,117,1542,fhi:git
county,Rogaland,2021-01-13,761,0,2303,0,0.477162303556444,0.0,761,2303,fhi:git
county,Rogaland,2021-01-14,535,0,2838,0,0.588009820882844,0.0,535,2838,fhi:git
county,Rogaland,2021-01-15,291,0,3129,0,0.648302582643558,0.0,291,3129,fhi:git
county,Rogaland,2021-01-16,0,0,3129,0,0.648302582643558,0.0,0,3129,fhi:git
county,Rogaland,2021-01-17,2,0,3131,0,0.6487169658859,0.0,2,3131,fhi:git
county,Rogaland,2021-01-18,71,0,3202,0,0.663427570989029,0.0,71,3202,fhi:git
county,Rogaland,2021-01-19,512,0,3714,0,0.769509681028499,0.0,512,3714,fhi:git
county,Rogaland,2021-01-20,656,0,4370,0,0.90542738451657,0.0,656,4370,fhi:git
county,Rogaland,2021-01-21,430,0,4800,0,0.994519781620031,0.0,430,4800,fhi:git
county,Rogaland,2021-01-22,272,0,5072,0,1.0508759025785,0.0,272,5072,fhi:git
county,Rogaland,2021-01-23,0,0,5072,0,1.0508759025785,0.0,0,5072,fhi:git
county,Rogaland,2021-01-24,0,0,5072,0,1.0508759025785,0.0,0,5072,fhi:git
county,Rogaland,2021-01-25,150,0,5222,0,1.08195464575413,0.0,150,5222,fhi:git
county,Rogaland,2021-01-26,338,381,5560,381,1.15198541370987,0.07894000766609,719,5941,fhi:git
county,Rogaland,2021-01-27,865,603,6425,984,1.33120616602265,0.203876555232106,1468,7409,fhi:git
county,Rogaland,2021-01-28,524,283,6949,1267,1.43977457551617,0.262511784023454,807,8216,fhi:git
county,Rogaland,2021-01-29,410,22,7359,1289,1.52472314019621,0.267069999689213,432,8648,fhi:git
county,Rogaland,2021-01-30,4,1,7363,1290,1.52555190668089,0.267277191310383,5,8653,fhi:git
county,Rogaland,2021-01-31,1,0,7364,1290,1.52575909830206,0.267277191310383,1,8654,fhi:git
county,Rogaland,2021-02-01,13,5,7377,1295,1.52845258937729,0.268313149416238,18,8672,fhi:git
county,Rogaland,2021-02-02,451,77,7828,1372,1.62189601052533,0.284266904246392,528,9200,fhi:git
county,Rogaland,2021-02-03,2430,635,10258,2007,2.12537164997048,0.415833583689876,3065,12265,fhi:git
county,Rogaland,2021-02-04,1887,550,12145,2557,2.51634223911985,0.529788975333838,2437,14702,fhi:git
county,Rogaland,2021-02-05,656,281,12801,2838,2.65225994260792,0.588009820882844,937,15639,fhi:git
county,Rogaland,2021-02-06,0,0,12801,2838,2.65225994260792,0.588009820882844,0,15639,fhi:git
county,Rogaland,2021-02-07,0,1,12801,2839,2.65225994260792,0.588217012504014,1,15640,fhi:git
county,Rogaland,2021-02-08,7,71,12808,2910,2.65371028395612,0.602927617607144,78,15718,fhi:git
county,Rogaland,2021-02-09,587,394,13395,3304,2.7753317655834,0.684561116348455,981,16699,fhi:git
county,Rogaland,2021-02-10,1923,683,15318,3987,3.17376125309493,0.826072993608139,2606,19305,fhi:git
county,Rogaland,2021-02-11,1181,496,16499,4483,3.41845455769769,0.928840037708875,1677,20982,fhi:git
county,Rogaland,2021-02-12,482,268,16981,4751,3.51832091910203,0.98436739218266,750,21732,fhi:git
county,Rogaland,2021-02-13,1,0,16982,4751,3.5185281107232,0.98436739218266,1,21733,fhi:git
county,Rogaland,2021-02-14,0,0,16982,4751,3.5185281107232,0.98436739218266,0,21733,fhi:git
county,Rogaland,2021-02-15,0,147,16982,4898,3.5185281107232,1.01482456049477,147,21880,fhi:git
county,Rogaland,2021-02-16,480,314,17462,5212,3.61798008888521,1.07988272954242,794,22674,fhi:git
county,Rogaland,2021-02-17,1488,783,18950,5995,3.92628122118742,1.24211376891919,2271,24945,fhi:git
county,Rogaland,2021-02-18,1101,472,20051,6467,4.15439919609651,1.33990821411182,1573,26518,fhi:git
county,Rogaland,2021-02-19,442,411,20493,6878,4.24597789265402,1.42506397041304,853,27371,fhi:git
county,Rogaland,2021-02-20,1,2,20494,6880,4.24618508427519,1.42547835365538,3,27374,fhi:git
county,Rogaland,2021-02-21,0,1,20494,6881,4.24618508427519,1.42568554527655,1,27375,fhi:git
county,Rogaland,2021-02-22,252,13,20746,6894,4.29839737281024,1.42837903635177,265,27640,fhi:git
county,Rogaland,2021-02-23,379,407,21125,7301,4.37692299723399,1.5127060261683,786,28426,fhi:git
county,Rogaland,2021-02-24,819,2168,21944,9469,4.54661293497291,1.96189746086668,2987,31413,fhi:git
county,Rogaland,2021-02-25,1229,1811,23173,11280,4.80125143739187,2.33712148680707,3040,34453,fhi:git
county,Rogaland,2021-02-26,999,674,24172,11954,5.00823586694154,2.47676863947622,1673,36126,fhi:git
county,Rogaland,2021-02-27,1,1,24173,11955,5.00844305856271,2.47697583109739,2,36128,fhi:git
county,Rogaland,2021-02-28,4,0,24177,11955,5.0092718250474,2.47697583109739,4,36132,fhi:git
county,Rogaland,2021-03-01,647,2,24824,11957,5.14332480394493,2.47739021433973,649,36781,fhi:git
county,Rogaland,2021-03-02,794,545,25618,12502,5.30783495115458,2.59030964787784,1339,38120,fhi:git
county,Rogaland,2021-03-03,1269,1460,26887,13962,5.57076111842037,2.89280941478727,2729,40849,fhi:git
county,Rogaland,2021-03-04,1089,1477,27976,15439,5.79639279387542,3.1988314392566,2566,43415,fhi:git
county,Rogaland,2021-03-05,590,424,28566,15863,5.91863585036621,3.28668068663303,1014,44429,fhi:git
county,Rogaland,2021-03-06,3,1,28569,15864,5.91925742522972,3.2868878782542,4,44433,fhi:git
county,Rogaland,2021-03-07,0,0,28569,15864,5.91925742522972,3.2868878782542,0,44433,fhi:git
county,Rogaland,2021-03-08,542,0,29111,15864,6.03155528390432,3.2868878782542,542,44975,fhi:git
county,Rogaland,2021-03-09,1567,465,30678,16329,6.35622455427903,3.38323198209864,2032,47007,fhi:git
county,Rogaland,2021-03-10,2130,1078,32808,17407,6.79754270737291,3.60658454972081,3208,50215,fhi:git
county,Rogaland,2021-03-11,1398,1056,34206,18463,7.08719659376975,3.82537890167722,2454,52669,fhi:git
county,Rogaland,2021-03-12,116,546,34322,19009,7.11123082182557,3.9385055268365,662,53331,fhi:git
county,Rogaland,2021-03-13,0,0,34322,19009,7.11123082182557,3.9385055268365,0,53331,fhi:git
county,Rogaland,2021-03-14,0,0,34322,19009,7.11123082182557,3.9385055268365,0,53331,fhi:git
county,Rogaland,2021-03-15,0,1,34322,19010,7.11123082182557,3.93871271845767,1,53332,fhi:git
county,Rogaland,2021-03-16,584,93,34906,19103,7.23223072858934,3.95798153922655,677,54009,fhi:git
county,Rogaland,2021-03-17,2395,95,37301,19198,7.7284546612935,3.97766474323778,2490,56499,fhi:git
county,Rogaland,2021-03-18,1674,83,38975,19281,8.07529343513348,3.99486164779496,1757,58256,fhi:git
county,Rogaland,2021-03-19,272,25,39247,19306,8.13164955609195,4.00004143832423,297,58553,fhi:git
county,Rogaland,2021-03-20,0,0,39247,19306,8.13164955609195,4.00004143832423,0,58553,fhi:git
county,Rogaland,2021-03-21,0,0,39247,19306,8.13164955609195,4.00004143832423,0,58553,fhi:git
county,Rogaland,2021-03-22,12,17,39259,19323,8.134135855546,4.00356369588414,29,58582,fhi:git
county,Rogaland,2021-03-23,827,48,40086,19371,8.30548332625429,4.01350889370034,875,59457,fhi:git
county,Rogaland,2021-03-24,3405,80,43491,19451,9.010970796341,4.03008422339401,3485,62942,fhi:git
county,Rogaland,2021-03-25,3235,166,46726,19617,9.68123569082866,4.06447803250837,3401,66343,fhi:git
county,Rogaland,2021-03-26,806,77,47532,19694,9.84823213749236,4.08043178733852,883,67226,fhi:git
county,Rogaland,2021-03-27,0,0,47532,19694,9.84823213749236,4.08043178733852,0,67226,fhi:git
county,Rogaland,2021-03-28,1,1,47533,19695,9.84843932911353,4.08063897895969,2,67228,fhi:git
county,Rogaland,2021-03-29,232,0,47765,19695,9.89650778522517,4.08063897895969,232,67460,fhi:git
county,Rogaland,2021-03-30,4000,358,51765,20053,10.7252742699085,4.15481357933885,4358,71818,fhi:git
county,Rogaland,2021-03-31,2048,590,53813,20643,11.1496027100664,4.27705663582965,2638,74456,fhi:git
county,Rogaland,2021-04-01,569,0,54382,20643,11.2674947425126,4.27705663582965,569,75025,fhi:git
county,Rogaland,2021-04-02,10,21,54392,20664,11.2695666587243,4.28140765987424,31,75056,fhi:git
county,Rogaland,2021-04-03,0,0,54392,20664,11.2695666587243,4.28140765987424,0,75056,fhi:git
county,Rogaland,2021-04-04,0,0,54392,20664,11.2695666587243,4.28140765987424,0,75056,fhi:git
county,Troms og Finnmark,2020-12-27,0,0,0,0,0.0,0.0,0,0,fhi:git
county,Troms og Finnmark,2020-12-28,1,0,1,0,0.0004109966257177,0.0,1,1,fhi:git
county,Troms og Finnmark,2020-12-29,0,0,1,0,0.0004109966257177,0.0,0,1,fhi:git
county,Troms og Finnmark,2020-12-30,0,0,1,0,0.0004109966257177,0.0,0,1,fhi:git
county,Troms og Finnmark,2020-12-31,0,0,1,0,0.0004109966257177,0.0,0,1,fhi:git
county,Troms og Finnmark,2021-01-01,0,0,1,0,0.0004109966257177,0.0,0,1,fhi:git
county,Troms og Finnmark,2021-01-02,0,0,1,0,0.0004109966257177,0.0,0,1,fhi:git
county,Troms og Finnmark,2021-01-03,0,0,1,0,0.0004109966257177,0.0,0,1,fhi:git
county,Troms og Finnmark,2021-01-04,0,0,1,0,0.0004129364738528,0.0,0,1,fhi:git
county,Troms og Finnmark,2021-01-05,53,0,54,0,0.0222985695880546,0.0,53,54,fhi:git
county,Troms og Finnmark,2021-01-06,530,0,584,0,0.241154900730072,0.0,530,584,fhi:git
county,Troms og Finnmark,2021-01-07,188,0,772,0,0.31878695781441,0.0,188,772,fhi:git
county,Troms og Finnmark,2021-01-08,247,0,1019,0,0.420782266856067,0.0,247,1019,fhi:git
county,Troms og Finnmark,2021-01-09,0,0,1019,0,0.420782266856067,0.0,0,1019,fhi:git
county,Troms og Finnmark,2021-01-10,0,0,1019,0,0.420782266856067,0.0,0,1019,fhi:git
county,Troms og Finnmark,2021-01-11,0,0,1019,0,0.420782266856067,0.0,0,1019,fhi:git
county,Troms og Finnmark,2021-01-12,191,0,1210,0,0.499653133361964,0.0,191,1210,fhi:git
county,Troms og Finnmark,2021-01-13,569,0,1779,0,0.734613986984242,0.0,569,1779,fhi:git
county,Troms og Finnmark,2021-01-14,330,0,2109,0,0.870883023355687,0.0,330,2109,fhi:git
county,Troms og Finnmark,2021-01-15,37,0,2146,0,0.886161672888243,0.0,37,2146,fhi:git
county,Troms og Finnmark,2021-01-16,2,0,2148,0,0.886987545835949,0.0,2,2148,fhi:git
county,Troms og Finnmark,2021-01-17,0,0,2148,0,0.886987545835949,0.0,0,2148,fhi:git
county,Troms og Finnmark,2021-01-18,0,1,2148,1,0.886987545835949,0.0004129364738528,1,2149,fhi:git
county,Troms og Finnmark,2021-01-19,251,0,2399,1,0.990634600773017,0.0004129364738528,251,2400,fhi:git
county,Troms og Finnmark,2021-01-20,923,0,3322,1,1.37177496613921,0.0004129364738528,923,3323,fhi:git
county,Troms og Finnmark,2021-01-21,247,0,3569,1,1.47377027518087,0.0004129364738528,247,3570,fhi:git
county,Troms og Finnmark,2021-01-22,82,0,3651,1,1.5076310660368,0.0004129364738528,82,3652,fhi:git
county,Troms og Finnmark,2021-01-23,12,0,3663,1,1.51258630372304,0.0004129364738528,12,3664,fhi:git
county,Troms og Finnmark,2021-01-24,0,0,3663,1,1.51258630372304,0.0004129364738528,0,3664,fhi:git
county,Troms og Finnmark,2021-01-25,6,0,3669,1,1.51506392256615,0.0004129364738528,6,3670,fhi:git
county,Troms og Finnmark,2021-01-26,85,0,3754,1,1.55016352284365,0.0004129364738528,85,3755,fhi:git
county,Troms og Finnmark,2021-01-27,667,357,4421,358,1.82559215090351,0.147831257639325,1024,4779,fhi:git
county,Troms og Finnmark,2021-01-28,235,276,4656,634,1.92263222225893,0.261801724422715,511,5290,fhi:git
county,Troms og Finnmark,2021-01-29,104,243,4760,877,1.96557761553963,0.36214528756896,347,5637,fhi:git
county,Troms og Finnmark,2021-01-30,0,0,4760,877,1.96557761553963,0.36214528756896,0,5637,fhi:git
county,Troms og Finnmark,2021-01-31,0,0,4760,877,1.96557761553963,0.36214528756896,0,5637,fhi:git
county,Troms og Finnmark,2021-02-01,0,1,4760,878,1.96557761553963,0.362558224042813,1,5638,fhi:git
county,Troms og Finnmark,2021-02-02,119,24,4879,902,2.01471705592812,0.372468699415282,143,5781,fhi:git
county,Troms og Finnmark,2021-02-03,1158,562,6037,1464,2.49289749264973,0.604538997720591,1720,7501,fhi:git
county,Troms og Finnmark,2021-02-04,1149,380,7186,1844,2.96736150110667,0.761454857784678,1529,9030,fhi:git
county,Troms og Finnmark,2021-02-05,287,140,7473,1984,3.08587426910244,0.819265964124079,427,9457,fhi:git
county,Troms og Finnmark,2021-02-06,1,1,7474,1985,3.08628720557629,0.819678900597932,2,9459,fhi:git
county,Troms og Finnmark,2021-02-07,0,0,7474,1985,3.08628720557629,0.819678900597932,0,9459,fhi:git
county,Troms og Finnmark,2021-02-08,0,0,7474,1985,3.08628720557629,0.819678900597932,0,9459,fhi:git
county,Troms og Finnmark,2021-02-09,71,29,7545,2014,3.11560569521985,0.831654058339665,100,9559,fhi:git
county,Troms og Finnmark,2021-02-10,1408,813,8953,2827,3.69702025040468,1.16737141158204,2221,11780,fhi:git
county,Troms og Finnmark,2021-02-11,995,465,9948,3292,4.10789204188828,1.35938687192362,1460,13240,fhi:git
county,Troms og Finnmark,2021-02-12,293,114,10241,3406,4.22888242872716,1.40646162994285,407,13647,fhi:git
county,Troms og Finnmark,2021-02-13,5,2,10246,3408,4.23094711109643,1.40728750289056,7,13654,fhi:git
county,Troms og Finnmark,2021-02-14,0,0,10246,3408,4.23094711109643,1.40728750289056,0,13654,fhi:git
county,Troms og Finnmark,2021-02-15,0,6,10246,3414,4.23094711109643,1.40976512173367,6,13660,fhi:git
county,Troms og Finnmark,2021-02-16,133,52,10379,3466,4.28586766211886,1.43123781837402,185,13845,fhi:git
county,Troms og Finnmark,2021-02-17,969,582,11348,4048,4.68600310528228,1.67156684615639,1551,15396,fhi:git
county,Troms og Finnmark,2021-02-18,1295,263,12643,4311,5.22075583892174,1.78016913877969,1558,16954,fhi:git
county,Troms og Finnmark,2021-02-19,232,133,12875,4444,5.3165571008556,1.83508968980212,365,17319,fhi:git
county,Troms og Finnmark,2021-02-20,0,0,12875,4444,5.3165571008556,1.83508968980212,0,17319,fhi:git
county,Troms og Finnmark,2021-02-21,0,0,12875,4444,5.3165571008556,1.83508968980212,0,17319,fhi:git
county,Troms og Finnmark,2021-02-22,107,0,12982,4444,5.36074130355786,1.83508968980212,107,17426,fhi:git
county,Troms og Finnmark,2021-02-23,79,78,13061,4522,5.39336328499224,1.86729873476264,157,17583,fhi:git
county,Troms og Finnmark,2021-02-24,430,989,13491,5511,5.57092596874897,2.27569290740313,1419,19002,fhi:git
county,Troms og Finnmark,2021-02-25,567,1053,14058,6564,5.80506094942354,2.71051501437019,1620,20622,fhi:git
county,Troms og Finnmark,2021-02-26,282,404,14340,6968,5.92150903505005,2.87734134980675,686,21308,fhi:git
county,Troms og Finnmark,2021-02-27,0,0,14340,6968,5.92150903505005,2.87734134980675,0,21308,fhi:git
county,Troms og Finnmark,2021-02-28,3,0,14343,6968,5.92274784447161,2.87734134980675,3,21311,fhi:git
county,Troms og Finnmark,2021-03-01,340,0,14683,6968,6.06314624558158,2.87734134980675,340,21651,fhi:git
county,Troms og Finnmark,2021-03-02,555,72,15238,7040,6.29232598856992,2.90707277592415,627,22278,fhi:git
county,Troms og Finnmark,2021-03-03,598,1179,15836,8219,6.53926199993393,3.39392487859668,1777,24055,fhi:git
county,Troms og Finnmark,2021-03-04,879,933,16715,9152,6.9022331604506,3.7791946087014,1812,25867,fhi:git
county,Troms og Finnmark,2021-03-05,702,374,17417,9526,7.19211456509531,3.93363284992237,1076,26943,fhi:git
county,Troms og Finnmark,2021-03-06,0,1,17417,9527,7.19211456509531,3.93404578639622,1,26944,fhi:git
county,Troms og Finnmark,2021-03-07,0,0,17417,9527,7.19211456509531,3.93404578639622,0,26944,fhi:git
county,Troms og Finnmark,2021-03-08,408,0,17825,9527,7.36059264642727,3.93404578639622,408,27352,fhi:git
county,Troms og Finnmark,2021-03-09,611,51,18436,9578,7.61289683195137,3.95510554656272,662,28014,fhi:git
county,Troms og Finnmark,2021-03-10,937,698,19373,10276,7.99981830795151,4.24333520531201,1635,29649,fhi:git
county,Troms og Finnmark,2021-03-11,794,1041,20167,11317,8.32768986819068,4.67320207459285,1835,31484,fhi:git
county,Troms og Finnmark,2021-03-12,68,209,20235,11526,8.35576954841267,4.75950579762809,277,31761,fhi:git
county,Troms og Finnmark,2021-03-13,0,0,20235,11526,8.35576954841267,4.75950579762809,0,31761,fhi:git
county,Troms og Finnmark,2021-03-14,0,0,20235,11526,8.35576954841267,4.75950579762809,0,31761,fhi:git
county,Troms og Finnmark,2021-03-15,2,5,20237,11531,8.35659542136038,4.76157047999736,7,31768,fhi:git
county,Troms og Finnmark,2021-03-16,19,2,20256,11533,8.36444121436358,4.76239635294506,21,31789,fhi:git
county,Troms og Finnmark,2021-03-17,546,45,20802,11578,8.58990452908725,4.78097849426844,591,32380,fhi:git
county,Troms og Finnmark,2021-03-18,1112,122,21914,11700,9.04908988801163,4.83135674407849,1234,33614,fhi:git
county,Troms og Finnmark,2021-03-19,406,33,22320,11733,9.21674209639589,4.84498364771564,439,34053,fhi:git
county,Troms og Finnmark,2021-03-20,0,0,22320,11733,9.21674209639589,4.84498364771564,0,34053,fhi:git
county,Troms og Finnmark,2021-03-21,1,0,22321,11733,9.21715503286974,4.84498364771564,1,34054,fhi:git
county,Troms og Finnmark,2021-03-22,3,0,22324,11733,9.2183938422913,4.84498364771564,3,34057,fhi:git
county,Troms og Finnmark,2021-03-23,429,14,22753,11747,9.39554358957418,4.85076475834958,443,34500,fhi:git
county,Troms og Finnmark,2021-03-24,1876,42,24629,11789,10.1702124145221,4.8681080902514,1918,36418,fhi:git
county,Troms og Finnmark,2021-03-25,1941,37,26570,11826,10.9717221102706,4.88338673978395,1978,38396,fhi:git
county,Troms og Finnmark,2021-03-26,505,15,27075,11841,11.1802550295663,4.88958078689174,520,38916,fhi:git
county,Troms og Finnmark,2021-03-27,1,0,27076,11841,11.1806679660401,4.88958078689174,1,38917,fhi:git
county,Troms og Finnmark,2021-03-28,0,0,27076,11841,11.1806679660401,4.88958078689174,0,38917,fhi:git
county,Troms og Finnmark,2021-03-29,176,0,27252,11841,11.2533447854382,4.88958078689174,176,39093,fhi:git
county,Troms og Finnmark,2021-03-30,1519,148,28771,11989,11.8805952892207,4.95069538502197,1667,40760,fhi:git
county,Troms og Finnmark,2021-03-31,1335,283,30106,12272,12.4318654818143,5.06755640712233,1618,42378,fhi:git
county,Troms og Finnmark,2021-04-01,165,35,30271,12307,12.5,5.08200918370718,200,42578,fhi:git
county,Troms og Finnmark,2021-04-02,0,0,30271,12307,12.5,5.08200918370718,0,42578,fhi:git
county,Troms og Finnmark,2021-04-03,0,0,30271,12307,12.5,5.08200918370718,0,42578,fhi:git
county,Troms og Finnmark,2021-04-04,0,0,30271,12307,12.5,5.08200918370718,0,42578,fhi:git
county,Trøndelag,2020-12-27,0,0,0,0,0.0,0.0,0,0,fhi:git
county,Trøndelag,2020-12-28,0,0,0,0,0.0,0.0,0,0,fhi:git
county,Trøndelag,2020-12-29,0,0,0,0,0.0,0.0,0,0,fhi:git
county,Trøndelag,2020-12-30,0,0,0,0,0.0,0.0,0,0,fhi:git
county,Trøndelag,2020-12-31,0,0,0,0,0.0,0.0,0,0,fhi:git
county,Trøndelag,2021-01-01,0,0,0,0,0.0,0.0,0,0,fhi:git
county,Trøndelag,2021-01-02,0,0,0,0,0.0,0.0,0,0,fhi:git
county,Trøndelag,2021-01-03,0,0,0,0,0.0,0.0,0,0,fhi:git
county,Trøndelag,2021-01-04,3,0,3,0,0.0006367750316264,0.0,3,3,fhi:git
county,Trøndelag,2021-01-05,407,0,410,0,0.0870259209889541,0.0,407,410,fhi:git
county,Trøndelag,2021-01-06,674,0,1084,0,0.23008804476104,0.0,674,1084,fhi:git
county,Trøndelag,2021-01-07,484,0,1568,0,0.332821083196781,0.0,484,1568,fhi:git
county,Trøndelag,2021-01-08,141,0,1709,0,0.362749509683226,0.0,141,1709,fhi:git
county,Trøndelag,2021-01-09,0,0,1709,0,0.362749509683226,0.0,0,1709,fhi:git
county,Trøndelag,2021-01-10,0,0,1709,0,0.362749509683226,0.0,0,1709,fhi:git
county,Trøndelag,2021-01-11,95,0,1804,0,0.382914052351398,0.0,95,1804,fhi:git
county,Trøndelag,2021-01-12,500,0,2304,0,0.489043224289147,0.0,500,2304,fhi:git
county,Trøndelag,2021-01-13,860,0,3164,0,0.671585400022075,0.0,860,3164,fhi:git
county,Trøndelag,2021-01-14,670,0,3834,0,0.813798490418659,0.0,670,3834,fhi:git
county,Trøndelag,2021-01-15,253,0,4087,0,0.867499851419159,0.0,253,4087,fhi:git
county,Trøndelag,2021-01-16,0,0,4087,0,0.867499851419159,0.0,0,4087,fhi:git
county,Trøndelag,2021-01-17,0,0,4087,0,0.867499851419159,0.0,0,4087,fhi:git
county,Trøndelag,2021-01-18,152,0,4239,0,0.899763119688235,0.0,152,4239,fhi:git
county,Trøndelag,2021-01-19,568,0,4807,0,1.02032585900952,0.0,568,4807,fhi:git
county,Trøndelag,2021-01-20,738,0,5545,0,1.17697251678964,0.0,738,5545,fhi:git
county,Trøndelag,2021-01-21,535,0,6080,0,1.29053073076303,0.0,535,6080,fhi:git
county,Trøndelag,2021-01-22,283,0,6363,0,1.35059984207979,0.0,283,6363,fhi:git
county,Trøndelag,2021-01-23,1,0,6364,0,1.35081210042367,0.0,1,6364,fhi:git
county,Trøndelag,2021-01-24,0,0,6364,0,1.35081210042367,0.0,0,6364,fhi:git
county,Trøndelag,2021-01-25,1,0,6365,0,1.35102435876754,0.0,1,6365,fhi:git
county,Trøndelag,2021-01-26,313,184,6678,184,1.41746122040057,0.0390555352730916,497,6862,fhi:git
county,Trøndelag,2021-01-27,1013,604,7691,788,1.63247892274645,0.167259574973892,1617,8479,fhi:git
county,Trøndelag,2021-01-28,727,483,8418,1271,1.78679073874394,0.269780355065758,1210,9689,fhi:git
county,Trøndelag,2021-01-29,423,229,8841,1500,1.87657601820328,0.318387515813247,652,10341,fhi:git
county,Trøndelag,2021-01-30,1,0,8842,1500,1.87678827654715,0.318387515813247,1,10342,fhi:git
county,Trøndelag,2021-01-31,2,1,8844,1501,1.8772127932349,0.318599774157122,3,10345,fhi:git
county,Trøndelag,2021-02-01,14,86,8858,1587,1.88018441004916,0.336853991730415,100,10445,fhi:git
county,Trøndelag,2021-02-02,836,392,9694,1979,2.05763238552908,0.42005926252961,1228,11673,fhi:git
county,Trøndelag,2021-02-03,2124,810,11818,2789,2.50846910792063,0.591988521068763,2934,14607,fhi:git
county,Trøndelag,2021-02-04,2143,607,13961,3396,2.96333873884582,0.72082933580119,2750,17357,fhi:git
county,Trøndelag,2021-02-05,1293,319,15254,3715,3.23778877747684,0.788539747497474,1612,18969,fhi:git
county,Trøndelag,2021-02-06,7,0,15261,3715,3.23927458588397,0.788539747497474,7,18976,fhi:git
county,Trøndelag,2021-02-07,1,0,15262,3715,3.23948684422785,0.788539747497474,1,18977,fhi:git
county,Trøndelag,2021-02-08,3,150,15265,3865,3.24012361925947,0.820378499078799,153,19130,fhi:git
county,Trøndelag,2021-02-09,836,523,16101,4388,3.41757159473939,0.931389612925684,1359,20489,fhi:git
county,Trøndelag,2021-02-10,2232,628,18333,5016,3.8913322182695,1.0646878528795,2860,23349,fhi:git
county,Trøndelag,2021-02-11,2361,586,20694,5602,4.39247416815955,1.18907124239054,2947,26296,fhi:git
county,Trøndelag,2021-02-12,888,352,21582,5954,4.58095957752099,1.26378617943471,1240,27536,fhi:git
county,Trøndelag,2021-02-13,2,0,21584,5954,4.58138409420874,1.26378617943471,2,27538,fhi:git
county,Trøndelag,2021-02-14,0,0,21584,5954,4.58138409420874,1.26378617943471,0,27538,fhi:git
county,Trøndelag,2021-02-15,0,2,21584,5956,4.58138409420874,1.26421069612246,2,27540,fhi:git
county,Trøndelag,2021-02-16,344,210,21928,6166,4.65440096450192,1.30878494833632,554,28094,fhi:git
county,Trøndelag,2021-02-17,2224,922,24152,7088,5.12646352128102,1.50448714138953,3146,31240,fhi:git
county,Trøndelag,2021-02-18,2118,752,26270,7840,5.57602669360933,1.6641054159839,2870,34110,fhi:git
county,Trøndelag,2021-02-19,1262,410,27532,8250,5.8438967235802,1.75113133697286,1672,35782,fhi:git
county,Trøndelag,2021-02-20,1,1,27533,8251,5.84410898192408,1.75134359531673,2,35784,fhi:git
county,Trøndelag,2021-02-21,0,4,27533,8255,5.84410898192408,1.75219262869223,4,35788,fhi:git
county,Trøndelag,2021-02-22,17,2,27550,8257,5.84771737376996,1.75261714537998,19,35807,fhi:git
county,Trøndelag,2021-02-23,334,674,27884,8931,5.91861166062438,1.89567926915207,1008,36815,fhi:git
county,Trøndelag,2021-02-24,1010,2046,28894,10977,6.13299258793863,2.32995984072134,3056,39871,fhi:git
county,Trøndelag,2021-02-25,474,1982,29368,12959,6.23360304293562,2.75065587828258,2456,42327,fhi:git
county,Trøndelag,2021-02-26,612,1155,29980,14114,6.36350514938742,2.99581426545878,1767,44094,fhi:git
county,Trøndelag,2021-02-27,4,1,29984,14115,6.36435418276292,2.99602652380265,5,44099,fhi:git
county,Trøndelag,2021-02-28,1,0,29985,14115,6.3645664411068,2.99602652380265,1,44100,fhi:git
county,Trøndelag,2021-03-01,526,0,30511,14115,6.47621432998531,2.99602652380265,526,44626,fhi:git
county,Trøndelag,2021-03-02,819,785,31330,14900,6.65005391361934,3.16264932374492,1604,46230,fhi:git
county,Trøndelag,2021-03-03,2017,2142,33347,17042,7.07817899321622,3.61730669632623,4159,50389,fhi:git
county,Trøndelag,2021-03-04,1875,2282,35222,19324,7.47616338798278,4.10168023705012,4157,54546,fhi:git
county,Trøndelag,2021-03-05,1048,982,36270,20306,7.6986101323643,4.31011793073586,2030,56576,fhi:git
county,Trøndelag,2021-03-06,2,0,36272,20306,7.69903464905205,4.31011793073586,2,56578,fhi:git
county,Trøndelag,2021-03-07,0,1,36272,20307,7.69903464905205,4.31033018907973,1,56579,fhi:git
county,Trøndelag,2021-03-08,435,0,36707,20307,7.7913670286379,4.31033018907973,435,57014,fhi:git
county,Trøndelag,2021-03-09,1172,301,37879,20608,8.04013380765998,4.37421995058626,1473,58487,fhi:git
county,Trøndelag,2021-03-10,1684,1500,39563,22108,8.39757685874632,4.69260746639951,3184,61671,fhi:git
county,Trøndelag,2021-03-11,826,1195,40389,23303,8.57290225078748,4.94625618733072,2021,63692,fhi:git
county,Trøndelag,2021-03-12,122,500,40511,23803,8.59879776874029,5.05238535926847,622,64314,fhi:git
county,Trøndelag,2021-03-13,0,1,40511,23804,8.59879776874029,5.05259761761235,1,64315,fhi:git
county,Trøndelag,2021-03-14,0,0,40511,23804,8.59879776874029,5.05259761761235,0,64315,fhi:git
county,Trøndelag,2021-03-15,3,6,40514,23810,8.59943454377192,5.0538711676756,9,64324,fhi:git
county,Trøndelag,2021-03-16,606,12,41120,23822,8.72806310016047,5.05641826780211,618,64942,fhi:git
county,Trøndelag,2021-03-17,1978,122,43098,23944,9.1479101043462,5.08231378575492,2100,67042,fhi:git
county,Trøndelag,2021-03-18,1498,123,44596,24067,9.4658731034717,5.1084215620516,1621,68663,fhi:git
county,Trøndelag,2021-03-19,542,88,45138,24155,9.58091712585222,5.12710029631265,630,69293,fhi:git
county,Trøndelag,2021-03-20,0,0,45138,24155,9.58091712585222,5.12710029631265,0,69293,fhi:git
county,Trøndelag,2021-03-21,0,0,45138,24155,9.58091712585222,5.12710029631265,0,69293,fhi:git
county,Trøndelag,2021-03-22,1,0,45139,24155,9.58112938419609,5.12710029631265,1,69294,fhi:git
county,Trøndelag,2021-03-23,1047,216,46186,24371,9.80336387023374,5.17294809858976,1263,70557,fhi:git
county,Trøndelag,2021-03-24,3108,545,49294,24916,10.4630628029988,5.2886288960019,3653,74210,fhi:git
county,Trøndelag,2021-03-25,2885,304,52179,25220,11.0754281250796,5.35315543254005,3189,77399,fhi:git
county,Trøndelag,2021-03-26,1980,218,54159,25438,11.4956996459531,5.39942775150491,2198,79597,fhi:git
county,Trøndelag,2021-03-27,0,3,54159,25441,11.4956996459531,5.40006452653654,3,79600,fhi:git
county,Trøndelag,2021-03-28,0,0,54159,25441,11.4956996459531,5.40006452653654,0,79600,fhi:git
county,Trøndelag,2021-03-29,3,0,54162,25441,11.4963364209847,5.40006452653654,3,79603,fhi:git
county,Trøndelag,2021-03-30,1848,524,56010,25965,11.8885898404666,5.5112878987273,2372,81975,fhi:git
county,Trøndelag,2021-03-31,2510,422,58520,26387,12.4213582835941,5.60086091984276,2932,84907,fhi:git
county,Trøndelag,2021-04-01,162,156,58682,26543,12.455744135302,5.63397322148734,318,85225,fhi:git
county,Trøndelag,2021-04-02,152,93,58834,26636,12.488007403571,5.65371324746776,245,85470,fhi:git
county,Trøndelag,2021-04-03,0,0,58834,26636,12.488007403571,5.65371324746776,0,85470,fhi:git
county,Trøndelag,2021-04-04,0,0,58834,26636,12.488007403571,5.65371324746776,0,85470,fhi:git
county,Vestfold og Telemark,2020-12-27,0,0,0,0,0.0,0.0,0,0,fhi:git
county,Vestfold og Telemark,2020-12-28,0,0,0,0,0.0,0.0,0,0,fhi:git
county,Vestfold og Telemark,2020-12-29,0,0,0,0,0.0,0.0,0,0,fhi:git
county,Vestfold og Telemark,2020-12-30,0,0,0,0,0.0,0.0,0,0,fhi:git
county,Vestfold og Telemark,2020-12-31,0,0,0,0,0.0,0.0,0,0,fhi:git
county,Vestfold og Telemark,2021-01-01,0,0,0,0,0.0,0.0,0,0,fhi:git
county,Vestfold og Telemark,2021-01-02,0,0,0,0,0.0,0.0,0,0,fhi:git
county,Vestfold og Telemark,2021-01-03,0,0,0,0,0.0,0.0,0,0,fhi:git
county,Vestfold og Telemark,2021-01-04,1,0,1,0,0.0002370331040433,0.0,1,1,fhi:git
county,Vestfold og Telemark,2021-01-05,218,0,219,0,0.051910249785485,0.0,218,219,fhi:git
county,Vestfold og Telemark,2021-01-06,1026,0,1245,0,0.295106214533922,0.0,1026,1245,fhi:git
county,Vestfold og Telemark,2021-01-07,442,0,1687,0,0.399874846521065,0.0,442,1687,fhi:git
county,Vestfold og Telemark,2021-01-08,63,0,1750,0,0.414807932075794,0.0,63,1750,fhi:git
county,Vestfold og Telemark,2021-01-09,0,0,1750,0,0.414807932075794,0.0,0,1750,fhi:git
county,Vestfold og Telemark,2021-01-10,3,0,1753,0,0.415519031387924,0.0,3,1753,fhi:git
county,Vestfold og Telemark,2021-01-11,3,0,1756,0,0.416230130700054,0.0,3,1756,fhi:git
county,Vestfold og Telemark,2021-01-12,420,0,2176,0,0.515784034398244,0.0,420,2176,fhi:git
county,Vestfold og Telemark,2021-01-13,1164,0,3340,0,0.791690567504658,0.0,1164,3340,fhi:git
county,Vestfold og Telemark,2021-01-14,583,0,3923,0,0.929880867161908,0.0,583,3923,fhi:git
county,Vestfold og Telemark,2021-01-15,157,0,4080,0,0.967095064496707,0.0,157,4080,fhi:git
county,Vestfold og Telemark,2021-01-16,3,0,4083,0,0.967806163808838,0.0,3,4083,fhi:git
county,Vestfold og Telemark,2021-01-17,42,0,4125,0,0.977761554178656,0.0,42,4125,fhi:git
county,Vestfold og Telemark,2021-01-18,7,0,4132,0,0.97942078590696,0.0,7,4132,fhi:git
county,Vestfold og Telemark,2021-01-19,232,0,4364,0,1.03441246604501,0.0,232,4364,fhi:git
county,Vestfold og Telemark,2021-01-20,1606,0,5970,0,1.41508763113856,0.0,1606,5970,fhi:git
county,Vestfold og Telemark,2021-01-21,829,0,6799,0,1.61158807439047,0.0,829,6799,fhi:git
county,Vestfold og Telemark,2021-01-22,181,0,6980,0,1.65449106622231,0.0,181,6980,fhi:git
county,Vestfold og Telemark,2021-01-23,3,0,6983,0,1.65520216553444,0.0,3,6983,fhi:git
county,Vestfold og Telemark,2021-01-24,0,0,6983,0,1.65520216553444,0.0,0,6983,fhi:git
county,Vestfold og Telemark,2021-01-25,44,0,7027,0,1.66563162211234,0.0,44,7027,fhi:git
county,Vestfold og Telemark,2021-01-26,103,179,7130,179,1.69004603182881,0.0424289256237526,282,7309,fhi:git
county,Vestfold og Telemark,2021-01-27,1625,899,8755,1078,2.07522482589919,0.255521686158689,2524,9833,fhi:git
county,Vestfold og Telemark,2021-01-28,655,449,9410,1527,2.23048150904755,0.361949549874135,1104,10937,fhi:git
county,Vestfold og Telemark,2021-01-29,86,90,9496,1617,2.25086635599528,0.383282529238033,176,11113,fhi:git
county,Vestfold og Telemark,2021-01-30,0,0,9496,1617,2.25086635599528,0.383282529238033,0,11113,fhi:git
county,Vestfold og Telemark,2021-01-31,1,2,9497,1619,2.25110338909932,0.38375659544612,3,11116,fhi:git
county,Vestfold og Telemark,2021-02-01,50,1,9547,1620,2.26295504430149,0.383993628550163,51,11167,fhi:git
county,Vestfold og Telemark,2021-02-02,464,327,10011,1947,2.37293840457758,0.461503453572326,791,11958,fhi:git
county,Vestfold og Telemark,2021-02-03,3215,847,13226,2794,3.13499983407683,0.66227049269701,4062,16020,fhi:git
county,Vestfold og Telemark,2021-02-04,1903,708,15129,3502,3.58607383107125,0.830089930359674,2611,18631,fhi:git
county,Vestfold og Telemark,2021-02-05,964,245,16093,3747,3.814573743369,0.888163040850285,1209,19840,fhi:git
county,Vestfold og Telemark,2021-02-06,0,4,16093,3751,3.814573743369,0.889111173266458,4,19844,fhi:git
county,Vestfold og Telemark,2021-02-07,2,1,16095,3752,3.81504780957709,0.889348206370502,3,19847,fhi:git
county,Vestfold og Telemark,2021-02-08,17,46,16112,3798,3.81907737234582,0.900251729156494,63,19910,fhi:git
county,Vestfold og Telemark,2021-02-09,356,208,16468,4006,3.90346115738524,0.949554614797503,564,20474,fhi:git
county,Vestfold og Telemark,2021-02-10,2891,1395,19359,5401,4.58872386117445,1.28021579493792,4286,24760,fhi:git
county,Vestfold og Telemark,2021-02-11,1540,878,20899,6279,4.95375484140115,1.48833086028795,2418,27178,fhi:git
county,Vestfold og Telemark,2021-02-12,602,213,21501,6492,5.09644877003522,1.53881891144917,815,27993,fhi:git
county,Vestfold og Telemark,2021-02-13,2,2,21503,6494,5.09692283624331,1.53929297765726,4,27997,fhi:git
county,Vestfold og Telemark,2021-02-14,0,0,21503,6494,5.09692283624331,1.53929297765726,0,27997,fhi:git
county,Vestfold og Telemark,2021-02-15,4,2,21507,6496,5.09787096865948,1.53976704386535,6,28003,fhi:git
county,Vestfold og Telemark,2021-02-16,579,75,22086,6571,5.23511313590056,1.55754452666859,654,28657,fhi:git
county,Vestfold og Telemark,2021-02-17,3042,1532,25128,8103,5.95616783840031,1.92067924206295,4574,33231,fhi:git
county,Vestfold og Telemark,2021-02-18,1820,629,26948,8732,6.38756808775914,2.06977306450619,2449,35680,fhi:git
county,Vestfold og Telemark,2021-02-19,283,83,27231,8815,6.45464845620339,2.08944681214178,366,36046,fhi:git
county,Vestfold og Telemark,2021-02-20,0,1,27231,8816,6.45464845620339,2.08968384524583,1,36047,fhi:git
county,Vestfold og Telemark,2021-02-21,1,1,27232,8817,6.45488548930744,2.08992087834987,2,36049,fhi:git
county,Vestfold og Telemark,2021-02-22,50,0,27282,8817,6.4667371445096,2.08992087834987,50,36099,fhi:git
county,Vestfold og Telemark,2021-02-23,626,385,27908,9202,6.61511986764072,2.18117862340655,1011,37110,fhi:git
county,Vestfold og Telemark,2021-02-24,666,2870,28574,12072,6.77298391493356,2.86146363201085,3536,40646,fhi:git
county,Vestfold og Telemark,2021-02-25,702,1992,29276,14064,6.93938115397196,3.33363357526512,2694,43340,fhi:git
county,Vestfold og Telemark,2021-02-26,543,845,29819,14909,7.06809012946748,3.53392654818172,1388,44728,fhi:git
county,Vestfold og Telemark,2021-02-27,3,2,29822,14911,7.06880122877961,3.53440061438981,5,44733,fhi:git
county,Vestfold og Telemark,2021-02-28,0,0,29822,14911,7.06880122877961,3.53440061438981,0,44733,fhi:git
county,Vestfold og Telemark,2021-03-01,609,0,30431,14911,7.21315438914199,3.53440061438981,609,45342,fhi:git
county,Vestfold og Telemark,2021-03-02,844,354,31275,15265,7.41321032895454,3.61831033322114,1198,46540,fhi:git
county,Vestfold og Telemark,2021-03-03,1975,2813,33250,18078,7.88135070944008,4.28508445489497,4788,51328,fhi:git
county,Vestfold og Telemark,2021-03-04,1011,1431,34261,19509,8.12099117762787,4.62427882678095,2442,53770,fhi:git
county,Vestfold og Telemark,2021-03-05,1476,585,35737,20094,8.47085203919579,4.76294319264629,2061,55831,fhi:git
county,Vestfold og Telemark,2021-03-06,2,1,35739,20095,8.47132610540388,4.76318022575033,3,55834,fhi:git
county,Vestfold og Telemark,2021-03-07,0,0,35739,20095,8.47132610540388,4.76318022575033,0,55834,fhi:git
county,Vestfold og Telemark,2021-03-08,236,0,35975,20095,8.5272659179581,4.76318022575033,236,56070,fhi:git
county,Vestfold og Telemark,2021-03-09,934,142,36909,20237,8.74865483713456,4.79683892652448,1076,57146,fhi:git
county,Vestfold og Telemark,2021-03-10,1593,2260,38502,22497,9.12624857187555,5.33253374166236,3853,60999,fhi:git
county,Vestfold og Telemark,2021-03-11,296,835,38798,23332,9.19641037067237,5.53045638353853,1131,62130,fhi:git
county,Vestfold og Telemark,2021-03-12,35,126,38833,23458,9.20470652931388,5.56032255464798,161,62291,fhi:git
county,Vestfold og Telemark,2021-03-13,1,1,38834,23459,9.20494356241793,5.56055958775203,2,62293,fhi:git
county,Vestfold og Telemark,2021-03-14,0,0,38834,23459,9.20494356241793,5.56055958775203,0,62293,fhi:git
county,Vestfold og Telemark,2021-03-15,2,3,38836,23462,9.20541762862601,5.56127068706416,5,62298,fhi:git
county,Vestfold og Telemark,2021-03-16,402,25,39238,23487,9.30070493645142,5.56719651466524,427,62725,fhi:git
county,Vestfold og Telemark,2021-03-17,3102,166,42340,23653,10.0359816251938,5.60654400993643,3268,65993,fhi:git
county,Vestfold og Telemark,2021-03-18,911,53,43251,23706,10.2519187829772,5.61910676445072,964,66957,fhi:git
county,Vestfold og Telemark,2021-03-19,27,32,43278,23738,10.2583186767864,5.62669182378011,59,67016,fhi:git
county,Vestfold og Telemark,2021-03-20,0,0,43278,23738,10.2583186767864,5.62669182378011,0,67016,fhi:git
county,Vestfold og Telemark,2021-03-21,0,0,43278,23738,10.2583186767864,5.62669182378011,0,67016,fhi:git
county,Vestfold og Telemark,2021-03-22,0,1,43278,23739,10.2583186767864,5.62692885688415,1,67017,fhi:git
county,Vestfold og Telemark,2021-03-23,660,58,43938,23797,10.414760525455,5.64067677691867,718,67735,fhi:git
county,Vestfold og Telemark,2021-03-24,4610,813,48548,24610,11.5074831350946,5.83338469050588,5423,73158,fhi:git
county,Vestfold og Telemark,2021-03-25,2940,262,51488,24872,12.204360460982,5.89548736376522,3202,76360,fhi:git
county,Vestfold og Telemark,2021-03-26,897,152,52385,25024,12.4169791553088,5.93151639557981,1049,77409,fhi:git
county,Vestfold og Telemark,2021-03-27,0,0,52385,25024,12.4169791553088,5.93151639557981,0,77409,fhi:git
county,Vestfold og Telemark,2021-03-28,0,0,52385,25024,12.4169791553088,5.93151639557981,0,77409,fhi:git
county,Vestfold og Telemark,2021-03-29,184,3,52569,25027,12.4605932464528,5.93222749489194,187,77596,fhi:git
county,Vestfold og Telemark,2021-03-30,3012,79,55581,25106,13.1745369558313,5.95095311011136,3091,80687,fhi:git
county,Vestfold og Telemark,2021-03-31,3380,487,58961,25593,13.9757088474976,6.06638823178045,3867,84554,fhi:git
county,Vestfold og Telemark,2021-04-01,424,17,59385,25610,14.076210883612,6.07041779454919,441,84995,fhi:git
county,Vestfold og Telemark,2021-04-02,2,3,59387,25613,14.0766849498201,6.07112889386132,5,85000,fhi:git
county,Vestfold og Telemark,2021-04-03,1,0,59388,25613,14.0769219829241,6.07112889386132,1,85001,fhi:git
county,Vestfold og Telemark,2021-04-04,0,0,59388,25613,14.0769219829241,6.07112889386132,0,85001,fhi:git
county,Vestland,2020-12-27,0,0,0,0,0.0,0.0,0,0,fhi:git
county,Vestland,2020-12-28,0,0,0,0,0.0,0.0,0,0,fhi:git
county,Vestland,2020-12-29,0,0,0,0,0.0,0.0,0,0,fhi:git
county,Vestland,2020-12-30,0,0,0,0,0.0,0.0,0,0,fhi:git
county,Vestland,2020-12-31,0,0,0,0,0.0,0.0,0,0,fhi:git
county,Vestland,2021-01-01,0,0,0,0,0.0,0.0,0,0,fhi:git
county,Vestland,2021-01-02,0,0,0,0,0.0,0.0,0,0,fhi:git
county,Vestland,2021-01-03,0,0,0,0,0.0,0.0,0,0,fhi:git
county,Vestland,2021-01-04,2,0,2,0,0.0003130767460681,0.0,2,2,fhi:git
county,Vestland,2021-01-05,416,0,418,0,0.0654330399282428,0.0,416,418,fhi:git
county,Vestland,2021-01-06,1256,0,1674,0,0.262045236459039,0.0,1256,1674,fhi:git
county,Vestland,2021-01-07,715,0,2389,0,0.373970173178402,0.0,715,2389,fhi:git
county,Vestland,2021-01-08,139,0,2528,0,0.395729007030138,0.0,139,2528,fhi:git
county,Vestland,2021-01-09,0,0,2528,0,0.395729007030138,0.0,0,2528,fhi:git
county,Vestland,2021-01-10,0,0,2528,0,0.395729007030138,0.0,0,2528,fhi:git
county,Vestland,2021-01-11,65,0,2593,0,0.405904001277353,0.0,65,2593,fhi:git
county,Vestland,2021-01-12,856,0,3449,0,0.53990084859452,0.0,856,3449,fhi:git
county,Vestland,2021-01-13,1127,0,4576,0,0.716319595003921,0.0,1127,4576,fhi:git
county,Vestland,2021-01-14,999,0,5575,0,0.872701429664961,0.0,999,5575,fhi:git
county,Vestland,2021-01-15,425,0,6000,0,0.939230238204442,0.0,425,6000,fhi:git
county,Vestland,2021-01-16,2,0,6002,0,0.93954331495051,0.0,2,6002,fhi:git
county,Vestland,2021-01-17,1,0,6003,0,0.939699853323544,0.0,1,6003,fhi:git
county,Vestland,2021-01-18,62,0,6065,0,0.949405232451657,0.0,62,6065,fhi:git
county,Vestland,2021-01-19,368,0,6433,0,1.0070113537282,0.0,368,6433,fhi:git
county,Vestland,2021-01-20,1235,0,7668,0,1.20033624442528,0.0,1235,7668,fhi:git
county,Vestland,2021-01-21,782,0,8450,0,1.32274925213792,0.0,782,8450,fhi:git
county,Vestland,2021-01-22,312,0,8762,0,1.37158922452455,0.0,312,8762,fhi:git
county,Vestland,2021-01-23,0,0,8762,0,1.37158922452455,0.0,0,8762,fhi:git
county,Vestland,2021-01-24,0,0,8762,0,1.37158922452455,0.0,0,8762,fhi:git
county,Vestland,2021-01-25,2,0,8764,0,1.37190230127062,0.0,2,8764,fhi:git
county,Vestland,2021-01-26,152,174,8916,174,1.3956961339718,0.0272376769079288,326,9090,fhi:git
county,Vestland,2021-01-27,1590,1211,10506,1385,1.64459214709598,0.216805646652192,2801,11891,fhi:git
county,Vestland,2021-01-28,1958,695,12464,2080,1.95109428149669,0.325599815910873,2653,14544,fhi:git
county,Vestland,2021-01-29,481,176,12945,2256,2.02638923892608,0.35315056956487,657,15201,fhi:git
county,Vestland,2021-01-30,3,0,12948,2256,2.02685885404519,0.35315056956487,3,15204,fhi:git
county,Vestland,2021-01-31,1,0,12949,2256,2.02701539241822,0.35315056956487,1,15205,fhi:git
county,Vestland,2021-02-01,13,59,12962,2315,2.02905039126766,0.362386333573881,72,15277,fhi:git
county,Vestland,2021-02-02,722,582,13684,2897,2.14207109659826,0.453491666679712,1304,16581,fhi:git
county,Vestland,2021-02-03,2830,1049,16514,3946,2.58507469228469,0.617700419992455,3879,20460,fhi:git
county,Vestland,2021-02-04,2589,1114,19103,5060,2.99035254006991,0.792084167552413,3703,24163,fhi:git
county,Vestland,2021-02-05,911,487,20014,5547,3.13295899790395,0.868318355220007,1398,25561,fhi:git
county,Vestland,2021-02-06,0,2,20014,5549,3.13295899790395,0.868631431966075,2,25563,fhi:git
county,Vestland,2021-02-07,2,1,20016,5550,3.13327207465002,0.868787970339109,3,25566,fhi:git
county,Vestland,2021-02-08,8,49,20024,5599,3.13452438163429,0.876458350617779,57,25623,fhi:git
county,Vestland,2021-02-09,891,307,20915,5906,3.27400007200765,0.924515631139239,1198,26821,fhi:git
county,Vestland,2021-02-10,2757,971,23672,6877,3.70557636646259,1.07651439135532,3728,30549,fhi:git
county,Vestland,2021-02-11,2704,835,26376,7712,4.12885612714673,1.20722393283878,3539,34088,fhi:git
county,Vestland,2021-02-12,621,458,26997,8170,4.22606645680089,1.27891850768838,1079,35167,fhi:git
county,Vestland,2021-02-13,0,0,26997,8170,4.22606645680089,1.27891850768838,0,35167,fhi:git
county,Vestland,2021-02-14,0,2,26997,8172,4.22606645680089,1.27923158443445,2,35169,fhi:git
county,Vestland,2021-02-15,94,1,27091,8173,4.24078106386609,1.27938812280748,95,35264,fhi:git
county,Vestland,2021-02-16,1087,55,28178,8228,4.41093827535413,1.28799773332436,1142,36406,fhi:git
county,Vestland,2021-02-17,2689,1328,30867,9556,4.83186996044275,1.49588069271361,4017,40423,fhi:git
county,Vestland,2021-02-18,2004,1999,32871,11555,5.14557286000304,1.80880090040872,4003,44426,fhi:git
county,Vestland,2021-02-19,1157,540,34028,12095,5.32668775760346,1.89333162184712,1697,46123,fhi:git
county,Vestland,2021-02-20,3,4,34031,12099,5.32715737272256,1.89395777533926,7,46130,fhi:git
county,Vestland,2021-02-21,0,1,34031,12100,5.32715737272256,1.89411431371229,1,46131,fhi:git
county,Vestland,2021-02-22,48,2,34079,12102,5.3346712146282,1.89442739045836,50,46181,fhi:git
county,Vestland,2021-02-23,540,591,34619,12693,5.4192019360666,1.9869415689215,1131,47312,fhi:git
county,Vestland,2021-02-24,1345,2401,35964,15094,5.62974604779743,2.36279020257631,3746,51058,fhi:git
county,Vestland,2021-02-25,1258,2646,37222,17740,5.82667132107429,2.77699073762447,3904,54962,fhi:git
county,Vestland,2021-02-26,1397,875,38619,18615,6.04535542820289,2.91396181402928,2272,57234,fhi:git
county,Vestland,2021-02-27,1,0,38620,18615,6.04551196657593,2.91396181402928,1,57235,fhi:git
county,Vestland,2021-02-28,0,7,38620,18622,6.04551196657593,2.91505758264052,7,57242,fhi:git
county,Vestland,2021-03-01,440,11,39060,18633,6.11438885071092,2.9167795047439,451,57693,fhi:git
county,Vestland,2021-03-02,1351,758,40411,19391,6.32587219267995,3.03543559150372,2109,59802,fhi:git
county,Vestland,2021-03-03,1746,2043,42157,21434,6.59918819199744,3.35524348761234,3789,63591,fhi:git
county,Vestland,2021-03-04,1795,2846,43952,24280,6.88017457159361,3.80075169726731,4641,68232,fhi:git
county,Vestland,2021-03-05,1251,895,45203,25175,7.07600407625923,3.94085354113281,2146,70378,fhi:git
county,Vestland,2021-03-06,1,6,45204,25181,7.07616061463227,3.94179277137101,7,70385,fhi:git
county,Vestland,2021-03-07,2,0,45206,25181,7.07647369137834,3.94179277137101,2,70387,fhi:git
county,Vestland,2021-03-08,630,14,45836,25195,7.1750928663898,3.94398430859349,644,71031,fhi:git
county,Vestland,2021-03-09,1499,527,47335,25722,7.40974388756788,4.02648003118244,2026,73057,fhi:git
county,Vestland,2021-03-10,2440,1830,49775,27552,7.79169751777102,4.3129452538348,4270,77327,fhi:git
county,Vestland,2021-03-11,1402,1540,51177,29092,8.01116431676479,4.55401434830727,2942,80269,fhi:git
county,Vestland,2021-03-12,178,974,51355,30066,8.03902814716486,4.70648272364246,1152,81421,fhi:git
county,Vestland,2021-03-13,8,10,51363,30076,8.04028045414913,4.7080481073728,18,81439,fhi:git
county,Vestland,2021-03-14,0,0,51363,30076,8.04028045414913,4.7080481073728,0,81439,fhi:git
county,Vestland,2021-03-15,7,8,51370,30084,8.04137622276037,4.70930041435707,15,81454,fhi:git
county,Vestland,2021-03-16,1191,33,52561,30117,8.22781342504395,4.7144661806672,1224,82678,fhi:git
county,Vestland,2021-03-17,2429,222,54990,30339,8.60804513314371,4.74921769948076,2651,85329,fhi:git
county,Vestland,2021-03-18,2313,145,57303,30484,8.97011838997153,4.7719157635707,2458,87787,fhi:git
county,Vestland,2021-03-19,587,115,57890,30599,9.06200641494253,4.78991767646962,702,88489,fhi:git
county,Vestland,2021-03-20,1,2,57891,30601,9.06216295331556,4.79023075321569,3,88492,fhi:git
county,Vestland,2021-03-21,0,0,57891,30601,9.06216295331556,4.79023075321569,0,88492,fhi:git
county,Vestland,2021-03-22,8,13,57899,30614,9.06341526029983,4.79226575206513,21,88513,fhi:git
county,Vestland,2021-03-23,2048,339,59947,30953,9.38400584827362,4.84533226052368,2387,90900,fhi:git
county,Vestland,2021-03-24,4009,510,63956,31463,10.0115681857672,4.92516683077106,4519,95419,fhi:git
county,Vestland,2021-03-25,3130,374,67086,31837,10.5015332933639,4.98371218228581,3504,98923,fhi:git
county,Vestland,2021-03-26,993,187,68079,32024,10.6569758977867,5.01298485804318,1180,100103,fhi:git
county,Vestland,2021-03-27,2,0,68081,32024,10.6572889745328,5.01298485804318,2,100105,fhi:git
county,Vestland,2021-03-28,0,0,68081,32024,10.6572889745328,5.01298485804318,0,100105,fhi:git
county,Vestland,2021-03-29,114,2,68195,32026,10.6751343490587,5.01329793478925,116,100221,fhi:git
county,Vestland,2021-03-30,3565,569,71760,32595,11.2331936489251,5.10236826904563,4134,104355,fhi:git
county,Vestland,2021-03-31,3340,1109,75100,33704,11.7560318148589,5.27596932474042,4449,108804,fhi:git
county,Vestland,2021-04-01,947,232,76047,33936,11.9042736541222,5.31228622728433,1179,109983,fhi:git
county,Vestland,2021-04-02,53,85,76100,34021,11.912570187893,5.32559198899222,138,110121,fhi:git
county,Vestland,2021-04-03,0,0,76100,34021,11.912570187893,5.32559198899222,0,110121,fhi:git
county,Vestland,2021-04-04,0,1,76100,34022,11.912570187893,5.32574852736526,1,110122,fhi:git
county,Viken,2020-12-27,0,0,0,0,0.0,0.0,0,0,fhi:git
county,Viken,2020-12-28,65,0,65,0,0.0052370152236004,0.0,65,65,fhi:git
county,Viken,2020-12-29,689,0,754,0,0.0607493765937647,0.0,689,754,fhi:git
county,Viken,2020-12-30,219,0,973,0,0.0783940894240492,0.0,219,973,fhi:git
county,Viken,2020-12-31,67,0,1040,0,0.0837922435776065,0.0,67,1040,fhi:git
county,Viken,2021-01-01,0,0,1040,0,0.0837922435776065,0.0,0,1040,fhi:git
county,Viken,2021-01-02,0,0,1040,0,0.0837922435776065,0.0,0,1040,fhi:git
county,Viken,2021-01-03,0,0,1040,0,0.0837922435776065,0.0,0,1040,fhi:git
county,Viken,2021-01-04,0,0,1040,0,0.0830416230165828,0.0,0,1040,fhi:git
county,Viken,2021-01-05,526,0,1566,0,0.125041520811508,0.0,526,1566,fhi:git
county,Viken,2021-01-06,1649,0,3215,0,0.256710401921455,0.0,1649,3215,fhi:git
county,Viken,2021-01-07,1922,0,5137,0,0.410177709073256,0.0,1922,5137,fhi:git
county,Viken,2021-01-08,282,0,5419,0,0.43269476454506,0.0,282,5419,fhi:git
county,Viken,2021-01-09,6,0,5425,0,0.433173850831694,0.0,6,5425,fhi:git
county,Viken,2021-01-10,5,0,5430,0,0.433573089403889,0.0,5,5430,fhi:git
county,Viken,2021-01-11,59,0,5489,0,0.438284104555791,0.0,59,5489,fhi:git
county,Viken,2021-01-12,788,0,6277,0,0.50120410353374,0.0,788,6277,fhi:git
county,Viken,2021-01-13,1945,0,8222,0,0.656507908117638,0.0,1945,8222,fhi:git
county,Viken,2021-01-14,1951,0,10173,0,0.81229079898817,0.0,1951,10173,fhi:git
county,Viken,2021-01-15,1049,0,11222,0,0.896051051434704,0.0,1049,11222,fhi:git
county,Viken,2021-01-16,90,0,11312,0,0.903237345734216,0.0,90,11312,fhi:git
county,Viken,2021-01-17,23,0,11335,0,0.905073843166313,0.0,23,11335,fhi:git
county,Viken,2021-01-18,144,51,11479,51,0.916571914045532,0.0040722334363901,195,11530,fhi:git
county,Viken,2021-01-19,648,384,12127,435,0.968313233002019,0.0347337557809745,1032,12562,fhi:git
county,Viken,2021-01-20,1492,342,13619,777,1.08744602294504,0.06204167411912,1834,14396,fhi:git
county,Viken,2021-01-21,1997,100,15616,877,1.24690190867977,0.0700264455630222,2097,16493,fhi:git
county,Viken,2021-01-22,820,1,16436,878,1.31237703451976,0.0701062932774612,821,17314,fhi:git
county,Viken,2021-01-23,98,0,16534,878,1.32020211053479,0.0701062932774612,98,17412,fhi:git
county,Viken,2021-01-24,0,0,16534,878,1.32020211053479,0.0701062932774612,0,17412,fhi:git
county,Viken,2021-01-25,62,0,16596,878,1.32515266883001,0.0701062932774612,62,17474,fhi:git
county,Viken,2021-01-26,563,402,17159,1280,1.37010693205918,0.102205074481948,965,18439,fhi:git
county,Viken,2021-01-27,1942,1218,19101,2498,1.52517119349976,0.199459590668677,3160,21599,fhi:git
county,Viken,2021-01-28,3105,1710,22206,4208,1.77309834683292,0.335999182359404,4815,26414,fhi:git
county,Viken,2021-01-29,1041,427,23247,4635,1.85621981756394,0.370094156424867,1468,27882,fhi:git
county,Viken,2021-01-30,10,18,23257,4653,1.85701829470833,0.371531415284769,28,27910,fhi:git
county,Viken,2021-01-31,10,3,23267,4656,1.85781677185272,0.371770958428086,13,27923,fhi:git
county,Viken,2021-02-01,36,47,23303,4703,1.86069128957253,0.37552380100672,83,28006,fhi:git
county,Viken,2021-02-02,1024,687,24327,5390,1.94245534915809,0.430379180826328,1711,29717,fhi:git
county,Viken,2021-02-03,4778,1723,29105,7113,2.32396772874773,0.567956792804763,6501,36218,fhi:git
county,Viken,2021-02-04,6642,1750,35747,8863,2.85431624805172,0.707690293073051,8392,44610,fhi:git
county,Viken,2021-02-05,3143,1098,38890,9961,3.10527761453356,0.795363083527097,4241,48851,fhi:git
county,Viken,2021-02-06,38,90,38928,10051,3.10831182768224,0.802549377826609,128,48979,fhi:git
county,Viken,2021-02-07,16,20,38944,10071,3.10958939111327,0.80414633211539,36,49015,fhi:git
county,Viken,2021-02-08,15,95,38959,10166,3.11078710682985,0.811731864987097,110,49125,fhi:git
county,Viken,2021-02-09,795,566,39754,10732,3.17426603980888,0.856925671359583,1361,50486,fhi:git
county,Viken,2021-02-10,3447,1325,43201,12057,3.44950111148019,0.962723892991287,4772,55258,fhi:git
county,Viken,2021-02-11,4848,1917,48049,13974,3.83660283108056,1.11579196157089,6765,62023,fhi:git
county,Viken,2021-02-12,2429,976,50478,14950,4.03055292945295,1.19372333086338,3405,65428,fhi:git
county,Viken,2021-02-13,24,97,50502,15047,4.03246927459948,1.20146855916396,121,65549,fhi:git
county,Viken,2021-02-14,6,0,50508,15047,4.03294836088612,1.20146855916396,6,65555,fhi:git
county,Viken,2021-02-15,356,125,50864,15172,4.06137414722641,1.21144952346884,481,66036,fhi:git
county,Viken,2021-02-16,1426,359,52290,15531,4.17523698801646,1.24011485295245,1785,67821,fhi:git
county,Viken,2021-02-17,4430,1812,56720,17343,4.52896236298132,1.38479891151596,6242,74063,fhi:git
county,Viken,2021-02-18,4893,2925,61613,20268,4.91965722973146,1.6183534762501,7818,81881,fhi:git
county,Viken,2021-02-19,3797,1282,65410,21550,5.22283900145642,1.72071824616092,5079,86960,fhi:git
county,Viken,2021-02-20,29,9,65439,21559,5.22515458517515,1.72143687559087,38,86998,fhi:git
county,Viken,2021-02-21,1,9,65440,21568,5.22523443288959,1.72215550502082,10,87008,fhi:git
county,Viken,2021-02-22,701,8,66141,21576,5.28120768071135,1.72279428673634,709,87717,fhi:git
county,Viken,2021-02-23,2128,756,68269,22332,5.45112361703759,1.78315915885224,2884,90601,fhi:git
county,Viken,2021-02-24,2466,4204,70735,26536,5.64802808084421,2.11883895035389,6670,97271,fhi:git
county,Viken,2021-02-25,2544,6270,73279,32806,5.85116066637709,2.61948411988655,8814,106085,fhi:git
county,Viken,2021-02-26,1930,2719,75209,35525,6.0052667552444,2.83659005544625,4649,110734,fhi:git
county,Viken,2021-02-27,165,88,75374,35613,6.01844162812684,2.84361665431689,253,110987,fhi:git
county,Viken,2021-02-28,416,1,75790,35614,6.05165827733347,2.84369650203133,417,111404,fhi:git
county,Viken,2021-03-01,1520,2,77310,35616,6.17302680328078,2.8438561974602,1522,112926,fhi:git
county,Viken,2021-03-02,3011,520,80321,36136,6.41344827145668,2.8853770089685,3531,116457,fhi:git
county,Viken,2021-03-03,4952,2695,85273,38831,6.80885415335872,3.10056659938166,7647,124104,fhi:git
county,Viken,2021-03-04,4395,3261,89668,42092,7.15978485831822,3.36094999616731,7656,131760,fhi:git
county,Viken,2021-03-05,2721,1781,92389,43873,7.37705048930679,3.50315877558321,4502,136262,fhi:git
county,Viken,2021-03-06,210,2,92599,43875,7.39381850933899,3.50331847101209,212,136474,fhi:git
county,Viken,2021-03-07,17,0,92616,43875,7.39517592048445,3.50331847101209,17,136491,fhi:git
county,Viken,2021-03-08,1130,22,93746,43897,7.48540383780055,3.50507512072974,1152,137643,fhi:git
county,Viken,2021-03-09,2888,715,96634,44612,7.71600403710044,3.56216623655364,3603,141246,fhi:git
county,Viken,2021-03-10,5393,3197,102027,47809,8.14662276107009,3.8174393796152,8590,149836,fhi:git
county,Viken,2021-03-11,3414,4763,105441,52572,8.41922285816491,4.19775404348826,8177,158013,fhi:git
county,Viken,2021-03-12,1219,3304,106660,55876,8.51655722206608,4.46157089199479,4523,162536,fhi:git
county,Viken,2021-03-13,6,8,106666,55884,8.51703630835271,4.4622096737103,14,162550,fhi:git
county,Viken,2021-03-14,2,5,106668,55889,8.51719600378159,4.46260891228249,7,162557,fhi:git
county,Viken,2021-03-15,35,47,106703,55936,8.51999067378695,4.46636175486113,82,162639,fhi:git
county,Viken,2021-03-16,774,303,107477,56239,8.58179280476276,4.49055561233615,1077,163716,fhi:git
county,Viken,2021-03-17,3981,413,111458,56652,8.8996665559445,4.52353271839947,4394,168110,fhi:git
county,Viken,2021-03-18,5904,434,117362,57086,9.37108746199249,4.558186626466,6338,174448,fhi:git
county,Viken,2021-03-19,2029,365,119391,57451,9.53309847458926,4.58733104223625,2394,176842,fhi:git
county,Viken,2021-03-20,6,1,119397,57452,9.5335775608759,4.58741088995069,7,176849,fhi:git
county,Viken,2021-03-21,6,1,119403,57453,9.53405664716253,4.58749073766513,7,176856,fhi:git
county,Viken,2021-03-22,400,24,119803,57477,9.56599573293814,4.58940708281166,424,177280,fhi:git
county,Viken,2021-03-23,2466,81,122269,57558,9.76290019674477,4.59587474768122,2547,179827,fhi:git
county,Viken,2021-03-24,7373,746,129642,58304,10.3516173953037,4.65544114265273,8119,187946,fhi:git
county,Viken,2021-03-25,10175,616,139817,58920,11.1640678897207,4.70462733474717,10791,198737,fhi:git
county,Viken,2021-03-26,5886,314,145703,59234,11.6340515369088,4.72969951708102,6200,204937,fhi:git
county,Viken,2021-03-27,4,1,145707,59235,11.6343709277666,4.72977936479546,5,204942,fhi:git
county,Viken,2021-03-28,4,0,145711,59235,11.6346903186243,4.72977936479546,4,204946,fhi:git
county,Viken,2021-03-29,1314,3,147025,59238,11.7396102153972,4.73001890793878,1317,206263,fhi:git
county,Viken,2021-03-30,6056,1600,153081,60838,12.2231679740399,4.85777525104122,7656,213919,fhi:git
county,Viken,2021-03-31,9773,1805,162854,62643,13.0035196872525,5.00190037560365,11578,225497,fhi:git
county,Viken,2021-04-01,3668,477,166522,63120,13.2964011038148,5.03998773539106,4145,229642,fhi:git
county,Viken,2021-04-02,2257,263,168779,63383,13.4766173953037,5.06098768428852,2520,232162,fhi:git
county,Viken,2021-04-03,4,0,168783,63383,13.4769367861614,5.06098768428852,4,232166,fhi:git
county,Viken,2021-04-04,13,0,168796,63383,13.4779748064491,5.06098768428852,13,232179,fhi:git
nation,Norge,2020-12-27,5,0,5,0,9.31518486915891e-05,0.0,5,5,fhi:git
nation,Norge,2020-12-28,604,0,609,0,0.0113458951706356,0.0,604,609,fhi:git
nation,Norge,2020-12-29,1067,0,1676,0,0.0312244996814207,0.0,1067,1676,fhi:git
nation,Norge,2020-12-30,427,0,2103,0,0.0391796675596824,0.0,427,2103,fhi:git
nation,Norge,2020-12-31,72,0,2175,0,0.0405210541808413,0.0,72,2175,fhi:git
nation,Norge,2021-01-01,6,0,2181,0,0.0406328363992712,0.0,6,2181,fhi:git
nation,Norge,2021-01-02,0,0,2181,0,0.0406328363992712,0.0,0,2181,fhi:git
nation,Norge,2021-01-03,3,0,2184,0,0.0406887275084861,0.0,3,2184,fhi:git
nation,Norge,2021-01-04,6,0,2190,0,0.0406204806237525,0.0,6,2190,fhi:git
nation,Norge,2021-01-05,3385,0,5575,0,0.103406018026219,0.0,3385,5575,fhi:git
nation,Norge,2021-01-06,9064,0,14639,0,0.271526582580417,0.0,9064,14639,fhi:git
nation,Norge,2021-01-07,6553,0,21192,0,0.393072705652312,0.0,6553,21192,fhi:git
nation,Norge,2021-01-08,1616,0,22808,0,0.423046539756414,0.0,1616,22808,fhi:git
nation,Norge,2021-01-09,135,0,22943,0,0.425550541986646,0.0,135,22943,fhi:git
nation,Norge,2021-01-10,108,0,23051,0,0.427553743770831,0.0,108,23051,fhi:git
nation,Norge,2021-01-11,355,0,23406,0,0.434138342228106,0.0,355,23406,fhi:git
nation,Norge,2021-01-12,4260,0,27666,0,0.513153523715405,0.0,4260,27666,fhi:git
nation,Norge,2021-01-13,9778,0,37444,0,0.694517477842826,0.0,9778,37444,fhi:git
nation,Norge,2021-01-14,8472,0,45916,0,0.851657528913343,0.0,8472,45916,fhi:git
nation,Norge,2021-01-15,4477,0,50393,0,0.934697662133681,0.0,4477,50393,fhi:git
nation,Norge,2021-01-16,746,0,51139,0,0.948534592976292,0.0,746,51139,fhi:git
nation,Norge,2021-01-17,349,5,51488,5,0.955007902445557,9.27408233419007e-05,354,51493,fhi:git
nation,Norge,2021-01-18,1284,283,52772,288,0.978823745879757,0.0053418714244934,1567,53060,fhi:git
nation,Norge,2021-01-19,4589,772,57361,1060,1.06394127354295,0.019661054548483,5361,58421,fhi:git
nation,Norge,2021-01-20,10062,693,67423,1753,1.25057290643619,0.0325149326636704,10755,69176,fhi:git
nation,Norge,2021-01-21,8436,169,75859,1922,1.40704522357865,0.0356495724926266,8605,77781,fhi:git
nation,Norge,2021-01-22,3317,7,79176,1929,1.46856948578367,0.0357794096453053,3324,81105,fhi:git
nation,Norge,2021-01-23,359,0,79535,1929,1.47522827689962,0.0357794096453053,359,81464,fhi:git
nation,Norge,2021-01-24,67,0,79602,1929,1.4764710039324,0.0357794096453053,67,81531,fhi:git
nation,Norge,2021-01-25,581,0,80183,1929,1.48724748760473,0.0357794096453053,581,82112,fhi:git
nation,Norge,2021-01-26,2278,2142,82461,4071,1.5295002067193,0.0755095783649756,4420,86532,fhi:git
nation,Norge,2021-01-27,11417,7596,93878,11667,1.74126460273819,0.216401437185991,19013,105545,fhi:git
nation,Norge,2021-01-28,10901,6572,104779,18239,1.9434581457882,0.338299975386586,17473,123018,fhi:git
nation,Norge,2021-01-29,3812,2107,108591,20346,2.01416374950407,0.377380958342862,5919,128937,fhi:git
nation,Norge,2021-01-30,147,172,108738,20518,2.01689032971032,0.380571242665824,319,129256,fhi:git
nation,Norge,2021-01-31,101,51,108839,20569,2.01876369434183,0.381517199063911,152,129408,fhi:git
nation,Norge,2021-02-01,198,303,109037,20872,2.02243623094617,0.38713729295843,501,129909,fhi:git
nation,Norge,2021-02-02,6357,3144,115394,24016,2.14034691374306,0.445452722675818,9501,139410,fhi:git
nation,Norge,2021-02-03,25134,8320,140528,32336,2.60653648451813,0.59977345271674,33454,172864,fhi:git
nation,Norge,2021-02-04,25969,8663,166497,40999,3.08821377279129,0.760456203238918,34632,207496,fhi:git
nation,Norge,2021-02-05,10626,4865,177123,45864,3.2853065705575,0.850693024350587,15491,222987,fhi:git
nation,Norge,2021-02-06,809,736,177932,46600,3.30031203577422,0.864344473546515,1545,224532,fhi:git
nation,Norge,2021-02-07,320,296,178252,46896,3.3062474484681,0.869834730288355,616,225148,fhi:git
nation,Norge,2021-02-08,120,922,178372,47818,3.3084732282283,0.886936138112602,1042,226190,fhi:git
nation,Norge,2021-02-09,5543,3241,183915,51059,3.41128570498514,0.947050739802822,8784,234974,fhi:git
nation,Norge,2021-02-10,22994,8665,206909,59724,3.83778220336987,1.10777058665434,31659,266633,fhi:git
nation,Norge,2021-02-11,20943,8573,227852,68297,4.22623641601975,1.26678400235636,29516,296149,fhi:git
nation,Norge,2021-02-12,8043,3610,235895,71907,4.37541930444753,1.33374287680921,11653,307802,fhi:git
nation,Norge,2021-02-13,893,306,236788,72213,4.3919828154964,1.33941861519774,1199,309001,fhi:git
nation,Norge,2021-02-14,110,3,236898,72216,4.39402311360992,1.33947425969174,113,309114,fhi:git
nation,Norge,2021-02-15,803,751,237701,72967,4.40891728983863,1.35340393135769,1554,310668,fhi:git
nation,Norge,2021-02-16,6026,2175,243727,75142,4.52068853013029,1.39374618951142,8201,318869,fhi:git
nation,Norge,2021-02-17,21812,10206,265539,85348,4.925261097877,1.58304875811691,32018,350887,fhi:git
nation,Norge,2021-02-18,18891,10816,284430,96164,5.27565447662737,1.78366570717011,29707,380594,fhi:git
nation,Norge,2021-02-19,10737,4799,295167,100963,5.47480612067176,1.87267834941367,15536,396130,fhi:git
nation,Norge,2021-02-20,500,172,295667,101135,5.48408020300595,1.87586863373663,672,396802,fhi:git
nation,Norge,2021-02-21,58,101,295725,101236,5.48515599655672,1.87774199836813,159,396961,fhi:git
nation,Norge,2021-02-22,2572,141,298297,101377,5.53286187608379,1.88035728958637,2713,399674,fhi:git
nation,Norge,2021-02-23,5749,5206,304046,106583,5.63949527476231,1.97691903484996,10955,410629,fhi:git
nation,Norge,2021-02-24,10973,22351,315019,128934,5.84302428566845,2.39148906335293,33324,443953,fhi:git
nation,Norge,2021-02-25,11149,25093,326168,154027,6.04981777355622,2.85691815937659,36242,480195,fhi:git
nation,Norge,2021-02-26,8299,9931,334467,163958,6.2037489921391,3.04111998269827,18230,498425,fhi:git
nation,Norge,2021-02-27,440,202,334907,164160,6.21191018459319,3.04486671196129,642,499067,fhi:git
nation,Norge,2021-02-28,538,159,335445,164319,6.22188909718478,3.04781587014356,697,499764,fhi:git
nation,Norge,2021-03-01,5924,62,341369,164381,6.33176842468026,3.048965856353,5986,505750,fhi:git
nation,Norge,2021-03-02,10516,3824,351885,168205,6.52682092433295,3.11989403804488,14340,520090,fhi:git
nation,Norge,2021-03-03,17657,18057,369542,186262,6.85432586788254,3.45481824746182,35714,555804,fhi:git
nation,Norge,2021-03-04,16255,18443,385797,204705,7.15582628456706,3.79690204844076,34698,590502,fhi:git
nation,Norge,2021-03-05,11891,6528,397688,211233,7.37638251063876,3.91798446739594,18419,608921,fhi:git
nation,Norge,2021-03-06,380,479,398068,211712,7.38343081321275,3.9268690382721,859,609780,fhi:git
nation,Norge,2021-03-07,91,1,398159,211713,7.38511869619757,3.92688758643677,92,609872,fhi:git
nation,Norge,2021-03-08,4901,46,403060,211759,7.4760232512373,3.92774080201151,4947,614819,fhi:git
nation,Norge,2021-03-09,12439,4271,415499,216030,7.70674387154728,4.00696001331016,16710,631529,fhi:git
nation,Norge,2021-03-10,20960,17190,436459,233220,8.09551340299653,4.32580296395962,38150,669679,fhi:git
nation,Norge,2021-03-11,11948,16563,448407,249783,8.31712687445434,4.633016215362,28511,698190,fhi:git
nation,Norge,2021-03-12,2313,8301,450720,258084,8.3600287793323,4.78698453027422,10614,708804,fhi:git
nation,Norge,2021-03-13,33,304,450753,258388,8.36064086876636,4.79262317233341,337,709141,fhi:git
nation,Norge,2021-03-14,3,109,450756,258497,8.36069651326036,4.79464492228226,112,709253,fhi:git
nation,Norge,2021-03-15,99,436,450855,258933,8.36253278156253,4.80273192207768,535,709788,fhi:git
nation,Norge,2021-03-16,5642,626,456497,259559,8.46718152662153,4.81434307316008,6268,716056,fhi:git
nation,Norge,2021-03-17,23021,1553,479518,261112,8.89417882545231,4.84314837289008,24574,740630,fhi:git
nation,Norge,2021-03-18,20991,1402,500509,262514,9.28352335000628,4.86915289975515,22393,763023,fhi:git
nation,Norge,2021-03-19,6749,970,507258,263484,9.40870491335318,4.88714461948347,7719,770742,fhi:git
nation,Norge,2021-03-20,458,21,507716,263505,9.41719997277129,4.88753413094151,479,771221,fhi:git
nation,Norge,2021-03-21,187,68,507903,263573,9.42066847956428,4.88879540613896,255,771476,fhi:git
nation,Norge,2021-03-22,1504,86,509407,263659,9.44856491922553,4.89039054830044,1590,773066,fhi:git
nation,Norge,2021-03-23,13090,953,522497,264612,9.69136039473462,4.90806694922941,14043,787109,fhi:git
nation,Norge,2021-03-24,39006,3641,561503,268253,10.4148501057895,4.97560081678698,42647,829756,fhi:git
nation,Norge,2021-03-25,38582,2312,600085,270565,11.1304753950249,5.01848417350027,40894,870650,fhi:git
nation,Norge,2021-03-26,17236,1138,617321,271703,11.4501715612491,5.03959198489289,18374,889024,fhi:git
nation,Norge,2021-03-27,566,6,617887,271709,11.4606698224514,5.0397032738809,572,889596,fhi:git
nation,Norge,2021-03-28,329,2,618216,271711,11.4667721686273,5.03974037021024,331,889927,fhi:git
nation,Norge,2021-03-29,4725,25,622941,271736,11.5544122466854,5.04020407432695,4750,894677,fhi:git
nation,Norge,2021-03-30,31523,3972,654464,275708,12.1391060415267,5.11387738438975,35495,930172,fhi:git
nation,Norge,2021-03-31,35621,6841,690085,282549,12.7998102151791,5.24076537888614,42462,972634,fhi:git
nation,Norge,2021-04-01,9366,1445,699451,283994,12.9735323254632,5.26756747683195,10811,983445,fhi:git
nation,Norge,2021-04-02,4265,658,703716,284652,13.0526402477738,5.27977216918375,4923,988368,fhi:git
nation,Norge,2021-04-03,258,6,703974,284658,13.0574256742582,5.27988345817176,264,988632,fhi:git
nation,Norge,2021-04-04,388,42,704362,284700,13.0646223621496,5.28066248108783,430,989062,fhi:git
